Team,Total Matches Played,Runs Scored,Wickets Lost,Got All Out,Runs Conceded,Opponent Wickets Taken,Opponent All Out,Match Index,Batsman,Player Total Runs,Player Home Runs,Player Non Home Runs,Balls Faced,R0,W0,R1,W1,Current_HR,Current_NHR,Total Runs in Segment,Total HR till Segment,Total NHR till Segment,Total Runs Till Segment,Target,Final Runs Made,Extras,Home,Segment,Home Run Hitting Ability,Milestone Reaching Ability,Batting Average,Strike Rate,Matches Played,ClusterID
England,221,237.176,7.17647,0.289593,230.633,7.45701,0.384615,1,ME Trescothick,0,0,0,0,0,0,0,0,16,6,22,16,6,22,0,301,10,0,1,6.625,0.375,49.5,87.4172,8,4
England,221,237.176,7.17647,0.289593,230.633,7.45701,0.384615,1,EC Joyce,0,0,0,0,0,0,0,0,16,6,22,16,6,22,0,301,10,0,1,3.08571,0.2,28.3429,68.6505,35,4
Ireland,55,219.527,7.65455,0.290909,202.727,7.56364,0.4,1,DI Joyce,0,0,0,0,0,0,0,0,8,7,15,8,7,15,302,263,15,1,1,1.33333,0,9.66667,47.541,3,3
Ireland,55,219.527,7.65455,0.290909,202.727,7.56364,0.4,1,AC Botha,0,0,0,0,0,0,0,0,8,7,15,8,7,15,302,263,15,1,1,1.25,0.0833333,14.3333,53.75,12,3
Ireland,55,219.527,7.65455,0.290909,202.727,7.56364,0.4,1,JP Bray,0,0,0,0,0,0,0,0,8,7,15,8,7,15,302,263,15,1,1,2.7,0.1,23.4,63.0728,10,1
England,221,237.176,7.17647,0.289593,230.633,7.45701,0.384615,2,ME Trescothick,0,0,0,0,0,0,0,0,4,5,9,4,5,9,0,166,1,1,1,6.625,0.375,49.5,87.4172,8,4
England,221,237.176,7.17647,0.289593,230.633,7.45701,0.384615,2,AJ Strauss,0,0,0,0,0,0,0,0,4,5,9,4,5,9,0,166,1,1,1,3.93243,0.27027,33.9054,79.8028,74,4
England,221,237.176,7.17647,0.289593,230.633,7.45701,0.384615,2,IR Bell,0,0,0,0,0,0,0,0,4,5,9,4,5,9,0,166,1,1,1,3.63433,0.246269,35.3806,75.6623,134,4
Pakistan,211,222.621,7.38389,0.393365,235.517,7.54976,0.336493,2,Shoaib Malik,0,0,0,0,0,0,0,0,4,12,16,4,12,16,167,169,4,0,1,2.77551,0.193878,28.7041,81.4418,98,4
Pakistan,211,222.621,7.38389,0.393365,235.517,7.54976,0.336493,2,Mohammad Hafeez,0,0,0,0,0,0,0,0,4,12,16,4,12,16,167,169,4,0,1,4.04511,0.255639,34.3534,78.0625,133,4
Pakistan,211,222.621,7.38389,0.393365,235.517,7.54976,0.336493,2,Younis Khan,0,0,0,0,0,0,0,0,4,12,16,4,12,16,167,169,4,0,1,2.64655,0.215517,28.5,73.2713,116,4
England,221,237.176,7.17647,0.289593,230.633,7.45701,0.384615,3,ME Trescothick,0,0,0,0,0,0,0,0,12,15,27,12,15,27,0,271,2,1,1,6.625,0.375,49.5,87.4172,8,4
England,221,237.176,7.17647,0.289593,230.633,7.45701,0.384615,3,IR Bell,0,0,0,0,0,0,0,0,12,15,27,12,15,27,0,271,2,1,1,3.63433,0.246269,35.3806,75.6623,134,4
England,221,237.176,7.17647,0.289593,230.633,7.45701,0.384615,3,AJ Strauss,0,0,0,0,0,0,0,0,12,15,27,12,15,27,0,271,2,1,1,3.93243,0.27027,33.9054,79.8028,74,4
Pakistan,211,222.621,7.38389,0.393365,235.517,7.54976,0.336493,3,Shoaib Malik,0,0,0,0,0,0,0,0,14,9,23,14,9,23,272,274,2,0,1,2.77551,0.193878,28.7041,81.4418,98,4
Pakistan,211,222.621,7.38389,0.393365,235.517,7.54976,0.336493,3,Mohammad Hafeez,0,0,0,0,0,0,0,0,14,9,23,14,9,23,272,274,2,0,1,4.04511,0.255639,34.3534,78.0625,133,4
Pakistan,211,222.621,7.38389,0.393365,235.517,7.54976,0.336493,3,Younis Khan,0,0,0,0,0,0,0,0,14,9,23,14,9,23,272,274,2,0,1,2.64655,0.215517,28.5,73.2713,116,4
Pakistan,211,222.621,7.38389,0.393365,235.517,7.54976,0.336493,4,Mohammad Hafeez,0,0,0,0,0,0,0,0,18,3,21,18,3,21,0,235,3,0,1,4.04511,0.255639,34.3534,78.0625,133,4
Pakistan,211,222.621,7.38389,0.393365,235.517,7.54976,0.336493,4,Shahid Afridi,0,0,0,0,0,0,0,0,18,3,21,18,3,21,0,235,3,0,1,2.72917,0.0972222,21.4097,127.766,144,0
Pakistan,211,222.621,7.38389,0.393365,235.517,7.54976,0.336493,4,Younis Khan,0,0,0,0,0,0,0,0,18,3,21,18,3,21,0,235,3,0,1,2.64655,0.215517,28.5,73.2713,116,4
Pakistan,211,222.621,7.38389,0.393365,235.517,7.54976,0.336493,4,Mohammad Yousuf,0,0,0,0,0,0,0,0,18,3,21,18,3,21,0,235,3,0,1,3.27586,0.275862,36.7931,73.9176,58,4
England,221,237.176,7.17647,0.289593,230.633,7.45701,0.384615,4,AJ Strauss,0,0,0,0,0,0,0,0,16,2,18,16,2,18,236,237,0,1,1,3.93243,0.27027,33.9054,79.8028,74,4
England,221,237.176,7.17647,0.289593,230.633,7.45701,0.384615,4,EC Joyce,0,0,0,0,0,0,0,0,16,2,18,16,2,18,236,237,0,1,1,3.08571,0.2,28.3429,68.6505,35,4
Pakistan,211,222.621,7.38389,0.393365,235.517,7.54976,0.336493,5,Mohammad Hafeez,0,0,0,0,0,0,0,0,0,5,5,0,5,5,0,154,9,0,1,4.04511,0.255639,34.3534,78.0625,133,4
Pakistan,211,222.621,7.38389,0.393365,235.517,7.54976,0.336493,5,Imran Farhat,0,0,0,0,0,0,0,0,0,5,5,0,5,5,0,154,9,0,1,3.03333,0.266667,27.0333,62.9658,30,4
England,221,237.176,7.17647,0.289593,230.633,7.45701,0.384615,5,AJ Strauss,0,0,0,0,0,0,0,0,24,3,27,24,3,27,155,155,3,1,1,3.93243,0.27027,33.9054,79.8028,74,4
England,221,237.176,7.17647,0.289593,230.633,7.45701,0.384615,5,EC Joyce,0,0,0,0,0,0,0,0,24,3,27,24,3,27,155,155,3,1,1,3.08571,0.2,28.3429,68.6505,35,4
England,221,237.176,7.17647,0.289593,230.633,7.45701,0.384615,5,IR Bell,0,0,0,0,0,0,0,0,24,3,27,24,3,27,155,155,3,1,1,3.63433,0.246269,35.3806,75.6623,134,4
Sri Lanka,244,223.373,7.09016,0.344262,227.578,7.47541,0.385246,6,WU Tharanga,0,0,0,0,0,0,0,0,8,5,13,8,5,13,0,257,12,0,1,3.93985,0.263158,32.9699,71.6035,133,4
Sri Lanka,244,223.373,7.09016,0.344262,227.578,7.47541,0.385246,6,ST Jayasuriya,0,0,0,0,0,0,0,0,8,5,13,8,5,13,0,257,12,0,1,4.91549,0.211268,33.9859,98.4898,71,0
England,221,237.176,7.17647,0.289593,230.633,7.45701,0.384615,6,ME Trescothick,0,0,0,0,0,0,0,0,4,11,15,4,11,15,258,237,0,1,1,6.625,0.375,49.5,87.4172,8,4
England,221,237.176,7.17647,0.289593,230.633,7.45701,0.384615,6,AJ Strauss,0,0,0,0,0,0,0,0,4,11,15,4,11,15,258,237,0,1,1,3.93243,0.27027,33.9054,79.8028,74,4
Sri Lanka,244,223.373,7.09016,0.344262,227.578,7.47541,0.385246,7,WU Tharanga,0,0,0,0,0,0,0,0,12,6,18,12,6,18,0,319,0,0,1,3.93985,0.263158,32.9699,71.6035,133,4
Sri Lanka,244,223.373,7.09016,0.344262,227.578,7.47541,0.385246,7,ST Jayasuriya,0,0,0,0,0,0,0,0,12,6,18,12,6,18,0,319,0,0,1,4.91549,0.211268,33.9859,98.4898,71,0
England,221,237.176,7.17647,0.289593,230.633,7.45701,0.384615,7,ME Trescothick,0,0,0,0,0,0,0,0,16,6,22,16,6,22,320,273,2,1,1,6.625,0.375,49.5,87.4172,8,4
England,221,237.176,7.17647,0.289593,230.633,7.45701,0.384615,7,IR Bell,0,0,0,0,0,0,0,0,16,6,22,16,6,22,320,273,2,1,1,3.63433,0.246269,35.3806,75.6623,134,4
England,221,237.176,7.17647,0.289593,230.633,7.45701,0.384615,7,AJ Strauss,0,0,0,0,0,0,0,0,16,6,22,16,6,22,320,273,2,1,1,3.93243,0.27027,33.9054,79.8028,74,4
England,221,237.176,7.17647,0.289593,230.633,7.45701,0.384615,8,ME Trescothick,0,0,0,0,0,0,0,0,12,5,17,12,5,17,0,261,2,1,1,6.625,0.375,49.5,87.4172,8,4
England,221,237.176,7.17647,0.289593,230.633,7.45701,0.384615,8,AJ Strauss,0,0,0,0,0,0,0,0,12,5,17,12,5,17,0,261,2,1,1,3.93243,0.27027,33.9054,79.8028,74,4
Sri Lanka,244,223.373,7.09016,0.344262,227.578,7.47541,0.385246,8,WU Tharanga,0,0,0,0,0,0,0,0,30,7,37,30,7,37,262,265,1,0,1,3.93985,0.263158,32.9699,71.6035,133,4
Sri Lanka,244,223.373,7.09016,0.344262,227.578,7.47541,0.385246,8,ST Jayasuriya,0,0,0,0,0,0,0,0,30,7,37,30,7,37,262,265,1,0,1,4.91549,0.211268,33.9859,98.4898,71,0
Sri Lanka,244,223.373,7.09016,0.344262,227.578,7.47541,0.385246,9,WU Tharanga,0,0,0,0,0,0,0,0,12,7,19,12,7,19,0,318,6,0,1,3.93985,0.263158,32.9699,71.6035,133,4
Sri Lanka,244,223.373,7.09016,0.344262,227.578,7.47541,0.385246,9,ST Jayasuriya,0,0,0,0,0,0,0,0,12,7,19,12,7,19,0,318,6,0,1,4.91549,0.211268,33.9859,98.4898,71,0
Sri Lanka,244,223.373,7.09016,0.344262,227.578,7.47541,0.385246,9,DPMD Jayawardene,0,0,0,0,0,0,0,0,12,7,19,12,7,19,0,318,6,0,1,3.20833,0.244792,31.6979,79.1109,192,4
England,221,237.176,7.17647,0.289593,230.633,7.45701,0.384615,9,ME Trescothick,0,0,0,0,0,0,0,0,16,7,23,16,7,23,319,285,0,1,1,6.625,0.375,49.5,87.4172,8,4
England,221,237.176,7.17647,0.289593,230.633,7.45701,0.384615,9,AN Cook,0,0,0,0,0,0,0,0,16,7,23,16,7,23,319,285,0,1,1,4.17045,0.272727,35.75,75.5524,88,4
India,259,242.378,7.15058,0.339768,244.568,7.12741,0.30888,10,V Sehwag,0,0,0,0,0,0,0,0,12,9,21,12,9,21,0,245,3,0,1,5.88636,0.238636,38.8295,108.649,88,0
India,259,242.378,7.15058,0.339768,244.568,7.12741,0.30888,10,R Dravid,0,0,0,0,0,0,0,0,12,9,21,12,9,21,0,245,3,0,1,2.83721,0.255814,29.8605,72.7067,43,4
India,259,242.378,7.15058,0.339768,244.568,7.12741,0.30888,10,SK Raina,0,0,0,0,0,0,0,0,12,9,21,12,9,21,0,245,3,0,1,3.11111,0.216374,28.9064,91.8944,171,0
West Indies,176,217.33,7.15909,0.3125,225.278,7.57386,0.380682,10,CH Gayle,0,0,0,0,0,0,0,0,8,5,13,8,5,13,246,248,4,1,1,4.58621,0.206897,31.1293,89.4255,116,4
West Indies,176,217.33,7.15909,0.3125,225.278,7.57386,0.380682,10,MN Samuels,0,0,0,0,0,0,0,0,8,5,13,8,5,13,246,248,4,1,1,3.74757,0.23301,31.6214,74.5821,103,4
India,259,242.378,7.15058,0.339768,244.568,7.12741,0.30888,11,V Sehwag,0,0,0,0,0,0,0,0,8,6,14,8,6,14,0,217,1,0,1,5.88636,0.238636,38.8295,108.649,88,0
India,259,242.378,7.15058,0.339768,244.568,7.12741,0.30888,11,R Dravid,0,0,0,0,0,0,0,0,8,6,14,8,6,14,0,217,1,0,1,2.83721,0.255814,29.8605,72.7067,43,4
India,259,242.378,7.15058,0.339768,244.568,7.12741,0.30888,11,SK Raina,0,0,0,0,0,0,0,0,8,6,14,8,6,14,0,217,1,0,1,3.11111,0.216374,28.9064,91.8944,171,0
West Indies,176,217.33,7.15909,0.3125,225.278,7.57386,0.380682,11,CH Gayle,0,0,0,0,0,0,0,0,22,3,25,22,3,25,218,218,3,1,1,4.58621,0.206897,31.1293,89.4255,116,4
West Indies,176,217.33,7.15909,0.3125,225.278,7.57386,0.380682,11,MN Samuels,0,0,0,0,0,0,0,0,22,3,25,22,3,25,218,218,3,1,1,3.74757,0.23301,31.6214,74.5821,103,4
West Indies,176,217.33,7.15909,0.3125,225.278,7.57386,0.380682,11,RR Sarwan,0,0,0,0,0,0,0,0,22,3,25,22,3,25,218,218,3,1,1,2.8254,0.222222,29.1429,69.1005,63,4
West Indies,176,217.33,7.15909,0.3125,225.278,7.57386,0.380682,12,CH Gayle,0,0,0,0,0,0,0,0,24,0,24,24,0,24,0,255,3,1,1,4.58621,0.206897,31.1293,89.4255,116,4
West Indies,176,217.33,7.15909,0.3125,225.278,7.57386,0.380682,12,S Chattergoon,0,0,0,0,0,0,0,0,24,0,24,24,0,24,0,255,3,1,1,4.66667,0.166667,27.8333,60.9489,6,4
West Indies,176,217.33,7.15909,0.3125,225.278,7.57386,0.380682,12,RR Sarwan,0,0,0,0,0,0,0,0,24,0,24,24,0,24,0,255,3,1,1,2.8254,0.222222,29.1429,69.1005,63,4
India,259,242.378,7.15058,0.339768,244.568,7.12741,0.30888,12,RV Uthappa,0,0,0,0,0,0,0,0,12,9,21,12,9,21,256,236,2,0,1,3,0.117647,22.1471,89.0071,34,0
India,259,242.378,7.15058,0.339768,244.568,7.12741,0.30888,12,MS Dhoni,0,0,0,0,0,0,0,0,12,9,21,12,9,21,256,236,2,0,1,3.47872,0.292553,36.7713,84.1612,188,4
India,259,242.378,7.15058,0.339768,244.568,7.12741,0.30888,12,V Sehwag,0,0,0,0,0,0,0,0,12,9,21,12,9,21,256,236,2,0,1,5.88636,0.238636,38.8295,108.649,88,0
West Indies,176,217.33,7.15909,0.3125,225.278,7.57386,0.380682,13,CH Gayle,0,0,0,0,0,0,0,0,12,7,19,12,7,19,0,241,3,1,1,4.58621,0.206897,31.1293,89.4255,116,4
West Indies,176,217.33,7.15909,0.3125,225.278,7.57386,0.380682,13,S Chanderpaul,0,0,0,0,0,0,0,0,12,7,19,12,7,19,0,241,3,1,1,3.57143,0.396825,40.8254,68.0783,63,4
West Indies,176,217.33,7.15909,0.3125,225.278,7.57386,0.380682,13,RR Sarwan,0,0,0,0,0,0,0,0,12,7,19,12,7,19,0,241,3,1,1,2.8254,0.222222,29.1429,69.1005,63,4
Pakistan,211,222.621,7.38389,0.393365,235.517,7.54976,0.336493,13,Imran Nazir,0,0,0,0,0,0,0,0,18,2,20,18,2,20,242,187,1,0,1,4.66667,0.133333,29,96.0265,15,0
Pakistan,211,222.621,7.38389,0.393365,235.517,7.54976,0.336493,13,Younis Khan,0,0,0,0,0,0,0,0,18,2,20,18,2,20,242,187,1,0,1,2.64655,0.215517,28.5,73.2713,116,4
Pakistan,211,222.621,7.38389,0.393365,235.517,7.54976,0.336493,13,Mohammad Hafeez,0,0,0,0,0,0,0,0,18,2,20,18,2,20,242,187,1,0,1,4.04511,0.255639,34.3534,78.0625,133,4
Ireland,55,219.527,7.65455,0.290909,202.727,7.56364,0.4,16,WTS Porterfield,0,0,0,0,0,0,0,0,10,5,15,10,5,15,0,221,2,0,1,2.6,0.142857,24.6857,56.2866,35,3
Ireland,55,219.527,7.65455,0.290909,202.727,7.56364,0.4,16,JP Bray,0,0,0,0,0,0,0,0,10,5,15,10,5,15,0,221,2,0,1,2.7,0.1,23.4,63.0728,10,1
Ireland,55,219.527,7.65455,0.290909,202.727,7.56364,0.4,16,EJG Morgan,0,0,0,0,0,0,0,0,10,5,15,10,5,15,0,221,2,0,1,3.19549,0.233083,30.0526,86.9291,133,4
Zimbabwe,142,212.077,7.5,0.380282,227.704,6.97887,0.316901,16,T Duffin,0,0,0,0,0,0,0,0,12,11,23,12,11,23,222,221,3,0,1,4,0.25,35.75,62.1739,4,4
Zimbabwe,142,212.077,7.5,0.380282,227.704,6.97887,0.316901,16,V Sibanda,0,0,0,0,0,0,0,0,12,11,23,12,11,23,222,221,3,0,1,2.9697,0.181818,23.5152,63.5545,66,1
England,221,237.176,7.17647,0.289593,230.633,7.45701,0.384615,18,EC Joyce,0,0,0,0,0,0,0,0,0,7,7,0,7,7,0,209,5,0,1,3.08571,0.2,28.3429,68.6505,35,4
England,221,237.176,7.17647,0.289593,230.633,7.45701,0.384615,18,IR Bell,0,0,0,0,0,0,0,0,0,7,7,0,7,7,0,209,5,0,1,3.63433,0.246269,35.3806,75.6623,134,4
England,221,237.176,7.17647,0.289593,230.633,7.45701,0.384615,18,MP Vaughan,0,0,0,0,0,0,0,0,0,7,7,0,7,7,0,209,5,0,1,2.6,0.1,20.6,66.4516,10,1
New Zealand,184,233.745,7.39674,0.36413,227.951,7.30435,0.353261,18,L Vincent,0,0,0,0,0,0,0,0,12,4,16,12,4,16,210,210,3,0,1,3.125,0.25,27.8125,67.5266,16,4
New Zealand,184,233.745,7.39674,0.36413,227.951,7.30435,0.353261,18,SP Fleming,0,0,0,0,0,0,0,0,12,4,16,12,4,16,210,210,3,0,1,3.875,0.25,30.2917,70.9268,24,4
New Zealand,184,233.745,7.39674,0.36413,227.951,7.30435,0.353261,18,LRPL Taylor,0,0,0,0,0,0,0,0,12,4,16,12,4,16,210,210,3,0,1,3.68382,0.301471,36.7206,79.3959,136,4
New Zealand,184,233.745,7.39674,0.36413,227.951,7.30435,0.353261,18,SB Styris,0,0,0,0,0,0,0,0,12,4,16,12,4,16,210,210,3,0,1,3.20755,0.264151,33.8302,78.7094,53,4
Pakistan,211,222.621,7.38389,0.393365,235.517,7.54976,0.336493,19,Imran Nazir,0,0,0,0,0,0,0,0,12,7,19,12,7,19,0,132,6,0,1,4.66667,0.133333,29,96.0265,15,0
Pakistan,211,222.621,7.38389,0.393365,235.517,7.54976,0.336493,19,Mohammad Hafeez,0,0,0,0,0,0,0,0,12,7,19,12,7,19,0,132,6,0,1,4.04511,0.255639,34.3534,78.0625,133,4
Pakistan,211,222.621,7.38389,0.393365,235.517,7.54976,0.336493,19,Younis Khan,0,0,0,0,0,0,0,0,12,7,19,12,7,19,0,132,6,0,1,2.64655,0.215517,28.5,73.2713,116,4
Pakistan,211,222.621,7.38389,0.393365,235.517,7.54976,0.336493,19,Mohammad Yousuf,0,0,0,0,0,0,0,0,12,7,19,12,7,19,0,132,6,0,1,3.27586,0.275862,36.7931,73.9176,58,4
Ireland,55,219.527,7.65455,0.290909,202.727,7.56364,0.4,19,JP Bray,0,0,0,0,0,0,0,0,4,10,14,4,10,14,133,133,1,0,1,2.7,0.1,23.4,63.0728,10,1
Ireland,55,219.527,7.65455,0.290909,202.727,7.56364,0.4,19,WTS Porterfield,0,0,0,0,0,0,0,0,4,10,14,4,10,14,133,133,1,0,1,2.6,0.142857,24.6857,56.2866,35,3
Ireland,55,219.527,7.65455,0.290909,202.727,7.56364,0.4,19,EJG Morgan,0,0,0,0,0,0,0,0,4,10,14,4,10,14,133,133,1,0,1,3.19549,0.233083,30.0526,86.9291,133,4
Zimbabwe,142,212.077,7.5,0.380282,227.704,6.97887,0.316901,23,V Sibanda,0,0,0,0,0,0,0,0,0,5,5,0,5,5,0,202,4,0,1,2.9697,0.181818,23.5152,63.5545,66,1
Zimbabwe,142,212.077,7.5,0.380282,227.704,6.97887,0.316901,23,CJ Chibhabha,0,0,0,0,0,0,0,0,0,5,5,0,5,5,0,202,4,0,1,2.56716,0.149254,23.5373,64.7373,67,1
Zimbabwe,142,212.077,7.5,0.380282,227.704,6.97887,0.316901,23,BRM Taylor,0,0,0,0,0,0,0,0,0,5,5,0,5,5,0,202,4,0,1,3.3,0.26,33.56,76.3421,100,4
West Indies,176,217.33,7.15909,0.3125,225.278,7.57386,0.380682,23,CH Gayle,0,0,0,0,0,0,0,0,4,8,12,4,8,12,203,204,3,1,1,4.58621,0.206897,31.1293,89.4255,116,4
West Indies,176,217.33,7.15909,0.3125,225.278,7.57386,0.380682,23,S Chanderpaul,0,0,0,0,0,0,0,0,4,8,12,4,8,12,203,204,3,1,1,3.57143,0.396825,40.8254,68.0783,63,4
Sri Lanka,244,223.373,7.09016,0.344262,227.578,7.47541,0.385246,26,WU Tharanga,0,0,0,0,0,0,0,0,10,9,19,10,9,19,0,318,5,0,1,3.93985,0.263158,32.9699,71.6035,133,4
Sri Lanka,244,223.373,7.09016,0.344262,227.578,7.47541,0.385246,26,ST Jayasuriya,0,0,0,0,0,0,0,0,10,9,19,10,9,19,0,318,5,0,1,4.91549,0.211268,33.9859,98.4898,71,0
Bangladesh,160,218.438,7.70625,0.4,211.106,7.05,0.325,26,Tamim Iqbal,0,0,0,0,0,0,0,0,4,3,7,4,3,7,319,112,0,0,1,4.05344,0.274809,31.8015,76.8068,131,4
Bangladesh,160,218.438,7.70625,0.4,211.106,7.05,0.325,26,Shahriar Nafees,0,0,0,0,0,0,0,0,4,3,7,4,3,7,319,112,0,0,1,3.40541,0.162162,24.4865,69.1076,37,4
Bangladesh,160,218.438,7.70625,0.4,211.106,7.05,0.325,26,Mushfiqur Rahim,0,0,0,0,0,0,0,0,4,3,7,4,3,7,319,112,0,0,1,2.61111,0.18254,27.7778,75.2526,126,4
Bangladesh,160,218.438,7.70625,0.4,211.106,7.05,0.325,26,Aftab Ahmed,0,0,0,0,0,0,0,0,4,3,7,4,3,7,319,112,0,0,1,2.44118,0.0882353,19.1471,73.8095,34,1
Pakistan,211,222.621,7.38389,0.393365,235.517,7.54976,0.336493,27,Kamran Akmal,0,0,0,0,0,0,0,0,12,11,23,12,11,23,0,349,2,0,1,3.01124,0.11236,23.0787,81.4433,89,4
Pakistan,211,222.621,7.38389,0.393365,235.517,7.54976,0.336493,27,Imran Nazir,0,0,0,0,0,0,0,0,12,11,23,12,11,23,0,349,2,0,1,4.66667,0.133333,29,96.0265,15,0
Zimbabwe,142,212.077,7.5,0.380282,227.704,6.97887,0.316901,27,V Sibanda,0,0,0,0,0,0,0,0,0,11,11,0,11,11,350,99,1,0,1,2.9697,0.181818,23.5152,63.5545,66,1
Zimbabwe,142,212.077,7.5,0.380282,227.704,6.97887,0.316901,27,CJ Chibhabha,0,0,0,0,0,0,0,0,0,11,11,0,11,11,350,99,1,0,1,2.56716,0.149254,23.5373,64.7373,67,1
Sri Lanka,244,223.373,7.09016,0.344262,227.578,7.47541,0.385246,29,WU Tharanga,0,0,0,0,0,0,0,0,0,9,9,0,9,9,0,254,10,0,1,3.93985,0.263158,32.9699,71.6035,133,4
Sri Lanka,244,223.373,7.09016,0.344262,227.578,7.47541,0.385246,29,ST Jayasuriya,0,0,0,0,0,0,0,0,0,9,9,0,9,9,0,254,10,0,1,4.91549,0.211268,33.9859,98.4898,71,0
India,259,242.378,7.15058,0.339768,244.568,7.12741,0.30888,29,RV Uthappa,0,0,0,0,0,0,0,0,12,6,18,12,6,18,255,185,0,0,1,3,0.117647,22.1471,89.0071,34,0
India,259,242.378,7.15058,0.339768,244.568,7.12741,0.30888,29,SC Ganguly,0,0,0,0,0,0,0,0,12,6,18,12,6,18,255,185,0,0,1,4.56,0.36,36.8,68.2999,25,4
Ireland,55,219.527,7.65455,0.290909,202.727,7.56364,0.4,30,JP Bray,0,0,0,0,0,0,0,0,10,7,17,10,7,17,0,183,9,0,1,2.7,0.1,23.4,63.0728,10,1
Ireland,55,219.527,7.65455,0.290909,202.727,7.56364,0.4,30,WTS Porterfield,0,0,0,0,0,0,0,0,10,7,17,10,7,17,0,183,9,0,1,2.6,0.142857,24.6857,56.2866,35,3
Ireland,55,219.527,7.65455,0.290909,202.727,7.56364,0.4,30,EJG Morgan,0,0,0,0,0,0,0,0,10,7,17,10,7,17,0,183,9,0,1,3.19549,0.233083,30.0526,86.9291,133,4
West Indies,176,217.33,7.15909,0.3125,225.278,7.57386,0.380682,30,CH Gayle,0,0,0,0,0,0,0,0,12,10,22,12,10,22,184,190,2,1,1,4.58621,0.206897,31.1293,89.4255,116,4
West Indies,176,217.33,7.15909,0.3125,225.278,7.57386,0.380682,30,S Chanderpaul,0,0,0,0,0,0,0,0,12,10,22,12,10,22,184,190,2,1,1,3.57143,0.396825,40.8254,68.0783,63,4
Australia,228,239.627,7.69737,0.372807,232.079,7.23246,0.337719,31,AC Gilchrist,0,0,0,0,0,0,0,0,40,10,50,40,10,50,0,377,0,0,1,4.3,0.275,31.425,96.1009,40,0
Australia,228,239.627,7.69737,0.372807,232.079,7.23246,0.337719,31,ML Hayden,0,0,0,0,0,0,0,0,40,10,50,40,10,50,0,377,0,0,1,6.37838,0.378378,50.6757,83.3333,37,4
South Africa,190,234.274,7.4,0.373684,232.363,7.33158,0.342105,31,AB de Villiers,0,0,0,0,0,0,0,0,30,7,37,30,7,37,378,294,3,0,1,5.04969,0.403727,47.2174,98.8428,161,4
South Africa,190,234.274,7.4,0.373684,232.363,7.33158,0.342105,31,GC Smith,0,0,0,0,0,0,0,0,30,7,37,30,7,37,378,294,3,0,1,3.97,0.29,33.57,79.6819,100,4
Australia,228,239.627,7.69737,0.372807,232.079,7.23246,0.337719,34,AC Gilchrist,0,0,0,0,0,0,0,0,0,9,9,0,9,9,0,322,7,0,1,4.3,0.275,31.425,96.1009,40,0
Australia,228,239.627,7.69737,0.372807,232.079,7.23246,0.337719,34,ML Hayden,0,0,0,0,0,0,0,0,0,9,9,0,9,9,0,322,7,0,1,6.37838,0.378378,50.6757,83.3333,37,4
Australia,228,239.627,7.69737,0.372807,232.079,7.23246,0.337719,34,RT Ponting,0,0,0,0,0,0,0,0,0,9,9,0,9,9,0,322,7,0,1,4.17431,0.33945,38.1009,80.8606,109,4
West Indies,176,217.33,7.15909,0.3125,225.278,7.57386,0.380682,34,CH Gayle,0,0,0,0,0,0,0,0,0,8,8,0,8,8,323,219,5,1,1,4.58621,0.206897,31.1293,89.4255,116,4
West Indies,176,217.33,7.15909,0.3125,225.278,7.57386,0.380682,34,S Chanderpaul,0,0,0,0,0,0,0,0,0,8,8,0,8,8,323,219,5,1,1,3.57143,0.396825,40.8254,68.0783,63,4
West Indies,176,217.33,7.15909,0.3125,225.278,7.57386,0.380682,34,RR Sarwan,0,0,0,0,0,0,0,0,0,8,8,0,8,8,323,219,5,1,1,2.8254,0.222222,29.1429,69.1005,63,4
Sri Lanka,244,223.373,7.09016,0.344262,227.578,7.47541,0.385246,35,WU Tharanga,0,0,0,0,0,0,0,0,16,9,25,16,9,25,0,209,1,0,1,3.93985,0.263158,32.9699,71.6035,133,4
Sri Lanka,244,223.373,7.09016,0.344262,227.578,7.47541,0.385246,35,ST Jayasuriya,0,0,0,0,0,0,0,0,16,9,25,16,9,25,0,209,1,0,1,4.91549,0.211268,33.9859,98.4898,71,0
Sri Lanka,244,223.373,7.09016,0.344262,227.578,7.47541,0.385246,35,DPMD Jayawardene,0,0,0,0,0,0,0,0,16,9,25,16,9,25,0,209,1,0,1,3.20833,0.244792,31.6979,79.1109,192,4
South Africa,190,234.274,7.4,0.373684,232.363,7.33158,0.342105,35,GC Smith,0,0,0,0,0,0,0,0,12,11,23,12,11,23,210,212,2,0,1,3.97,0.29,33.57,79.6819,100,4
South Africa,190,234.274,7.4,0.373684,232.363,7.33158,0.342105,35,AB de Villiers,0,0,0,0,0,0,0,0,12,11,23,12,11,23,210,212,2,0,1,5.04969,0.403727,47.2174,98.8428,161,4
South Africa,190,234.274,7.4,0.373684,232.363,7.33158,0.342105,35,JH Kallis,0,0,0,0,0,0,0,0,12,11,23,12,11,23,210,212,2,0,1,3.58621,0.356322,37.2644,76.4442,87,4
West Indies,176,217.33,7.15909,0.3125,225.278,7.57386,0.380682,36,CH Gayle,0,0,0,0,0,0,0,0,0,5,5,0,5,5,0,177,2,1,1,4.58621,0.206897,31.1293,89.4255,116,4
West Indies,176,217.33,7.15909,0.3125,225.278,7.57386,0.380682,36,S Chanderpaul,0,0,0,0,0,0,0,0,0,5,5,0,5,5,0,177,2,1,1,3.57143,0.396825,40.8254,68.0783,63,4
New Zealand,184,233.745,7.39674,0.36413,227.951,7.30435,0.353261,36,PG Fulton,0,0,0,0,0,0,0,0,8,7,15,8,7,15,178,179,1,0,1,2.75,0.1875,27.4062,67.4615,32,4
New Zealand,184,233.745,7.39674,0.36413,227.951,7.30435,0.353261,36,HJH Marshall,0,0,0,0,0,0,0,0,8,7,15,8,7,15,178,179,1,0,1,1.1,0.1,11.4,69.5122,10,1
New Zealand,184,233.745,7.39674,0.36413,227.951,7.30435,0.353261,36,SP Fleming,0,0,0,0,0,0,0,0,8,7,15,8,7,15,178,179,1,0,1,3.875,0.25,30.2917,70.9268,24,4
Bangladesh,160,218.438,7.70625,0.4,211.106,7.05,0.325,37,Tamim Iqbal,0,0,0,0,0,0,0,0,10,12,22,10,12,22,0,104,2,0,1,4.05344,0.274809,31.8015,76.8068,131,4
Bangladesh,160,218.438,7.70625,0.4,211.106,7.05,0.325,37,Shahriar Nafees,0,0,0,0,0,0,0,0,10,12,22,10,12,22,0,104,2,0,1,3.40541,0.162162,24.4865,69.1076,37,4
Bangladesh,160,218.438,7.70625,0.4,211.106,7.05,0.325,37,Aftab Ahmed,0,0,0,0,0,0,0,0,10,12,22,10,12,22,0,104,2,0,1,2.44118,0.0882353,19.1471,73.8095,34,1
Bangladesh,160,218.438,7.70625,0.4,211.106,7.05,0.325,37,Shakib Al Hasan,0,0,0,0,0,0,0,0,10,12,22,10,12,22,0,104,2,0,1,2.86992,0.252033,29.9106,79.0163,123,4
Australia,228,239.627,7.69737,0.372807,232.079,7.23246,0.337719,37,AC Gilchrist,0,0,0,0,0,0,0,0,28,12,40,28,12,40,105,106,0,0,1,4.3,0.275,31.425,96.1009,40,0
Australia,228,239.627,7.69737,0.372807,232.079,7.23246,0.337719,37,ML Hayden,0,0,0,0,0,0,0,0,28,12,40,28,12,40,105,106,0,0,1,6.37838,0.378378,50.6757,83.3333,37,4
Sri Lanka,244,223.373,7.09016,0.344262,227.578,7.47541,0.385246,38,WU Tharanga,0,0,0,0,0,0,0,0,0,9,9,0,9,9,0,303,5,0,1,3.93985,0.263158,32.9699,71.6035,133,4
Sri Lanka,244,223.373,7.09016,0.344262,227.578,7.47541,0.385246,38,ST Jayasuriya,0,0,0,0,0,0,0,0,0,9,9,0,9,9,0,303,5,0,1,4.91549,0.211268,33.9859,98.4898,71,0
West Indies,176,217.33,7.15909,0.3125,225.278,7.57386,0.380682,38,CH Gayle,0,0,0,0,0,0,0,0,8,9,17,8,9,17,304,190,1,1,1,4.58621,0.206897,31.1293,89.4255,116,4
West Indies,176,217.33,7.15909,0.3125,225.278,7.57386,0.380682,38,DJ Bravo,0,0,0,0,0,0,0,0,8,9,17,8,9,17,304,190,1,1,1,2.35514,0.11215,23.1589,80.9011,107,4
Bangladesh,160,218.438,7.70625,0.4,211.106,7.05,0.325,39,Javed Omar,0,0,0,0,0,0,0,0,8,6,14,8,6,14,0,174,0,0,1,2.66667,0.166667,24.3333,48.0263,6,3
Bangladesh,160,218.438,7.70625,0.4,211.106,7.05,0.325,39,Tamim Iqbal,0,0,0,0,0,0,0,0,8,6,14,8,6,14,0,174,0,0,1,4.05344,0.274809,31.8015,76.8068,131,4
New Zealand,184,233.745,7.39674,0.36413,227.951,7.30435,0.353261,39,PG Fulton,0,0,0,0,0,0,0,0,16,7,23,16,7,23,175,178,3,0,1,2.75,0.1875,27.4062,67.4615,32,4
New Zealand,184,233.745,7.39674,0.36413,227.951,7.30435,0.353261,39,SP Fleming,0,0,0,0,0,0,0,0,16,7,23,16,7,23,175,178,3,0,1,3.875,0.25,30.2917,70.9268,24,4
Ireland,55,219.527,7.65455,0.290909,202.727,7.56364,0.4,40,JP Bray,0,0,0,0,0,0,0,0,4,5,9,4,5,9,0,152,0,0,1,2.7,0.1,23.4,63.0728,10,1
Ireland,55,219.527,7.65455,0.290909,202.727,7.56364,0.4,40,WTS Porterfield,0,0,0,0,0,0,0,0,4,5,9,4,5,9,0,152,0,0,1,2.6,0.142857,24.6857,56.2866,35,3
Ireland,55,219.527,7.65455,0.290909,202.727,7.56364,0.4,40,EJG Morgan,0,0,0,0,0,0,0,0,4,5,9,4,5,9,0,152,0,0,1,3.19549,0.233083,30.0526,86.9291,133,4
South Africa,190,234.274,7.4,0.373684,232.363,7.33158,0.342105,40,AB de Villiers,0,0,0,0,0,0,0,0,12,6,18,12,6,18,153,165,1,0,1,5.04969,0.403727,47.2174,98.8428,161,4
South Africa,190,234.274,7.4,0.373684,232.363,7.33158,0.342105,40,JH Kallis,0,0,0,0,0,0,0,0,12,6,18,12,6,18,153,165,1,0,1,3.58621,0.356322,37.2644,76.4442,87,4
South Africa,190,234.274,7.4,0.373684,232.363,7.33158,0.342105,40,GC Smith,0,0,0,0,0,0,0,0,12,6,18,12,6,18,153,165,1,0,1,3.97,0.29,33.57,79.6819,100,4
Sri Lanka,244,223.373,7.09016,0.344262,227.578,7.47541,0.385246,41,WU Tharanga,0,0,0,0,0,0,0,0,8,10,18,8,10,18,0,235,1,0,1,3.93985,0.263158,32.9699,71.6035,133,4
Sri Lanka,244,223.373,7.09016,0.344262,227.578,7.47541,0.385246,41,ST Jayasuriya,0,0,0,0,0,0,0,0,8,10,18,8,10,18,0,235,1,0,1,4.91549,0.211268,33.9859,98.4898,71,0
England,221,237.176,7.17647,0.289593,230.633,7.45701,0.384615,41,EC Joyce,0,0,0,0,0,0,0,0,4,7,11,4,7,11,236,233,0,0,1,3.08571,0.2,28.3429,68.6505,35,4
England,221,237.176,7.17647,0.289593,230.633,7.45701,0.384615,41,MP Vaughan,0,0,0,0,0,0,0,0,4,7,11,4,7,11,236,233,0,0,1,2.6,0.1,20.6,66.4516,10,1
England,221,237.176,7.17647,0.289593,230.633,7.45701,0.384615,41,IR Bell,0,0,0,0,0,0,0,0,4,7,11,4,7,11,236,233,0,0,1,3.63433,0.246269,35.3806,75.6623,134,4
Bangladesh,160,218.438,7.70625,0.4,211.106,7.05,0.325,42,Javed Omar,0,0,0,0,0,0,0,0,8,3,11,8,3,11,0,251,2,0,1,2.66667,0.166667,24.3333,48.0263,6,3
Bangladesh,160,218.438,7.70625,0.4,211.106,7.05,0.325,42,Tamim Iqbal,0,0,0,0,0,0,0,0,8,3,11,8,3,11,0,251,2,0,1,4.05344,0.274809,31.8015,76.8068,131,4
South Africa,190,234.274,7.4,0.373684,232.363,7.33158,0.342105,42,GC Smith,0,0,0,0,0,0,0,0,4,13,17,4,13,17,252,184,1,0,1,3.97,0.29,33.57,79.6819,100,4
South Africa,190,234.274,7.4,0.373684,232.363,7.33158,0.342105,42,AB de Villiers,0,0,0,0,0,0,0,0,4,13,17,4,13,17,252,184,1,0,1,5.04969,0.403727,47.2174,98.8428,161,4
England,221,237.176,7.17647,0.289593,230.633,7.45701,0.384615,43,IR Bell,0,0,0,0,0,0,0,0,4,12,16,4,12,16,0,247,2,0,1,3.63433,0.246269,35.3806,75.6623,134,4
England,221,237.176,7.17647,0.289593,230.633,7.45701,0.384615,43,MP Vaughan,0,0,0,0,0,0,0,0,4,12,16,4,12,16,0,247,2,0,1,2.6,0.1,20.6,66.4516,10,1
England,221,237.176,7.17647,0.289593,230.633,7.45701,0.384615,43,AJ Strauss,0,0,0,0,0,0,0,0,4,12,16,4,12,16,0,247,2,0,1,3.93243,0.27027,33.9054,79.8028,74,4
Australia,228,239.627,7.69737,0.372807,232.079,7.23246,0.337719,43,AC Gilchrist,0,0,0,0,0,0,0,0,20,0,20,20,0,20,248,248,4,0,1,4.3,0.275,31.425,96.1009,40,0
Australia,228,239.627,7.69737,0.372807,232.079,7.23246,0.337719,43,ML Hayden,0,0,0,0,0,0,0,0,20,0,20,20,0,20,248,248,4,0,1,6.37838,0.378378,50.6757,83.3333,37,4
New Zealand,184,233.745,7.39674,0.36413,227.951,7.30435,0.353261,44,PG Fulton,0,0,0,0,0,0,0,0,16,10,26,16,10,26,0,263,4,0,1,2.75,0.1875,27.4062,67.4615,32,4
New Zealand,184,233.745,7.39674,0.36413,227.951,7.30435,0.353261,44,SP Fleming,0,0,0,0,0,0,0,0,16,10,26,16,10,26,0,263,4,0,1,3.875,0.25,30.2917,70.9268,24,4
Ireland,55,219.527,7.65455,0.290909,202.727,7.56364,0.4,44,WTS Porterfield,0,0,0,0,0,0,0,0,0,10,10,0,10,10,264,134,4,0,1,2.6,0.142857,24.6857,56.2866,35,3
Ireland,55,219.527,7.65455,0.290909,202.727,7.56364,0.4,44,JP Bray,0,0,0,0,0,0,0,0,0,10,10,0,10,10,264,134,4,0,1,2.7,0.1,23.4,63.0728,10,1
Ireland,55,219.527,7.65455,0.290909,202.727,7.56364,0.4,44,EJG Morgan,0,0,0,0,0,0,0,0,0,10,10,0,10,10,264,134,4,0,1,3.19549,0.233083,30.0526,86.9291,133,4
South Africa,190,234.274,7.4,0.373684,232.363,7.33158,0.342105,45,AB de Villiers,0,0,0,0,0,0,0,0,4,9,13,4,9,13,0,356,5,0,1,5.04969,0.403727,47.2174,98.8428,161,4
South Africa,190,234.274,7.4,0.373684,232.363,7.33158,0.342105,45,GC Smith,0,0,0,0,0,0,0,0,4,9,13,4,9,13,0,356,5,0,1,3.97,0.29,33.57,79.6819,100,4
West Indies,176,217.33,7.15909,0.3125,225.278,7.57386,0.380682,45,CH Gayle,0,0,0,0,0,0,0,0,4,16,20,4,16,20,357,289,0,1,1,4.58621,0.206897,31.1293,89.4255,116,4
West Indies,176,217.33,7.15909,0.3125,225.278,7.57386,0.380682,45,S Chanderpaul,0,0,0,0,0,0,0,0,4,16,20,4,16,20,357,289,0,1,1,3.57143,0.396825,40.8254,68.0783,63,4
West Indies,176,217.33,7.15909,0.3125,225.278,7.57386,0.380682,45,DS Smith,0,0,0,0,0,0,0,0,4,16,20,4,16,20,357,289,0,1,1,2.61765,0.147059,23.5588,71.2,34,4
New Zealand,184,233.745,7.39674,0.36413,227.951,7.30435,0.353261,46,PG Fulton,0,0,0,0,0,0,0,0,0,3,3,0,3,3,0,219,1,0,1,2.75,0.1875,27.4062,67.4615,32,4
New Zealand,184,233.745,7.39674,0.36413,227.951,7.30435,0.353261,46,SP Fleming,0,0,0,0,0,0,0,0,0,3,3,0,3,3,0,219,1,0,1,3.875,0.25,30.2917,70.9268,24,4
New Zealand,184,233.745,7.39674,0.36413,227.951,7.30435,0.353261,46,LRPL Taylor,0,0,0,0,0,0,0,0,0,3,3,0,3,3,0,219,1,0,1,3.68382,0.301471,36.7206,79.3959,136,4
New Zealand,184,233.745,7.39674,0.36413,227.951,7.30435,0.353261,46,SB Styris,0,0,0,0,0,0,0,0,0,3,3,0,3,3,0,219,1,0,1,3.20755,0.264151,33.8302,78.7094,53,4
Sri Lanka,244,223.373,7.09016,0.344262,227.578,7.47541,0.385246,46,WU Tharanga,0,0,0,0,0,0,0,0,8,10,18,8,10,18,220,222,14,0,1,3.93985,0.263158,32.9699,71.6035,133,4
Sri Lanka,244,223.373,7.09016,0.344262,227.578,7.47541,0.385246,46,ST Jayasuriya,0,0,0,0,0,0,0,0,8,10,18,8,10,18,220,222,14,0,1,4.91549,0.211268,33.9859,98.4898,71,0
Sri Lanka,244,223.373,7.09016,0.344262,227.578,7.47541,0.385246,46,KC Sangakkara,0,0,0,0,0,0,0,0,8,10,18,8,10,18,220,222,14,0,1,4.33659,0.360976,41.9854,80.6276,205,4
Ireland,55,219.527,7.65455,0.290909,202.727,7.56364,0.4,47,JP Bray,0,0,0,0,0,0,0,0,8,3,11,8,3,11,0,91,2,0,1,2.7,0.1,23.4,63.0728,10,1
Ireland,55,219.527,7.65455,0.290909,202.727,7.56364,0.4,47,WTS Porterfield,0,0,0,0,0,0,0,0,8,3,11,8,3,11,0,91,2,0,1,2.6,0.142857,24.6857,56.2866,35,3
Ireland,55,219.527,7.65455,0.290909,202.727,7.56364,0.4,47,EJG Morgan,0,0,0,0,0,0,0,0,8,3,11,8,3,11,0,91,2,0,1,3.19549,0.233083,30.0526,86.9291,133,4
Ireland,55,219.527,7.65455,0.290909,202.727,7.56364,0.4,47,NJ O'Brien,0,0,0,0,0,0,0,0,8,3,11,8,3,11,0,91,2,0,1,2.55882,0.176471,25.5882,69.378,34,4
Ireland,55,219.527,7.65455,0.290909,202.727,7.56364,0.4,47,KJ O'Brien,0,0,0,0,0,0,0,0,8,3,11,8,3,11,0,91,2,0,1,2.64706,0.0588235,22.3824,79.4363,34,4
Ireland,55,219.527,7.65455,0.290909,202.727,7.56364,0.4,47,AR White,0,0,0,0,0,0,0,0,8,3,11,8,3,11,0,91,2,0,1,1.17647,0,14.1765,59.9502,17,1
Australia,228,239.627,7.69737,0.372807,232.079,7.23246,0.337719,47,AC Gilchrist,0,0,0,0,0,0,0,0,12,18,30,12,18,30,92,92,9,0,1,4.3,0.275,31.425,96.1009,40,0
Australia,228,239.627,7.69737,0.372807,232.079,7.23246,0.337719,47,MEK Hussey,0,0,0,0,0,0,0,0,12,18,30,12,18,30,92,92,9,0,1,2.7563,0.260504,34.084,82.4893,119,4
South Africa,190,234.274,7.4,0.373684,232.363,7.33158,0.342105,48,GC Smith,0,0,0,0,0,0,0,0,0,3,3,0,3,3,0,193,2,0,1,3.97,0.29,33.57,79.6819,100,4
South Africa,190,234.274,7.4,0.373684,232.363,7.33158,0.342105,48,JH Kallis,0,0,0,0,0,0,0,0,0,3,3,0,3,3,0,193,2,0,1,3.58621,0.356322,37.2644,76.4442,87,4
South Africa,190,234.274,7.4,0.373684,232.363,7.33158,0.342105,48,AB de Villiers,0,0,0,0,0,0,0,0,0,3,3,0,3,3,0,193,2,0,1,5.04969,0.403727,47.2174,98.8428,161,4
South Africa,190,234.274,7.4,0.373684,232.363,7.33158,0.342105,48,HH Gibbs,0,0,0,0,0,0,0,0,0,3,3,0,3,3,0,193,2,0,1,4.61538,0.307692,35.6923,83.4157,52,4
New Zealand,184,233.745,7.39674,0.36413,227.951,7.30435,0.353261,48,PG Fulton,0,0,0,0,0,0,0,0,4,7,11,4,7,11,194,196,1,0,1,2.75,0.1875,27.4062,67.4615,32,4
New Zealand,184,233.745,7.39674,0.36413,227.951,7.30435,0.353261,48,SP Fleming,0,0,0,0,0,0,0,0,4,7,11,4,7,11,194,196,1,0,1,3.875,0.25,30.2917,70.9268,24,4
Ireland,55,219.527,7.65455,0.290909,202.727,7.56364,0.4,49,WTS Porterfield,0,0,0,0,0,0,0,0,4,15,19,4,15,19,0,243,4,0,1,2.6,0.142857,24.6857,56.2866,35,3
Ireland,55,219.527,7.65455,0.290909,202.727,7.56364,0.4,49,JP Bray,0,0,0,0,0,0,0,0,4,15,19,4,15,19,0,243,4,0,1,2.7,0.1,23.4,63.0728,10,1
Bangladesh,160,218.438,7.70625,0.4,211.106,7.05,0.325,49,Tamim Iqbal,0,0,0,0,0,0,0,0,4,5,9,4,5,9,244,169,9,0,1,4.05344,0.274809,31.8015,76.8068,131,4
Bangladesh,160,218.438,7.70625,0.4,211.106,7.05,0.325,49,Shahriar Nafees,0,0,0,0,0,0,0,0,4,5,9,4,5,9,244,169,9,0,1,3.40541,0.162162,24.4865,69.1076,37,4
Sri Lanka,244,223.373,7.09016,0.344262,227.578,7.47541,0.385246,50,WU Tharanga,0,0,0,0,0,0,0,0,8,9,17,8,9,17,0,226,9,0,1,3.93985,0.263158,32.9699,71.6035,133,4
Sri Lanka,244,223.373,7.09016,0.344262,227.578,7.47541,0.385246,50,ST Jayasuriya,0,0,0,0,0,0,0,0,8,9,17,8,9,17,0,226,9,0,1,4.91549,0.211268,33.9859,98.4898,71,0
Sri Lanka,244,223.373,7.09016,0.344262,227.578,7.47541,0.385246,50,KC Sangakkara,0,0,0,0,0,0,0,0,8,9,17,8,9,17,0,226,9,0,1,4.33659,0.360976,41.9854,80.6276,205,4
Australia,228,239.627,7.69737,0.372807,232.079,7.23246,0.337719,50,AC Gilchrist,0,0,0,0,0,0,0,0,8,5,13,8,5,13,227,232,5,0,1,4.3,0.275,31.425,96.1009,40,0
Australia,228,239.627,7.69737,0.372807,232.079,7.23246,0.337719,50,ML Hayden,0,0,0,0,0,0,0,0,8,5,13,8,5,13,227,232,5,0,1,6.37838,0.378378,50.6757,83.3333,37,4
England,221,237.176,7.17647,0.289593,230.633,7.45701,0.384615,51,IR Bell,0,0,0,0,0,0,0,0,4,1,5,4,1,5,0,154,0,0,1,3.63433,0.246269,35.3806,75.6623,134,4
England,221,237.176,7.17647,0.289593,230.633,7.45701,0.384615,51,MP Vaughan,0,0,0,0,0,0,0,0,4,1,5,4,1,5,0,154,0,0,1,2.6,0.1,20.6,66.4516,10,1
South Africa,190,234.274,7.4,0.373684,232.363,7.33158,0.342105,51,AB de Villiers,0,0,0,0,0,0,0,0,20,22,42,20,22,42,155,157,2,0,1,5.04969,0.403727,47.2174,98.8428,161,4
South Africa,190,234.274,7.4,0.373684,232.363,7.33158,0.342105,51,GC Smith,0,0,0,0,0,0,0,0,20,22,42,20,22,42,155,157,2,0,1,3.97,0.29,33.57,79.6819,100,4
Ireland,55,219.527,7.65455,0.290909,202.727,7.56364,0.4,52,JP Bray,0,0,0,0,0,0,0,0,4,6,10,4,6,10,0,77,1,0,1,2.7,0.1,23.4,63.0728,10,1
Ireland,55,219.527,7.65455,0.290909,202.727,7.56364,0.4,52,WTS Porterfield,0,0,0,0,0,0,0,0,4,6,10,4,6,10,0,77,1,0,1,2.6,0.142857,24.6857,56.2866,35,3
Sri Lanka,244,223.373,7.09016,0.344262,227.578,7.47541,0.385246,52,WU Tharanga,0,0,0,0,0,0,0,0,22,11,33,22,11,33,78,81,8,0,1,3.93985,0.263158,32.9699,71.6035,133,4
Sri Lanka,244,223.373,7.09016,0.344262,227.578,7.47541,0.385246,52,ST Jayasuriya,0,0,0,0,0,0,0,0,22,11,33,22,11,33,78,81,8,0,1,4.91549,0.211268,33.9859,98.4898,71,0
Sri Lanka,244,223.373,7.09016,0.344262,227.578,7.47541,0.385246,52,KC Sangakkara,0,0,0,0,0,0,0,0,22,11,33,22,11,33,78,81,8,0,1,4.33659,0.360976,41.9854,80.6276,205,4
Sri Lanka,244,223.373,7.09016,0.344262,227.578,7.47541,0.385246,52,DPMD Jayawardene,0,0,0,0,0,0,0,0,22,11,33,22,11,33,78,81,8,0,1,3.20833,0.244792,31.6979,79.1109,192,4
West Indies,176,217.33,7.15909,0.3125,225.278,7.57386,0.380682,53,CH Gayle,0,0,0,0,0,0,0,0,4,8,12,4,8,12,0,230,2,1,1,4.58621,0.206897,31.1293,89.4255,116,4
West Indies,176,217.33,7.15909,0.3125,225.278,7.57386,0.380682,53,DS Smith,0,0,0,0,0,0,0,0,4,8,12,4,8,12,0,230,2,1,1,2.61765,0.147059,23.5588,71.2,34,4
West Indies,176,217.33,7.15909,0.3125,225.278,7.57386,0.380682,53,MN Samuels,0,0,0,0,0,0,0,0,4,8,12,4,8,12,0,230,2,1,1,3.74757,0.23301,31.6214,74.5821,103,4
West Indies,176,217.33,7.15909,0.3125,225.278,7.57386,0.380682,53,S Chanderpaul,0,0,0,0,0,0,0,0,4,8,12,4,8,12,0,230,2,1,1,3.57143,0.396825,40.8254,68.0783,63,4
Bangladesh,160,218.438,7.70625,0.4,211.106,7.05,0.325,53,Javed Omar,0,0,0,0,0,0,0,0,0,3,3,0,3,3,231,131,1,0,1,2.66667,0.166667,24.3333,48.0263,6,3
Bangladesh,160,218.438,7.70625,0.4,211.106,7.05,0.325,53,Tamim Iqbal,0,0,0,0,0,0,0,0,0,3,3,0,3,3,231,131,1,0,1,4.05344,0.274809,31.8015,76.8068,131,4
Australia,228,239.627,7.69737,0.372807,232.079,7.23246,0.337719,54,AC Gilchrist,0,0,0,0,0,0,0,0,24,6,30,24,6,30,0,348,2,0,1,4.3,0.275,31.425,96.1009,40,0
Australia,228,239.627,7.69737,0.372807,232.079,7.23246,0.337719,54,ML Hayden,0,0,0,0,0,0,0,0,24,6,30,24,6,30,0,348,2,0,1,6.37838,0.378378,50.6757,83.3333,37,4
Australia,228,239.627,7.69737,0.372807,232.079,7.23246,0.337719,54,RT Ponting,0,0,0,0,0,0,0,0,24,6,30,24,6,30,0,348,2,0,1,4.17431,0.33945,38.1009,80.8606,109,4
New Zealand,184,233.745,7.39674,0.36413,227.951,7.30435,0.353261,54,PG Fulton,0,0,0,0,0,0,0,0,14,14,28,14,14,28,349,133,1,0,1,2.75,0.1875,27.4062,67.4615,32,4
New Zealand,184,233.745,7.39674,0.36413,227.951,7.30435,0.353261,54,SP Fleming,0,0,0,0,0,0,0,0,14,14,28,14,14,28,349,133,1,0,1,3.875,0.25,30.2917,70.9268,24,4
New Zealand,184,233.745,7.39674,0.36413,227.951,7.30435,0.353261,54,LRPL Taylor,0,0,0,0,0,0,0,0,14,14,28,14,14,28,349,133,1,0,1,3.68382,0.301471,36.7206,79.3959,136,4
Sri Lanka,244,223.373,7.09016,0.344262,227.578,7.47541,0.385246,55,WU Tharanga,0,0,0,0,0,0,0,0,12,9,21,12,9,21,0,289,5,0,1,3.93985,0.263158,32.9699,71.6035,133,4
Sri Lanka,244,223.373,7.09016,0.344262,227.578,7.47541,0.385246,55,ST Jayasuriya,0,0,0,0,0,0,0,0,12,9,21,12,9,21,0,289,5,0,1,4.91549,0.211268,33.9859,98.4898,71,0
Sri Lanka,244,223.373,7.09016,0.344262,227.578,7.47541,0.385246,55,KC Sangakkara,0,0,0,0,0,0,0,0,12,9,21,12,9,21,0,289,5,0,1,4.33659,0.360976,41.9854,80.6276,205,4
New Zealand,184,233.745,7.39674,0.36413,227.951,7.30435,0.353261,55,PG Fulton,0,0,0,0,0,0,0,0,0,6,6,0,6,6,290,208,4,0,1,2.75,0.1875,27.4062,67.4615,32,4
New Zealand,184,233.745,7.39674,0.36413,227.951,7.30435,0.353261,55,SP Fleming,0,0,0,0,0,0,0,0,0,6,6,0,6,6,290,208,4,0,1,3.875,0.25,30.2917,70.9268,24,4
New Zealand,184,233.745,7.39674,0.36413,227.951,7.30435,0.353261,55,LRPL Taylor,0,0,0,0,0,0,0,0,0,6,6,0,6,6,290,208,4,0,1,3.68382,0.301471,36.7206,79.3959,136,4
South Africa,190,234.274,7.4,0.373684,232.363,7.33158,0.342105,56,GC Smith,0,0,0,0,0,0,0,0,4,3,7,4,3,7,0,149,1,0,1,3.97,0.29,33.57,79.6819,100,4
South Africa,190,234.274,7.4,0.373684,232.363,7.33158,0.342105,56,AB de Villiers,0,0,0,0,0,0,0,0,4,3,7,4,3,7,0,149,1,0,1,5.04969,0.403727,47.2174,98.8428,161,4
South Africa,190,234.274,7.4,0.373684,232.363,7.33158,0.342105,56,JH Kallis,0,0,0,0,0,0,0,0,4,3,7,4,3,7,0,149,1,0,1,3.58621,0.356322,37.2644,76.4442,87,4
Australia,228,239.627,7.69737,0.372807,232.079,7.23246,0.337719,56,AC Gilchrist,0,0,0,0,0,0,0,0,20,5,25,20,5,25,150,153,2,0,1,4.3,0.275,31.425,96.1009,40,0
Australia,228,239.627,7.69737,0.372807,232.079,7.23246,0.337719,56,ML Hayden,0,0,0,0,0,0,0,0,20,5,25,20,5,25,150,153,2,0,1,6.37838,0.378378,50.6757,83.3333,37,4
Australia,228,239.627,7.69737,0.372807,232.079,7.23246,0.337719,56,RT Ponting,0,0,0,0,0,0,0,0,20,5,25,20,5,25,150,153,2,0,1,4.17431,0.33945,38.1009,80.8606,109,4
Australia,228,239.627,7.69737,0.372807,232.079,7.23246,0.337719,57,AC Gilchrist,0,0,0,0,0,0,0,0,18,7,25,18,7,25,0,281,1,0,1,4.3,0.275,31.425,96.1009,40,0
Australia,228,239.627,7.69737,0.372807,232.079,7.23246,0.337719,57,ML Hayden,0,0,0,0,0,0,0,0,18,7,25,18,7,25,0,281,1,0,1,6.37838,0.378378,50.6757,83.3333,37,4
Sri Lanka,244,223.373,7.09016,0.344262,227.578,7.47541,0.385246,57,WU Tharanga,0,0,0,0,0,0,0,0,12,4,16,12,4,16,282,215,2,0,1,3.93985,0.263158,32.9699,71.6035,133,4
Sri Lanka,244,223.373,7.09016,0.344262,227.578,7.47541,0.385246,57,ST Jayasuriya,0,0,0,0,0,0,0,0,12,4,16,12,4,16,282,215,2,0,1,4.91549,0.211268,33.9859,98.4898,71,0
Sri Lanka,244,223.373,7.09016,0.344262,227.578,7.47541,0.385246,57,KC Sangakkara,0,0,0,0,0,0,0,0,12,4,16,12,4,16,282,215,2,0,1,4.33659,0.360976,41.9854,80.6276,205,4
Zimbabwe,142,212.077,7.5,0.380282,227.704,6.97887,0.316901,58,T Duffin,0,0,0,0,0,0,0,0,16,10,26,16,10,26,0,197,2,1,1,4,0.25,35.75,62.1739,4,4
Zimbabwe,142,212.077,7.5,0.380282,227.704,6.97887,0.316901,58,V Sibanda,0,0,0,0,0,0,0,0,16,10,26,16,10,26,0,197,2,1,1,2.9697,0.181818,23.5152,63.5545,66,1
Bangladesh,160,218.438,7.70625,0.4,211.106,7.05,0.325,58,Rajin Saleh,0,0,0,0,0,0,0,0,8,5,13,8,5,13,198,201,0,0,1,3.5,0,21.5,53.0864,2,3
Bangladesh,160,218.438,7.70625,0.4,211.106,7.05,0.325,58,Shahriar Nafees,0,0,0,0,0,0,0,0,8,5,13,8,5,13,198,201,0,0,1,3.40541,0.162162,24.4865,69.1076,37,4
South Africa,190,234.274,7.4,0.373684,232.363,7.33158,0.342105,59,GC Smith,0,0,0,0,0,0,0,0,8,10,18,8,10,18,0,248,4,1,1,3.97,0.29,33.57,79.6819,100,4
South Africa,190,234.274,7.4,0.373684,232.363,7.33158,0.342105,59,LE Bosman,0,0,0,0,0,0,0,0,8,10,18,8,10,18,0,248,4,1,1,4.18182,0.181818,27.1818,97.7124,11,0
South Africa,190,234.274,7.4,0.373684,232.363,7.33158,0.342105,59,JH Kallis,0,0,0,0,0,0,0,0,8,10,18,8,10,18,0,248,4,1,1,3.58621,0.356322,37.2644,76.4442,87,4
India,259,242.378,7.15058,0.339768,244.568,7.12741,0.30888,59,W Jaffer,0,0,0,0,0,0,0,0,8,8,16,8,8,16,249,91,1,0,1,1,0,5,43.4783,2,3
India,259,242.378,7.15058,0.339768,244.568,7.12741,0.30888,59,M Kaif,0,0,0,0,0,0,0,0,8,8,16,8,8,16,249,91,1,0,1,1.77778,0.222222,23.8889,61.4286,9,1
India,259,242.378,7.15058,0.339768,244.568,7.12741,0.30888,59,SR Tendulkar,0,0,0,0,0,0,0,0,8,8,16,8,8,16,249,91,1,0,1,5.89773,0.363636,45.6023,84.5376,88,4
South Africa,190,234.274,7.4,0.373684,232.363,7.33158,0.342105,60,GC Smith,0,0,0,0,0,0,0,0,8,1,9,8,1,9,0,274,1,1,1,3.97,0.29,33.57,79.6819,100,4
South Africa,190,234.274,7.4,0.373684,232.363,7.33158,0.342105,60,JH Kallis,0,0,0,0,0,0,0,0,8,1,9,8,1,9,0,274,1,1,1,3.58621,0.356322,37.2644,76.4442,87,4
South Africa,190,234.274,7.4,0.373684,232.363,7.33158,0.342105,60,HH Gibbs,0,0,0,0,0,0,0,0,8,1,9,8,1,9,0,274,1,1,1,4.61538,0.307692,35.6923,83.4157,52,4
South Africa,190,234.274,7.4,0.373684,232.363,7.33158,0.342105,60,LE Bosman,0,0,0,0,0,0,0,0,8,1,9,8,1,9,0,274,1,1,1,4.18182,0.181818,27.1818,97.7124,11,0
India,259,242.378,7.15058,0.339768,244.568,7.12741,0.30888,60,V Sehwag,0,0,0,0,0,0,0,0,0,7,7,0,7,7,275,168,0,0,1,5.88636,0.238636,38.8295,108.649,88,0
India,259,242.378,7.15058,0.339768,244.568,7.12741,0.30888,60,R Dravid,0,0,0,0,0,0,0,0,0,7,7,0,7,7,275,168,0,0,1,2.83721,0.255814,29.8605,72.7067,43,4
India,259,242.378,7.15058,0.339768,244.568,7.12741,0.30888,60,SR Tendulkar,0,0,0,0,0,0,0,0,0,7,7,0,7,7,275,168,0,0,1,5.89773,0.363636,45.6023,84.5376,88,4
India,259,242.378,7.15058,0.339768,244.568,7.12741,0.30888,60,M Kaif,0,0,0,0,0,0,0,0,0,7,7,0,7,7,275,168,0,0,1,1.77778,0.222222,23.8889,61.4286,9,1
South Africa,190,234.274,7.4,0.373684,232.363,7.33158,0.342105,61,GC Smith,0,0,0,0,0,0,0,0,4,3,7,4,3,7,0,243,0,1,1,3.97,0.29,33.57,79.6819,100,4
South Africa,190,234.274,7.4,0.373684,232.363,7.33158,0.342105,61,JH Kallis,0,0,0,0,0,0,0,0,4,3,7,4,3,7,0,243,0,1,1,3.58621,0.356322,37.2644,76.4442,87,4
South Africa,190,234.274,7.4,0.373684,232.363,7.33158,0.342105,61,LE Bosman,0,0,0,0,0,0,0,0,4,3,7,4,3,7,0,243,0,1,1,4.18182,0.181818,27.1818,97.7124,11,0
South Africa,190,234.274,7.4,0.373684,232.363,7.33158,0.342105,61,HH Gibbs,0,0,0,0,0,0,0,0,4,3,7,4,3,7,0,243,0,1,1,4.61538,0.307692,35.6923,83.4157,52,4
India,259,242.378,7.15058,0.339768,244.568,7.12741,0.30888,61,W Jaffer,0,0,0,0,0,0,0,0,16,6,22,16,6,22,244,163,0,0,1,1,0,5,43.4783,2,3
India,259,242.378,7.15058,0.339768,244.568,7.12741,0.30888,61,V Sehwag,0,0,0,0,0,0,0,0,16,6,22,16,6,22,244,163,0,0,1,5.88636,0.238636,38.8295,108.649,88,0
India,259,242.378,7.15058,0.339768,244.568,7.12741,0.30888,62,V Sehwag,0,0,0,0,0,0,0,0,8,3,11,8,3,11,0,200,6,0,1,5.88636,0.238636,38.8295,108.649,88,0
India,259,242.378,7.15058,0.339768,244.568,7.12741,0.30888,62,SR Tendulkar,0,0,0,0,0,0,0,0,8,3,11,8,3,11,0,200,6,0,1,5.89773,0.363636,45.6023,84.5376,88,4
South Africa,190,234.274,7.4,0.373684,232.363,7.33158,0.342105,62,AB de Villiers,0,0,0,0,0,0,0,0,16,6,22,16,6,22,201,201,5,1,1,5.04969,0.403727,47.2174,98.8428,161,4
South Africa,190,234.274,7.4,0.373684,232.363,7.33158,0.342105,62,GC Smith,0,0,0,0,0,0,0,0,16,6,22,16,6,22,201,201,5,1,1,3.97,0.29,33.57,79.6819,100,4
Australia,228,239.627,7.69737,0.372807,232.079,7.23246,0.337719,63,AC Gilchrist,0,0,0,0,0,0,0,0,16,10,26,16,10,26,0,289,2,1,1,4.3,0.275,31.425,96.1009,40,0
Australia,228,239.627,7.69737,0.372807,232.079,7.23246,0.337719,63,ML Hayden,0,0,0,0,0,0,0,0,16,10,26,16,10,26,0,289,2,1,1,6.37838,0.378378,50.6757,83.3333,37,4
New Zealand,184,233.745,7.39674,0.36413,227.951,7.30435,0.353261,63,BB McCullum,0,0,0,0,0,0,0,0,4,6,10,4,6,10,290,184,0,0,1,3.98611,0.201389,29.9028,98.4004,144,0
New Zealand,184,233.745,7.39674,0.36413,227.951,7.30435,0.353261,63,NJ Astle,0,0,0,0,0,0,0,0,4,6,10,4,6,10,290,184,0,0,1,2.8,0.1,20,67.5676,10,1
New Zealand,184,233.745,7.39674,0.36413,227.951,7.30435,0.353261,63,SP Fleming,0,0,0,0,0,0,0,0,4,6,10,4,6,10,290,184,0,0,1,3.875,0.25,30.2917,70.9268,24,4
New Zealand,184,233.745,7.39674,0.36413,227.951,7.30435,0.353261,63,LRPL Taylor,0,0,0,0,0,0,0,0,4,6,10,4,6,10,290,184,0,0,1,3.68382,0.301471,36.7206,79.3959,136,4
Australia,228,239.627,7.69737,0.372807,232.079,7.23246,0.337719,64,AC Gilchrist,0,0,0,0,0,0,0,0,12,4,16,12,4,16,0,343,12,1,1,4.3,0.275,31.425,96.1009,40,0
Australia,228,239.627,7.69737,0.372807,232.079,7.23246,0.337719,64,ML Hayden,0,0,0,0,0,0,0,0,12,4,16,12,4,16,0,343,12,1,1,6.37838,0.378378,50.6757,83.3333,37,4
New Zealand,184,233.745,7.39674,0.36413,227.951,7.30435,0.353261,64,L Vincent,0,0,0,0,0,0,0,0,4,8,12,4,8,12,344,335,1,0,1,3.125,0.25,27.8125,67.5266,16,4
New Zealand,184,233.745,7.39674,0.36413,227.951,7.30435,0.353261,64,SP Fleming,0,0,0,0,0,0,0,0,4,8,12,4,8,12,344,335,1,0,1,3.875,0.25,30.2917,70.9268,24,4
New Zealand,184,233.745,7.39674,0.36413,227.951,7.30435,0.353261,65,L Vincent,0,0,0,0,0,0,0,0,4,13,17,4,13,17,0,290,2,0,1,3.125,0.25,27.8125,67.5266,16,4
New Zealand,184,233.745,7.39674,0.36413,227.951,7.30435,0.353261,65,SP Fleming,0,0,0,0,0,0,0,0,4,13,17,4,13,17,0,290,2,0,1,3.875,0.25,30.2917,70.9268,24,4
New Zealand,184,233.745,7.39674,0.36413,227.951,7.30435,0.353261,65,PG Fulton,0,0,0,0,0,0,0,0,4,13,17,4,13,17,0,290,2,0,1,2.75,0.1875,27.4062,67.4615,32,4
Australia,228,239.627,7.69737,0.372807,232.079,7.23246,0.337719,65,AC Gilchrist,0,0,0,0,0,0,0,0,16,10,26,16,10,26,291,291,1,1,1,4.3,0.275,31.425,96.1009,40,0
Australia,228,239.627,7.69737,0.372807,232.079,7.23246,0.337719,65,ML Hayden,0,0,0,0,0,0,0,0,16,10,26,16,10,26,291,291,1,1,1,6.37838,0.378378,50.6757,83.3333,37,4
England,221,237.176,7.17647,0.289593,230.633,7.45701,0.384615,66,AJ Strauss,0,0,0,0,0,0,0,0,8,10,18,8,10,18,0,242,2,0,1,3.93243,0.27027,33.9054,79.8028,74,4
England,221,237.176,7.17647,0.289593,230.633,7.45701,0.384615,66,MP Vaughan,0,0,0,0,0,0,0,0,8,10,18,8,10,18,0,242,2,0,1,2.6,0.1,20.6,66.4516,10,1
Australia,228,239.627,7.69737,0.372807,232.079,7.23246,0.337719,66,AC Gilchrist,0,0,0,0,0,0,0,0,8,8,16,8,8,16,243,246,16,1,1,4.3,0.275,31.425,96.1009,40,0
Australia,228,239.627,7.69737,0.372807,232.079,7.23246,0.337719,66,ML Hayden,0,0,0,0,0,0,0,0,8,8,16,8,8,16,243,246,16,1,1,6.37838,0.378378,50.6757,83.3333,37,4
England,221,237.176,7.17647,0.289593,230.633,7.45701,0.384615,67,AJ Strauss,0,0,0,0,0,0,0,0,10,13,23,10,13,23,0,155,1,0,1,3.93243,0.27027,33.9054,79.8028,74,4
England,221,237.176,7.17647,0.289593,230.633,7.45701,0.384615,67,MB Loye,0,0,0,0,0,0,0,0,10,13,23,10,13,23,0,155,1,0,1,3.42857,0,20.2857,74.7368,7,1
Australia,228,239.627,7.69737,0.372807,232.079,7.23246,0.337719,67,AC Gilchrist,0,0,0,0,0,0,0,0,8,8,16,8,8,16,156,156,5,1,1,4.3,0.275,31.425,96.1009,40,0
Australia,228,239.627,7.69737,0.372807,232.079,7.23246,0.337719,67,ML Hayden,0,0,0,0,0,0,0,0,8,8,16,8,8,16,156,156,5,1,1,6.37838,0.378378,50.6757,83.3333,37,4
England,221,237.176,7.17647,0.289593,230.633,7.45701,0.384615,68,AJ Strauss,0,0,0,0,0,0,0,0,6,7,13,6,7,13,0,110,1,0,1,3.93243,0.27027,33.9054,79.8028,74,4
England,221,237.176,7.17647,0.289593,230.633,7.45701,0.384615,68,MB Loye,0,0,0,0,0,0,0,0,6,7,13,6,7,13,0,110,1,0,1,3.42857,0,20.2857,74.7368,7,1
England,221,237.176,7.17647,0.289593,230.633,7.45701,0.384615,68,IR Bell,0,0,0,0,0,0,0,0,6,7,13,6,7,13,0,110,1,0,1,3.63433,0.246269,35.3806,75.6623,134,4
Australia,228,239.627,7.69737,0.372807,232.079,7.23246,0.337719,68,AC Gilchrist,0,0,0,0,0,0,0,0,16,6,22,16,6,22,111,111,5,1,1,4.3,0.275,31.425,96.1009,40,0
Australia,228,239.627,7.69737,0.372807,232.079,7.23246,0.337719,68,ML Hayden,0,0,0,0,0,0,0,0,16,6,22,16,6,22,111,111,5,1,1,6.37838,0.378378,50.6757,83.3333,37,4
England,221,237.176,7.17647,0.289593,230.633,7.45701,0.384615,69,EC Joyce,0,0,0,0,0,0,0,0,4,9,13,4,9,13,0,292,4,0,1,3.08571,0.2,28.3429,68.6505,35,4
England,221,237.176,7.17647,0.289593,230.633,7.45701,0.384615,69,MB Loye,0,0,0,0,0,0,0,0,4,9,13,4,9,13,0,292,4,0,1,3.42857,0,20.2857,74.7368,7,1
Australia,228,239.627,7.69737,0.372807,232.079,7.23246,0.337719,69,AC Gilchrist,0,0,0,0,0,0,0,0,8,6,14,8,6,14,293,200,5,1,1,4.3,0.275,31.425,96.1009,40,0
Australia,228,239.627,7.69737,0.372807,232.079,7.23246,0.337719,69,BJ Hodge,0,0,0,0,0,0,0,0,8,6,14,8,6,14,293,200,5,1,1,2.76923,0.153846,26.4615,83.9024,13,4
Australia,228,239.627,7.69737,0.372807,232.079,7.23246,0.337719,69,ML Hayden,0,0,0,0,0,0,0,0,8,6,14,8,6,14,293,200,5,1,1,6.37838,0.378378,50.6757,83.3333,37,4
Australia,228,239.627,7.69737,0.372807,232.079,7.23246,0.337719,69,MJ Clarke,0,0,0,0,0,0,0,0,8,6,14,8,6,14,293,200,5,1,1,3.10294,0.301471,35.9265,74.0303,136,4
New Zealand,184,233.745,7.39674,0.36413,227.951,7.30435,0.353261,70,BB McCullum,0,0,0,0,0,0,0,0,22,3,25,22,3,25,0,205,0,0,1,3.98611,0.201389,29.9028,98.4004,144,0
New Zealand,184,233.745,7.39674,0.36413,227.951,7.30435,0.353261,70,NJ Astle,0,0,0,0,0,0,0,0,22,3,25,22,3,25,0,205,0,0,1,2.8,0.1,20,67.5676,10,1
England,221,237.176,7.17647,0.289593,230.633,7.45701,0.384615,70,AJ Strauss,0,0,0,0,0,0,0,0,8,3,11,8,3,11,206,206,2,0,1,3.93243,0.27027,33.9054,79.8028,74,4
England,221,237.176,7.17647,0.289593,230.633,7.45701,0.384615,70,MP Vaughan,0,0,0,0,0,0,0,0,8,3,11,8,3,11,206,206,2,0,1,2.6,0.1,20.6,66.4516,10,1
New Zealand,184,233.745,7.39674,0.36413,227.951,7.30435,0.353261,71,SP Fleming,0,0,0,0,0,0,0,0,4,4,8,4,4,8,0,210,4,0,1,3.875,0.25,30.2917,70.9268,24,4
New Zealand,184,233.745,7.39674,0.36413,227.951,7.30435,0.353261,71,NJ Astle,0,0,0,0,0,0,0,0,4,4,8,4,4,8,0,210,4,0,1,2.8,0.1,20,67.5676,10,1
New Zealand,184,233.745,7.39674,0.36413,227.951,7.30435,0.353261,71,PG Fulton,0,0,0,0,0,0,0,0,4,4,8,4,4,8,0,210,4,0,1,2.75,0.1875,27.4062,67.4615,32,4
England,221,237.176,7.17647,0.289593,230.633,7.45701,0.384615,71,AJ Strauss,0,0,0,0,0,0,0,0,8,9,17,8,9,17,211,120,2,0,1,3.93243,0.27027,33.9054,79.8028,74,4
England,221,237.176,7.17647,0.289593,230.633,7.45701,0.384615,71,MB Loye,0,0,0,0,0,0,0,0,8,9,17,8,9,17,211,120,2,0,1,3.42857,0,20.2857,74.7368,7,1
New Zealand,184,233.745,7.39674,0.36413,227.951,7.30435,0.353261,72,L Vincent,0,0,0,0,0,0,0,0,16,7,23,16,7,23,0,318,9,0,1,3.125,0.25,27.8125,67.5266,16,4
New Zealand,184,233.745,7.39674,0.36413,227.951,7.30435,0.353261,72,SP Fleming,0,0,0,0,0,0,0,0,16,7,23,16,7,23,0,318,9,0,1,3.875,0.25,30.2917,70.9268,24,4
England,221,237.176,7.17647,0.289593,230.633,7.45701,0.384615,72,EC Joyce,0,0,0,0,0,0,0,0,18,7,25,18,7,25,319,260,2,0,1,3.08571,0.2,28.3429,68.6505,35,4
England,221,237.176,7.17647,0.289593,230.633,7.45701,0.384615,72,MB Loye,0,0,0,0,0,0,0,0,18,7,25,18,7,25,319,260,2,0,1,3.42857,0,20.2857,74.7368,7,1
England,221,237.176,7.17647,0.289593,230.633,7.45701,0.384615,72,IR Bell,0,0,0,0,0,0,0,0,18,7,25,18,7,25,319,260,2,0,1,3.63433,0.246269,35.3806,75.6623,134,4
Australia,228,239.627,7.69737,0.372807,232.079,7.23246,0.337719,73,AC Gilchrist,0,0,0,0,0,0,0,0,16,7,23,16,7,23,0,252,6,1,1,4.3,0.275,31.425,96.1009,40,0
Australia,228,239.627,7.69737,0.372807,232.079,7.23246,0.337719,73,ML Hayden,0,0,0,0,0,0,0,0,16,7,23,16,7,23,0,252,6,1,1,6.37838,0.378378,50.6757,83.3333,37,4
England,221,237.176,7.17647,0.289593,230.633,7.45701,0.384615,73,EC Joyce,0,0,0,0,0,0,0,0,8,6,14,8,6,14,253,253,0,0,1,3.08571,0.2,28.3429,68.6505,35,4
England,221,237.176,7.17647,0.289593,230.633,7.45701,0.384615,73,MB Loye,0,0,0,0,0,0,0,0,8,6,14,8,6,14,253,253,0,0,1,3.42857,0,20.2857,74.7368,7,1
England,221,237.176,7.17647,0.289593,230.633,7.45701,0.384615,73,IR Bell,0,0,0,0,0,0,0,0,8,6,14,8,6,14,253,253,0,0,1,3.63433,0.246269,35.3806,75.6623,134,4
England,221,237.176,7.17647,0.289593,230.633,7.45701,0.384615,74,EC Joyce,0,0,0,0,0,0,0,0,16,3,19,16,3,19,0,246,4,0,1,3.08571,0.2,28.3429,68.6505,35,4
England,221,237.176,7.17647,0.289593,230.633,7.45701,0.384615,74,MB Loye,0,0,0,0,0,0,0,0,16,3,19,16,3,19,0,246,4,0,1,3.42857,0,20.2857,74.7368,7,1
Australia,228,239.627,7.69737,0.372807,232.079,7.23246,0.337719,74,AC Gilchrist,0,0,0,0,0,0,0,0,12,17,29,12,17,29,247,152,6,1,1,4.3,0.275,31.425,96.1009,40,0
Australia,228,239.627,7.69737,0.372807,232.079,7.23246,0.337719,74,ML Hayden,0,0,0,0,0,0,0,0,12,17,29,12,17,29,247,152,6,1,1,6.37838,0.378378,50.6757,83.3333,37,4
Australia,228,239.627,7.69737,0.372807,232.079,7.23246,0.337719,74,RT Ponting,0,0,0,0,0,0,0,0,12,17,29,12,17,29,247,152,6,1,1,4.17431,0.33945,38.1009,80.8606,109,4
Australia,228,239.627,7.69737,0.372807,232.079,7.23246,0.337719,74,MJ Clarke,0,0,0,0,0,0,0,0,12,17,29,12,17,29,247,152,6,1,1,3.10294,0.301471,35.9265,74.0303,136,4
Sri Lanka,244,223.373,7.09016,0.344262,227.578,7.47541,0.385246,78,WU Tharanga,0,0,0,0,0,0,0,0,8,6,14,8,6,14,0,302,4,0,1,3.93985,0.263158,32.9699,71.6035,133,4
Sri Lanka,244,223.373,7.09016,0.344262,227.578,7.47541,0.385246,78,ST Jayasuriya,0,0,0,0,0,0,0,0,8,6,14,8,6,14,0,302,4,0,1,4.91549,0.211268,33.9859,98.4898,71,0
Bangladesh,160,218.438,7.70625,0.4,211.106,7.05,0.325,78,Shahriar Nafees,0,0,0,0,0,0,0,0,4,5,9,4,5,9,303,265,10,0,1,3.40541,0.162162,24.4865,69.1076,37,4
Bangladesh,160,218.438,7.70625,0.4,211.106,7.05,0.325,78,Mohammad Ashraful,0,0,0,0,0,0,0,0,4,5,9,4,5,9,303,265,10,0,1,2.17722,0.113924,19.4557,63.9085,79,1
Zimbabwe,142,212.077,7.5,0.380282,227.704,6.97887,0.316901,79,TV Mufambisi,0,0,0,0,0,0,0,0,4,4,8,4,4,8,0,85,3,0,1,1.5,0,11.25,63.3803,4,1
Zimbabwe,142,212.077,7.5,0.380282,227.704,6.97887,0.316901,79,CJ Chibhabha,0,0,0,0,0,0,0,0,4,4,8,4,4,8,0,85,3,0,1,2.56716,0.149254,23.5373,64.7373,67,1
Zimbabwe,142,212.077,7.5,0.380282,227.704,6.97887,0.316901,79,H Masakadza,0,0,0,0,0,0,0,0,4,4,8,4,4,8,0,85,3,0,1,3.11215,0.186916,26.972,70.0485,107,4
Zimbabwe,142,212.077,7.5,0.380282,227.704,6.97887,0.316901,79,BRM Taylor,0,0,0,0,0,0,0,0,4,4,8,4,4,8,0,85,3,0,1,3.3,0.26,33.56,76.3421,100,4
West Indies,176,217.33,7.15909,0.3125,225.278,7.57386,0.380682,79,CH Gayle,0,0,0,0,0,0,0,0,4,6,10,4,6,10,86,90,9,0,1,4.58621,0.206897,31.1293,89.4255,116,4
West Indies,176,217.33,7.15909,0.3125,225.278,7.57386,0.380682,79,S Chanderpaul,0,0,0,0,0,0,0,0,4,6,10,4,6,10,86,90,9,0,1,3.57143,0.396825,40.8254,68.0783,63,4
Sri Lanka,244,223.373,7.09016,0.344262,227.578,7.47541,0.385246,80,WU Tharanga,0,0,0,0,0,0,0,0,8,7,15,8,7,15,0,285,4,0,1,3.93985,0.263158,32.9699,71.6035,133,4
Sri Lanka,244,223.373,7.09016,0.344262,227.578,7.47541,0.385246,80,ST Jayasuriya,0,0,0,0,0,0,0,0,8,7,15,8,7,15,0,285,4,0,1,4.91549,0.211268,33.9859,98.4898,71,0
Zimbabwe,142,212.077,7.5,0.380282,227.704,6.97887,0.316901,80,TV Mufambisi,0,0,0,0,0,0,0,0,4,6,10,4,6,10,286,141,3,0,1,1.5,0,11.25,63.3803,4,1
Zimbabwe,142,212.077,7.5,0.380282,227.704,6.97887,0.316901,80,CJ Chibhabha,0,0,0,0,0,0,0,0,4,6,10,4,6,10,286,141,3,0,1,2.56716,0.149254,23.5373,64.7373,67,1
Zimbabwe,142,212.077,7.5,0.380282,227.704,6.97887,0.316901,80,H Masakadza,0,0,0,0,0,0,0,0,4,6,10,4,6,10,286,141,3,0,1,3.11215,0.186916,26.972,70.0485,107,4
Bangladesh,160,218.438,7.70625,0.4,211.106,7.05,0.325,81,Shahriar Nafees,0,0,0,0,0,0,0,0,8,5,13,8,5,13,0,161,1,0,1,3.40541,0.162162,24.4865,69.1076,37,4
Bangladesh,160,218.438,7.70625,0.4,211.106,7.05,0.325,81,Mohammad Ashraful,0,0,0,0,0,0,0,0,8,5,13,8,5,13,0,161,1,0,1,2.17722,0.113924,19.4557,63.9085,79,1
Bangladesh,160,218.438,7.70625,0.4,211.106,7.05,0.325,81,Aftab Ahmed,0,0,0,0,0,0,0,0,8,5,13,8,5,13,0,161,1,0,1,2.44118,0.0882353,19.1471,73.8095,34,1
West Indies,176,217.33,7.15909,0.3125,225.278,7.57386,0.380682,81,CH Gayle,0,0,0,0,0,0,0,0,12,6,18,12,6,18,162,164,2,0,1,4.58621,0.206897,31.1293,89.4255,116,4
West Indies,176,217.33,7.15909,0.3125,225.278,7.57386,0.380682,81,S Chanderpaul,0,0,0,0,0,0,0,0,12,6,18,12,6,18,162,164,2,0,1,3.57143,0.396825,40.8254,68.0783,63,4
West Indies,176,217.33,7.15909,0.3125,225.278,7.57386,0.380682,82,CH Gayle,0,0,0,0,0,0,0,0,8,1,9,8,1,9,0,80,6,0,1,4.58621,0.206897,31.1293,89.4255,116,4
West Indies,176,217.33,7.15909,0.3125,225.278,7.57386,0.380682,82,RR Sarwan,0,0,0,0,0,0,0,0,8,1,9,8,1,9,0,80,6,0,1,2.8254,0.222222,29.1429,69.1005,63,4
West Indies,176,217.33,7.15909,0.3125,225.278,7.57386,0.380682,82,S Chanderpaul,0,0,0,0,0,0,0,0,8,1,9,8,1,9,0,80,6,0,1,3.57143,0.396825,40.8254,68.0783,63,4
West Indies,176,217.33,7.15909,0.3125,225.278,7.57386,0.380682,82,BC Lara,0,0,0,0,0,0,0,0,8,1,9,8,1,9,0,80,6,0,1,3.35714,0.178571,29.3571,75.7604,28,4
West Indies,176,217.33,7.15909,0.3125,225.278,7.57386,0.380682,82,WW Hinds,0,0,0,0,0,0,0,0,8,1,9,8,1,9,0,80,6,0,1,1.11111,0,12,38.9892,9,3
Sri Lanka,244,223.373,7.09016,0.344262,227.578,7.47541,0.385246,82,WU Tharanga,0,0,0,0,0,0,0,0,16,6,22,16,6,22,81,83,2,0,1,3.93985,0.263158,32.9699,71.6035,133,4
Sri Lanka,244,223.373,7.09016,0.344262,227.578,7.47541,0.385246,82,DPMD Jayawardene,0,0,0,0,0,0,0,0,16,6,22,16,6,22,81,83,2,0,1,3.20833,0.244792,31.6979,79.1109,192,4
Sri Lanka,244,223.373,7.09016,0.344262,227.578,7.47541,0.385246,82,ST Jayasuriya,0,0,0,0,0,0,0,0,16,6,22,16,6,22,81,83,2,0,1,4.91549,0.211268,33.9859,98.4898,71,0
England,221,237.176,7.17647,0.289593,230.633,7.45701,0.384615,83,AJ Strauss,0,0,0,0,0,0,0,0,4,7,11,4,7,11,0,125,0,0,1,3.93243,0.27027,33.9054,79.8028,74,4
England,221,237.176,7.17647,0.289593,230.633,7.45701,0.384615,83,IR Bell,0,0,0,0,0,0,0,0,4,7,11,4,7,11,0,125,0,0,1,3.63433,0.246269,35.3806,75.6623,134,4
England,221,237.176,7.17647,0.289593,230.633,7.45701,0.384615,83,A Flintoff,0,0,0,0,0,0,0,0,4,7,11,4,7,11,0,125,0,0,1,2.4375,0.09375,22.5,86.5385,32,4
England,221,237.176,7.17647,0.289593,230.633,7.45701,0.384615,83,MH Yardy,0,0,0,0,0,0,0,0,4,7,11,4,7,11,0,125,0,0,1,0.875,0.0833333,13.5833,66.5306,24,1
India,259,242.378,7.15058,0.339768,244.568,7.12741,0.30888,83,V Sehwag,0,0,0,0,0,0,0,0,28,8,36,28,8,36,126,126,12,1,1,5.88636,0.238636,38.8295,108.649,88,0
India,259,242.378,7.15058,0.339768,244.568,7.12741,0.30888,83,SR Tendulkar,0,0,0,0,0,0,0,0,28,8,36,28,8,36,126,126,12,1,1,5.89773,0.363636,45.6023,84.5376,88,4
India,259,242.378,7.15058,0.339768,244.568,7.12741,0.30888,83,IK Pathan,0,0,0,0,0,0,0,0,28,8,36,28,8,36,126,126,12,1,1,1.875,0.025,16.85,78.2811,40,1
New Zealand,184,233.745,7.39674,0.36413,227.951,7.30435,0.353261,84,L Vincent,0,0,0,0,0,0,0,0,12,7,19,12,7,19,0,195,3,0,1,3.125,0.25,27.8125,67.5266,16,4
New Zealand,184,233.745,7.39674,0.36413,227.951,7.30435,0.353261,84,SP Fleming,0,0,0,0,0,0,0,0,12,7,19,12,7,19,0,195,3,0,1,3.875,0.25,30.2917,70.9268,24,4
South Africa,190,234.274,7.4,0.373684,232.363,7.33158,0.342105,84,GC Smith,0,0,0,0,0,0,0,0,4,7,11,4,7,11,196,108,1,0,1,3.97,0.29,33.57,79.6819,100,4
South Africa,190,234.274,7.4,0.373684,232.363,7.33158,0.342105,84,HH Dippenaar,0,0,0,0,0,0,0,0,4,7,11,4,7,11,196,108,1,0,1,1.8,0.2,22,54.1872,5,3
South Africa,190,234.274,7.4,0.373684,232.363,7.33158,0.342105,84,HH Gibbs,0,0,0,0,0,0,0,0,4,7,11,4,7,11,196,108,1,0,1,4.61538,0.307692,35.6923,83.4157,52,4
South Africa,190,234.274,7.4,0.373684,232.363,7.33158,0.342105,84,JH Kallis,0,0,0,0,0,0,0,0,4,7,11,4,7,11,196,108,1,0,1,3.58621,0.356322,37.2644,76.4442,87,4
Sri Lanka,244,223.373,7.09016,0.344262,227.578,7.47541,0.385246,85,WU Tharanga,0,0,0,0,0,0,0,0,8,13,21,8,13,21,0,253,2,0,1,3.93985,0.263158,32.9699,71.6035,133,4
Sri Lanka,244,223.373,7.09016,0.344262,227.578,7.47541,0.385246,85,ST Jayasuriya,0,0,0,0,0,0,0,0,8,13,21,8,13,21,0,253,2,0,1,4.91549,0.211268,33.9859,98.4898,71,0
Pakistan,211,222.621,7.38389,0.393365,235.517,7.54976,0.336493,85,Mohammad Hafeez,0,0,0,0,0,0,0,0,24,12,36,24,12,36,254,255,3,0,1,4.04511,0.255639,34.3534,78.0625,133,4
Pakistan,211,222.621,7.38389,0.393365,235.517,7.54976,0.336493,85,Imran Farhat,0,0,0,0,0,0,0,0,24,12,36,24,12,36,254,255,3,0,1,3.03333,0.266667,27.0333,62.9658,30,4
West Indies,176,217.33,7.15909,0.3125,225.278,7.57386,0.380682,86,WW Hinds,0,0,0,0,0,0,0,0,8,4,12,8,4,12,0,234,3,0,1,1.11111,0,12,38.9892,9,3
West Indies,176,217.33,7.15909,0.3125,225.278,7.57386,0.380682,86,CH Gayle,0,0,0,0,0,0,0,0,8,4,12,8,4,12,0,234,3,0,1,4.58621,0.206897,31.1293,89.4255,116,4
West Indies,176,217.33,7.15909,0.3125,225.278,7.57386,0.380682,86,DR Smith,0,0,0,0,0,0,0,0,8,4,12,8,4,12,0,234,3,0,1,2.5,0.12,17.96,84.5574,50,1
Australia,228,239.627,7.69737,0.372807,232.079,7.23246,0.337719,86,AC Gilchrist,0,0,0,0,0,0,0,0,12,8,20,12,8,20,235,224,5,0,1,4.3,0.275,31.425,96.1009,40,0
Australia,228,239.627,7.69737,0.372807,232.079,7.23246,0.337719,86,SR Watson,0,0,0,0,0,0,0,0,12,8,20,12,8,20,235,224,5,0,1,4.71318,0.286822,37.7907,90.0943,129,4
Australia,228,239.627,7.69737,0.372807,232.079,7.23246,0.337719,86,RT Ponting,0,0,0,0,0,0,0,0,12,8,20,12,8,20,235,224,5,0,1,4.17431,0.33945,38.1009,80.8606,109,4
Australia,228,239.627,7.69737,0.372807,232.079,7.23246,0.337719,86,DR Martyn,0,0,0,0,0,0,0,0,12,8,20,12,8,20,235,224,5,0,1,5.71429,0.428571,44.5714,65.1357,7,4
New Zealand,184,233.745,7.39674,0.36413,227.951,7.30435,0.353261,87,L Vincent,0,0,0,0,0,0,0,0,0,5,5,0,5,5,0,165,11,0,1,3.125,0.25,27.8125,67.5266,16,4
New Zealand,184,233.745,7.39674,0.36413,227.951,7.30435,0.353261,87,SP Fleming,0,0,0,0,0,0,0,0,0,5,5,0,5,5,0,165,11,0,1,3.875,0.25,30.2917,70.9268,24,4
New Zealand,184,233.745,7.39674,0.36413,227.951,7.30435,0.353261,87,NJ Astle,0,0,0,0,0,0,0,0,0,5,5,0,5,5,0,165,11,0,1,2.8,0.1,20,67.5676,10,1
Sri Lanka,244,223.373,7.09016,0.344262,227.578,7.47541,0.385246,87,WU Tharanga,0,0,0,0,0,0,0,0,22,7,29,22,7,29,166,166,6,0,1,3.93985,0.263158,32.9699,71.6035,133,4
Sri Lanka,244,223.373,7.09016,0.344262,227.578,7.47541,0.385246,87,ST Jayasuriya,0,0,0,0,0,0,0,0,22,7,29,22,7,29,166,166,6,0,1,4.91549,0.211268,33.9859,98.4898,71,0
England,221,237.176,7.17647,0.289593,230.633,7.45701,0.384615,88,AJ Strauss,0,0,0,0,0,0,0,0,12,5,17,12,5,17,0,169,3,0,1,3.93243,0.27027,33.9054,79.8028,74,4
England,221,237.176,7.17647,0.289593,230.633,7.45701,0.384615,88,IR Bell,0,0,0,0,0,0,0,0,12,5,17,12,5,17,0,169,3,0,1,3.63433,0.246269,35.3806,75.6623,134,4
Australia,228,239.627,7.69737,0.372807,232.079,7.23246,0.337719,88,AC Gilchrist,0,0,0,0,0,0,0,0,20,8,28,20,8,28,170,170,2,0,1,4.3,0.275,31.425,96.1009,40,0
Australia,228,239.627,7.69737,0.372807,232.079,7.23246,0.337719,88,SR Watson,0,0,0,0,0,0,0,0,20,8,28,20,8,28,170,170,2,0,1,4.71318,0.286822,37.7907,90.0943,129,4
South Africa,190,234.274,7.4,0.373684,232.363,7.33158,0.342105,89,GC Smith,0,0,0,0,0,0,0,0,4,10,14,4,10,14,0,219,1,0,1,3.97,0.29,33.57,79.6819,100,4
South Africa,190,234.274,7.4,0.373684,232.363,7.33158,0.342105,89,HH Dippenaar,0,0,0,0,0,0,0,0,4,10,14,4,10,14,0,219,1,0,1,1.8,0.2,22,54.1872,5,3
South Africa,190,234.274,7.4,0.373684,232.363,7.33158,0.342105,89,HH Gibbs,0,0,0,0,0,0,0,0,4,10,14,4,10,14,0,219,1,0,1,4.61538,0.307692,35.6923,83.4157,52,4
Sri Lanka,244,223.373,7.09016,0.344262,227.578,7.47541,0.385246,89,WU Tharanga,0,0,0,0,0,0,0,0,4,4,8,4,4,8,220,141,2,0,1,3.93985,0.263158,32.9699,71.6035,133,4
Sri Lanka,244,223.373,7.09016,0.344262,227.578,7.47541,0.385246,89,ST Jayasuriya,0,0,0,0,0,0,0,0,4,4,8,4,4,8,220,141,2,0,1,4.91549,0.211268,33.9859,98.4898,71,0
Sri Lanka,244,223.373,7.09016,0.344262,227.578,7.47541,0.385246,89,DPMD Jayawardene,0,0,0,0,0,0,0,0,4,4,8,4,4,8,220,141,2,0,1,3.20833,0.244792,31.6979,79.1109,192,4
New Zealand,184,233.745,7.39674,0.36413,227.951,7.30435,0.353261,90,L Vincent,0,0,0,0,0,0,0,0,8,8,16,8,8,16,0,274,3,0,1,3.125,0.25,27.8125,67.5266,16,4
New Zealand,184,233.745,7.39674,0.36413,227.951,7.30435,0.353261,90,NJ Astle,0,0,0,0,0,0,0,0,8,8,16,8,8,16,0,274,3,0,1,2.8,0.1,20,67.5676,10,1
New Zealand,184,233.745,7.39674,0.36413,227.951,7.30435,0.353261,90,SP Fleming,0,0,0,0,0,0,0,0,8,8,16,8,8,16,0,274,3,0,1,3.875,0.25,30.2917,70.9268,24,4
Pakistan,211,222.621,7.38389,0.393365,235.517,7.54976,0.336493,90,Mohammad Hafeez,0,0,0,0,0,0,0,0,16,5,21,16,5,21,275,223,2,0,1,4.04511,0.255639,34.3534,78.0625,133,4
Pakistan,211,222.621,7.38389,0.393365,235.517,7.54976,0.336493,90,Imran Farhat,0,0,0,0,0,0,0,0,16,5,21,16,5,21,275,223,2,0,1,3.03333,0.266667,27.0333,62.9658,30,4
Pakistan,211,222.621,7.38389,0.393365,235.517,7.54976,0.336493,90,Younis Khan,0,0,0,0,0,0,0,0,16,5,21,16,5,21,275,223,2,0,1,2.64655,0.215517,28.5,73.2713,116,4
South Africa,190,234.274,7.4,0.373684,232.363,7.33158,0.342105,91,GC Smith,0,0,0,0,0,0,0,0,4,5,9,4,5,9,0,213,2,0,1,3.97,0.29,33.57,79.6819,100,4
South Africa,190,234.274,7.4,0.373684,232.363,7.33158,0.342105,91,HH Gibbs,0,0,0,0,0,0,0,0,4,5,9,4,5,9,0,213,2,0,1,4.61538,0.307692,35.6923,83.4157,52,4
South Africa,190,234.274,7.4,0.373684,232.363,7.33158,0.342105,91,JH Kallis,0,0,0,0,0,0,0,0,4,5,9,4,5,9,0,213,2,0,1,3.58621,0.356322,37.2644,76.4442,87,4
South Africa,190,234.274,7.4,0.373684,232.363,7.33158,0.342105,91,HH Dippenaar,0,0,0,0,0,0,0,0,4,5,9,4,5,9,0,213,2,0,1,1.8,0.2,22,54.1872,5,3
Pakistan,211,222.621,7.38389,0.393365,235.517,7.54976,0.336493,91,Mohammad Hafeez,0,0,0,0,0,0,0,0,0,9,9,0,9,9,214,89,4,0,1,4.04511,0.255639,34.3534,78.0625,133,4
Pakistan,211,222.621,7.38389,0.393365,235.517,7.54976,0.336493,91,Imran Farhat,0,0,0,0,0,0,0,0,0,9,9,0,9,9,214,89,4,0,1,3.03333,0.266667,27.0333,62.9658,30,4
Pakistan,211,222.621,7.38389,0.393365,235.517,7.54976,0.336493,91,Younis Khan,0,0,0,0,0,0,0,0,0,9,9,0,9,9,214,89,4,0,1,2.64655,0.215517,28.5,73.2713,116,4
Pakistan,211,222.621,7.38389,0.393365,235.517,7.54976,0.336493,91,Mohammad Yousuf,0,0,0,0,0,0,0,0,0,9,9,0,9,9,214,89,4,0,1,3.27586,0.275862,36.7931,73.9176,58,4
West Indies,176,217.33,7.15909,0.3125,225.278,7.57386,0.380682,92,CH Gayle,0,0,0,0,0,0,0,0,12,11,23,12,11,23,0,272,1,0,1,4.58621,0.206897,31.1293,89.4255,116,4
West Indies,176,217.33,7.15909,0.3125,225.278,7.57386,0.380682,92,S Chanderpaul,0,0,0,0,0,0,0,0,12,11,23,12,11,23,0,272,1,0,1,3.57143,0.396825,40.8254,68.0783,63,4
England,221,237.176,7.17647,0.289593,230.633,7.45701,0.384615,92,AJ Strauss,0,0,0,0,0,0,0,0,12,17,29,12,17,29,273,276,4,0,1,3.93243,0.27027,33.9054,79.8028,74,4
England,221,237.176,7.17647,0.289593,230.633,7.45701,0.384615,92,IR Bell,0,0,0,0,0,0,0,0,12,17,29,12,17,29,273,276,4,0,1,3.63433,0.246269,35.3806,75.6623,134,4
India,259,242.378,7.15058,0.339768,244.568,7.12741,0.30888,93,V Sehwag,0,0,0,0,0,0,0,0,16,9,25,16,9,25,0,249,4,1,1,5.88636,0.238636,38.8295,108.649,88,0
India,259,242.378,7.15058,0.339768,244.568,7.12741,0.30888,93,SR Tendulkar,0,0,0,0,0,0,0,0,16,9,25,16,9,25,0,249,4,1,1,5.89773,0.363636,45.6023,84.5376,88,4
Australia,228,239.627,7.69737,0.372807,232.079,7.23246,0.337719,93,AC Gilchrist,0,0,0,0,0,0,0,0,8,10,18,8,10,18,250,252,10,0,1,4.3,0.275,31.425,96.1009,40,0
Australia,228,239.627,7.69737,0.372807,232.079,7.23246,0.337719,93,SR Watson,0,0,0,0,0,0,0,0,8,10,18,8,10,18,250,252,10,0,1,4.71318,0.286822,37.7907,90.0943,129,4
Australia,228,239.627,7.69737,0.372807,232.079,7.23246,0.337719,94,AC Gilchrist,0,0,0,0,0,0,0,0,0,6,6,0,6,6,0,240,0,0,1,4.3,0.275,31.425,96.1009,40,0
Australia,228,239.627,7.69737,0.372807,232.079,7.23246,0.337719,94,SR Watson,0,0,0,0,0,0,0,0,0,6,6,0,6,6,0,240,0,0,1,4.71318,0.286822,37.7907,90.0943,129,4
Australia,228,239.627,7.69737,0.372807,232.079,7.23246,0.337719,94,RT Ponting,0,0,0,0,0,0,0,0,0,6,6,0,6,6,0,240,0,0,1,4.17431,0.33945,38.1009,80.8606,109,4
Australia,228,239.627,7.69737,0.372807,232.079,7.23246,0.337719,94,DR Martyn,0,0,0,0,0,0,0,0,0,6,6,0,6,6,0,240,0,0,1,5.71429,0.428571,44.5714,65.1357,7,4
New Zealand,184,233.745,7.39674,0.36413,227.951,7.30435,0.353261,94,L Vincent,0,0,0,0,0,0,0,0,8,3,11,8,3,11,241,206,4,0,1,3.125,0.25,27.8125,67.5266,16,4
New Zealand,184,233.745,7.39674,0.36413,227.951,7.30435,0.353261,94,SP Fleming,0,0,0,0,0,0,0,0,8,3,11,8,3,11,241,206,4,0,1,3.875,0.25,30.2917,70.9268,24,4
South Africa,190,234.274,7.4,0.373684,232.363,7.33158,0.342105,95,GC Smith,0,0,0,0,0,0,0,0,16,9,25,16,9,25,0,258,2,0,1,3.97,0.29,33.57,79.6819,100,4
South Africa,190,234.274,7.4,0.373684,232.363,7.33158,0.342105,95,LE Bosman,0,0,0,0,0,0,0,0,16,9,25,16,9,25,0,258,2,0,1,4.18182,0.181818,27.1818,97.7124,11,0
West Indies,176,217.33,7.15909,0.3125,225.278,7.57386,0.380682,95,CH Gayle,0,0,0,0,0,0,0,0,16,10,26,16,10,26,259,262,3,0,1,4.58621,0.206897,31.1293,89.4255,116,4
West Indies,176,217.33,7.15909,0.3125,225.278,7.57386,0.380682,95,S Chanderpaul,0,0,0,0,0,0,0,0,16,10,26,16,10,26,259,262,3,0,1,3.57143,0.396825,40.8254,68.0783,63,4
West Indies,176,217.33,7.15909,0.3125,225.278,7.57386,0.380682,96,S Chanderpaul,0,0,0,0,0,0,0,0,38,6,44,38,6,44,0,138,5,0,1,3.57143,0.396825,40.8254,68.0783,63,4
West Indies,176,217.33,7.15909,0.3125,225.278,7.57386,0.380682,96,CH Gayle,0,0,0,0,0,0,0,0,38,6,44,38,6,44,0,138,5,0,1,4.58621,0.206897,31.1293,89.4255,116,4
Australia,228,239.627,7.69737,0.372807,232.079,7.23246,0.337719,96,AC Gilchrist,0,0,0,0,0,0,0,0,4,10,14,4,10,14,139,116,3,0,1,4.3,0.275,31.425,96.1009,40,0
Australia,228,239.627,7.69737,0.372807,232.079,7.23246,0.337719,96,SR Watson,0,0,0,0,0,0,0,0,4,10,14,4,10,14,139,116,3,0,1,4.71318,0.286822,37.7907,90.0943,129,4
Australia,228,239.627,7.69737,0.372807,232.079,7.23246,0.337719,96,RT Ponting,0,0,0,0,0,0,0,0,4,10,14,4,10,14,139,116,3,0,1,4.17431,0.33945,38.1009,80.8606,109,4
Australia,228,239.627,7.69737,0.372807,232.079,7.23246,0.337719,96,DR Martyn,0,0,0,0,0,0,0,0,4,10,14,4,10,14,139,116,3,0,1,5.71429,0.428571,44.5714,65.1357,7,4
South Africa,190,234.274,7.4,0.373684,232.363,7.33158,0.342105,97,AB de Villiers,0,0,0,0,0,0,0,0,16,7,23,16,7,23,0,392,5,1,1,5.04969,0.403727,47.2174,98.8428,161,4
South Africa,190,234.274,7.4,0.373684,232.363,7.33158,0.342105,97,GC Smith,0,0,0,0,0,0,0,0,16,7,23,16,7,23,0,392,5,1,1,3.97,0.29,33.57,79.6819,100,4
Pakistan,211,222.621,7.38389,0.393365,235.517,7.54976,0.336493,97,Mohammad Hafeez,0,0,0,0,0,0,0,0,12,18,30,12,18,30,393,228,0,0,1,4.04511,0.255639,34.3534,78.0625,133,4
Pakistan,211,222.621,7.38389,0.393365,235.517,7.54976,0.336493,97,Kamran Akmal,0,0,0,0,0,0,0,0,12,18,30,12,18,30,393,228,0,0,1,3.01124,0.11236,23.0787,81.4433,89,4
Pakistan,211,222.621,7.38389,0.393365,235.517,7.54976,0.336493,97,Younis Khan,0,0,0,0,0,0,0,0,12,18,30,12,18,30,393,228,0,0,1,2.64655,0.215517,28.5,73.2713,116,4
Pakistan,211,222.621,7.38389,0.393365,235.517,7.54976,0.336493,98,Imran Nazir,0,0,0,0,0,0,0,0,20,5,25,20,5,25,0,351,1,0,1,4.66667,0.133333,29,96.0265,15,0
Pakistan,211,222.621,7.38389,0.393365,235.517,7.54976,0.336493,98,Kamran Akmal,0,0,0,0,0,0,0,0,20,5,25,20,5,25,0,351,1,0,1,3.01124,0.11236,23.0787,81.4433,89,4
Pakistan,211,222.621,7.38389,0.393365,235.517,7.54976,0.336493,98,Younis Khan,0,0,0,0,0,0,0,0,20,5,25,20,5,25,0,351,1,0,1,2.64655,0.215517,28.5,73.2713,116,4
South Africa,190,234.274,7.4,0.373684,232.363,7.33158,0.342105,98,GC Smith,0,0,0,0,0,0,0,0,24,7,31,24,7,31,352,210,0,1,1,3.97,0.29,33.57,79.6819,100,4
South Africa,190,234.274,7.4,0.373684,232.363,7.33158,0.342105,98,AB de Villiers,0,0,0,0,0,0,0,0,24,7,31,24,7,31,352,210,0,1,1,5.04969,0.403727,47.2174,98.8428,161,4
Pakistan,211,222.621,7.38389,0.393365,235.517,7.54976,0.336493,99,Imran Nazir,0,0,0,0,0,0,0,0,0,3,3,0,3,3,0,107,0,0,1,4.66667,0.133333,29,96.0265,15,0
Pakistan,211,222.621,7.38389,0.393365,235.517,7.54976,0.336493,99,Younis Khan,0,0,0,0,0,0,0,0,0,3,3,0,3,3,0,107,0,0,1,2.64655,0.215517,28.5,73.2713,116,4
Pakistan,211,222.621,7.38389,0.393365,235.517,7.54976,0.336493,99,Kamran Akmal,0,0,0,0,0,0,0,0,0,3,3,0,3,3,0,107,0,0,1,3.01124,0.11236,23.0787,81.4433,89,4
South Africa,190,234.274,7.4,0.373684,232.363,7.33158,0.342105,99,AB de Villiers,0,0,0,0,0,0,0,0,12,10,22,12,10,22,108,113,7,1,1,5.04969,0.403727,47.2174,98.8428,161,4
South Africa,190,234.274,7.4,0.373684,232.363,7.33158,0.342105,99,GC Smith,0,0,0,0,0,0,0,0,12,10,22,12,10,22,108,113,7,1,1,3.97,0.29,33.57,79.6819,100,4
New Zealand,184,233.745,7.39674,0.36413,227.951,7.30435,0.353261,100,BB McCullum,0,0,0,0,0,0,0,0,14,3,17,14,3,17,0,285,1,1,1,3.98611,0.201389,29.9028,98.4004,144,0
New Zealand,184,233.745,7.39674,0.36413,227.951,7.30435,0.353261,100,NJ Astle,0,0,0,0,0,0,0,0,14,3,17,14,3,17,0,285,1,1,1,2.8,0.1,20,67.5676,10,1
Sri Lanka,244,223.373,7.09016,0.344262,227.578,7.47541,0.385246,100,WU Tharanga,0,0,0,0,0,0,0,0,14,14,28,14,14,28,286,289,3,0,1,3.93985,0.263158,32.9699,71.6035,133,4
Sri Lanka,244,223.373,7.09016,0.344262,227.578,7.47541,0.385246,100,ST Jayasuriya,0,0,0,0,0,0,0,0,14,14,28,14,14,28,286,289,3,0,1,4.91549,0.211268,33.9859,98.4898,71,0
Sri Lanka,244,223.373,7.09016,0.344262,227.578,7.47541,0.385246,101,WU Tharanga,0,0,0,0,0,0,0,0,4,10,14,4,10,14,0,112,0,0,1,3.93985,0.263158,32.9699,71.6035,133,4
Sri Lanka,244,223.373,7.09016,0.344262,227.578,7.47541,0.385246,101,ST Jayasuriya,0,0,0,0,0,0,0,0,4,10,14,4,10,14,0,112,0,0,1,4.91549,0.211268,33.9859,98.4898,71,0
Sri Lanka,244,223.373,7.09016,0.344262,227.578,7.47541,0.385246,101,MS Atapattu,0,0,0,0,0,0,0,0,4,10,14,4,10,14,0,112,0,0,1,2.63636,0,24.4545,66.9154,11,4
New Zealand,184,233.745,7.39674,0.36413,227.951,7.30435,0.353261,101,BB McCullum,0,0,0,0,0,0,0,0,16,6,22,16,6,22,113,110,6,1,1,3.98611,0.201389,29.9028,98.4004,144,0
New Zealand,184,233.745,7.39674,0.36413,227.951,7.30435,0.353261,101,NJ Astle,0,0,0,0,0,0,0,0,16,6,22,16,6,22,113,110,6,1,1,2.8,0.1,20,67.5676,10,1
New Zealand,184,233.745,7.39674,0.36413,227.951,7.30435,0.353261,101,LRPL Taylor,0,0,0,0,0,0,0,0,16,6,22,16,6,22,113,110,6,1,1,3.68382,0.301471,36.7206,79.3959,136,4
New Zealand,184,233.745,7.39674,0.36413,227.951,7.30435,0.353261,101,PG Fulton,0,0,0,0,0,0,0,0,16,6,22,16,6,22,113,110,6,1,1,2.75,0.1875,27.4062,67.4615,32,4
New Zealand,184,233.745,7.39674,0.36413,227.951,7.30435,0.353261,101,DL Vettori,0,0,0,0,0,0,0,0,16,6,22,16,6,22,113,110,6,1,1,1.43662,0.028169,15.7606,86.0108,71,0
Sri Lanka,244,223.373,7.09016,0.344262,227.578,7.47541,0.385246,102,WU Tharanga,0,0,0,0,0,0,0,0,8,8,16,8,8,16,0,262,5,0,1,3.93985,0.263158,32.9699,71.6035,133,4
Sri Lanka,244,223.373,7.09016,0.344262,227.578,7.47541,0.385246,102,ST Jayasuriya,0,0,0,0,0,0,0,0,8,8,16,8,8,16,0,262,5,0,1,4.91549,0.211268,33.9859,98.4898,71,0
New Zealand,184,233.745,7.39674,0.36413,227.951,7.30435,0.353261,102,BB McCullum,0,0,0,0,0,0,0,0,16,1,17,16,1,17,263,73,0,1,1,3.98611,0.201389,29.9028,98.4004,144,0
New Zealand,184,233.745,7.39674,0.36413,227.951,7.30435,0.353261,102,SP Fleming,0,0,0,0,0,0,0,0,16,1,17,16,1,17,263,73,0,1,1,3.875,0.25,30.2917,70.9268,24,4
New Zealand,184,233.745,7.39674,0.36413,227.951,7.30435,0.353261,102,LRPL Taylor,0,0,0,0,0,0,0,0,16,1,17,16,1,17,263,73,0,1,1,3.68382,0.301471,36.7206,79.3959,136,4
New Zealand,184,233.745,7.39674,0.36413,227.951,7.30435,0.353261,102,PG Fulton,0,0,0,0,0,0,0,0,16,1,17,16,1,17,263,73,0,1,1,2.75,0.1875,27.4062,67.4615,32,4
New Zealand,184,233.745,7.39674,0.36413,227.951,7.30435,0.353261,102,HJH Marshall,0,0,0,0,0,0,0,0,16,1,17,16,1,17,263,73,0,1,1,1.1,0.1,11.4,69.5122,10,1
Australia,228,239.627,7.69737,0.372807,232.079,7.23246,0.337719,103,ML Hayden,0,0,0,0,0,0,0,0,8,6,14,8,6,14,0,148,4,0,1,6.37838,0.378378,50.6757,83.3333,37,4
Australia,228,239.627,7.69737,0.372807,232.079,7.23246,0.337719,103,BJ Haddin,0,0,0,0,0,0,0,0,8,6,14,8,6,14,0,148,4,0,1,3.14737,0.147368,26.7789,81.382,95,4
Australia,228,239.627,7.69737,0.372807,232.079,7.23246,0.337719,103,MEK Hussey,0,0,0,0,0,0,0,0,8,6,14,8,6,14,0,148,4,0,1,2.7563,0.260504,34.084,82.4893,119,4
New Zealand,184,233.745,7.39674,0.36413,227.951,7.30435,0.353261,103,L Vincent,0,0,0,0,0,0,0,0,8,11,19,8,11,19,149,149,1,1,1,3.125,0.25,27.8125,67.5266,16,4
New Zealand,184,233.745,7.39674,0.36413,227.951,7.30435,0.353261,103,SP Fleming,0,0,0,0,0,0,0,0,8,11,19,8,11,19,149,149,1,1,1,3.875,0.25,30.2917,70.9268,24,4
Australia,228,239.627,7.69737,0.372807,232.079,7.23246,0.337719,104,ML Hayden,0,0,0,0,0,0,0,0,16,3,19,16,3,19,0,336,6,0,1,6.37838,0.378378,50.6757,83.3333,37,4
New Zealand,184,233.745,7.39674,0.36413,227.951,7.30435,0.353261,104,L Vincent,0,0,0,0,0,0,0,0,14,12,26,14,12,26,337,340,1,1,1,3.125,0.25,27.8125,67.5266,16,4
New Zealand,184,233.745,7.39674,0.36413,227.951,7.30435,0.353261,104,SP Fleming,0,0,0,0,0,0,0,0,14,12,26,14,12,26,337,340,1,1,1,3.875,0.25,30.2917,70.9268,24,4
New Zealand,184,233.745,7.39674,0.36413,227.951,7.30435,0.353261,104,LRPL Taylor,0,0,0,0,0,0,0,0,14,12,26,14,12,26,337,340,1,1,1,3.68382,0.301471,36.7206,79.3959,136,4
Australia,228,239.627,7.69737,0.372807,232.079,7.23246,0.337719,105,ML Hayden,0,0,0,0,0,0,0,0,8,13,21,8,13,21,0,346,0,0,1,6.37838,0.378378,50.6757,83.3333,37,4
Australia,228,239.627,7.69737,0.372807,232.079,7.23246,0.337719,105,SR Watson,0,0,0,0,0,0,0,0,8,13,21,8,13,21,0,346,0,0,1,4.71318,0.286822,37.7907,90.0943,129,4
New Zealand,184,233.745,7.39674,0.36413,227.951,7.30435,0.353261,105,L Vincent,0,0,0,0,0,0,0,0,16,7,23,16,7,23,347,350,7,1,1,3.125,0.25,27.8125,67.5266,16,4
New Zealand,184,233.745,7.39674,0.36413,227.951,7.30435,0.353261,105,SP Fleming,0,0,0,0,0,0,0,0,16,7,23,16,7,23,347,350,7,1,1,3.875,0.25,30.2917,70.9268,24,4
New Zealand,184,233.745,7.39674,0.36413,227.951,7.30435,0.353261,105,LRPL Taylor,0,0,0,0,0,0,0,0,16,7,23,16,7,23,347,350,7,1,1,3.68382,0.301471,36.7206,79.3959,136,4
Zimbabwe,142,212.077,7.5,0.380282,227.704,6.97887,0.316901,106,T Duffin,0,0,0,0,0,0,0,0,0,5,5,0,5,5,0,201,3,0,1,4,0.25,35.75,62.1739,4,4
Zimbabwe,142,212.077,7.5,0.380282,227.704,6.97887,0.316901,106,V Sibanda,0,0,0,0,0,0,0,0,0,5,5,0,5,5,0,201,3,0,1,2.9697,0.181818,23.5152,63.5545,66,1
South Africa,190,234.274,7.4,0.373684,232.363,7.33158,0.342105,106,LE Bosman,0,0,0,0,0,0,0,0,8,11,19,8,11,19,202,202,3,1,1,4.18182,0.181818,27.1818,97.7124,11,0
South Africa,190,234.274,7.4,0.373684,232.363,7.33158,0.342105,106,HH Dippenaar,0,0,0,0,0,0,0,0,8,11,19,8,11,19,202,202,3,1,1,1.8,0.2,22,54.1872,5,3
South Africa,190,234.274,7.4,0.373684,232.363,7.33158,0.342105,106,HH Gibbs,0,0,0,0,0,0,0,0,8,11,19,8,11,19,202,202,3,1,1,4.61538,0.307692,35.6923,83.4157,52,4
India,259,242.378,7.15058,0.339768,244.568,7.12741,0.30888,107,R Dravid,0,0,0,0,0,0,0,0,16,11,27,16,11,27,0,309,10,0,1,2.83721,0.255814,29.8605,72.7067,43,4
India,259,242.378,7.15058,0.339768,244.568,7.12741,0.30888,107,SR Tendulkar,0,0,0,0,0,0,0,0,16,11,27,16,11,27,0,309,10,0,1,5.89773,0.363636,45.6023,84.5376,88,4
West Indies,176,217.33,7.15909,0.3125,225.278,7.57386,0.380682,107,CH Gayle,0,0,0,0,0,0,0,0,24,7,31,24,7,31,310,141,6,0,1,4.58621,0.206897,31.1293,89.4255,116,4
West Indies,176,217.33,7.15909,0.3125,225.278,7.57386,0.380682,107,S Chanderpaul,0,0,0,0,0,0,0,0,24,7,31,24,7,31,310,141,6,0,1,3.57143,0.396825,40.8254,68.0783,63,4
West Indies,176,217.33,7.15909,0.3125,225.278,7.57386,0.380682,107,RR Sarwan,0,0,0,0,0,0,0,0,24,7,31,24,7,31,310,141,6,0,1,2.8254,0.222222,29.1429,69.1005,63,4
Australia,228,239.627,7.69737,0.372807,232.079,7.23246,0.337719,108,ML Hayden,0,0,0,0,0,0,0,0,12,6,18,12,6,18,0,272,2,0,1,6.37838,0.378378,50.6757,83.3333,37,4
Australia,228,239.627,7.69737,0.372807,232.079,7.23246,0.337719,108,SM Katich,0,0,0,0,0,0,0,0,12,6,18,12,6,18,0,272,2,0,1,2.33333,0,18.6667,50.4505,3,3
West Indies,176,217.33,7.15909,0.3125,225.278,7.57386,0.380682,108,CH Gayle,0,0,0,0,0,0,0,0,4,3,7,4,3,7,273,273,5,0,1,4.58621,0.206897,31.1293,89.4255,116,4
West Indies,176,217.33,7.15909,0.3125,225.278,7.57386,0.380682,108,S Chanderpaul,0,0,0,0,0,0,0,0,4,3,7,4,3,7,273,273,5,0,1,3.57143,0.396825,40.8254,68.0783,63,4
West Indies,176,217.33,7.15909,0.3125,225.278,7.57386,0.380682,108,RR Sarwan,0,0,0,0,0,0,0,0,4,3,7,4,3,7,273,273,5,0,1,2.8254,0.222222,29.1429,69.1005,63,4
Australia,228,239.627,7.69737,0.372807,232.079,7.23246,0.337719,109,ML Hayden,0,0,0,0,0,0,0,0,16,4,20,16,4,20,0,213,5,0,1,6.37838,0.378378,50.6757,83.3333,37,4
Australia,228,239.627,7.69737,0.372807,232.079,7.23246,0.337719,109,SM Katich,0,0,0,0,0,0,0,0,16,4,20,16,4,20,0,213,5,0,1,2.33333,0,18.6667,50.4505,3,3
India,259,242.378,7.15058,0.339768,244.568,7.12741,0.30888,109,V Sehwag,0,0,0,0,0,0,0,0,4,12,16,4,12,16,214,195,4,0,1,5.88636,0.238636,38.8295,108.649,88,0
India,259,242.378,7.15058,0.339768,244.568,7.12741,0.30888,109,SR Tendulkar,0,0,0,0,0,0,0,0,4,12,16,4,12,16,214,195,4,0,1,5.89773,0.363636,45.6023,84.5376,88,4
India,259,242.378,7.15058,0.339768,244.568,7.12741,0.30888,109,M Kaif,0,0,0,0,0,0,0,0,4,12,16,4,12,16,214,195,4,0,1,1.77778,0.222222,23.8889,61.4286,9,1
India,259,242.378,7.15058,0.339768,244.568,7.12741,0.30888,109,R Dravid,0,0,0,0,0,0,0,0,4,12,16,4,12,16,214,195,4,0,1,2.83721,0.255814,29.8605,72.7067,43,4
Australia,228,239.627,7.69737,0.372807,232.079,7.23246,0.337719,110,SR Watson,0,0,0,0,0,0,0,0,4,5,9,4,5,9,0,240,2,0,1,4.71318,0.286822,37.7907,90.0943,129,4
Australia,228,239.627,7.69737,0.372807,232.079,7.23246,0.337719,110,SM Katich,0,0,0,0,0,0,0,0,4,5,9,4,5,9,0,240,2,0,1,2.33333,0,18.6667,50.4505,3,3
West Indies,176,217.33,7.15909,0.3125,225.278,7.57386,0.380682,110,CH Gayle,0,0,0,0,0,0,0,0,4,3,7,4,3,7,241,113,3,0,1,4.58621,0.206897,31.1293,89.4255,116,4
West Indies,176,217.33,7.15909,0.3125,225.278,7.57386,0.380682,110,RS Morton,0,0,0,0,0,0,0,0,4,3,7,4,3,7,241,113,3,0,1,2.2963,0.222222,28.8889,67.0103,27,4
West Indies,176,217.33,7.15909,0.3125,225.278,7.57386,0.380682,110,S Chanderpaul,0,0,0,0,0,0,0,0,4,3,7,4,3,7,241,113,3,0,1,3.57143,0.396825,40.8254,68.0783,63,4
South Africa,190,234.274,7.4,0.373684,232.363,7.33158,0.342105,111,LE Bosman,0,0,0,0,0,0,0,0,20,7,27,20,7,27,0,418,3,1,1,4.18182,0.181818,27.1818,97.7124,11,0
South Africa,190,234.274,7.4,0.373684,232.363,7.33158,0.342105,111,AN Petersen,0,0,0,0,0,0,0,0,20,7,27,20,7,27,0,418,3,1,1,3.11111,0.222222,27.6667,81.6393,18,4
Zimbabwe,142,212.077,7.5,0.380282,227.704,6.97887,0.316901,111,T Duffin,0,0,0,0,0,0,0,0,4,9,13,4,9,13,419,247,7,0,1,4,0.25,35.75,62.1739,4,4
Zimbabwe,142,212.077,7.5,0.380282,227.704,6.97887,0.316901,111,V Sibanda,0,0,0,0,0,0,0,0,4,9,13,4,9,13,419,247,7,0,1,2.9697,0.181818,23.5152,63.5545,66,1
Zimbabwe,142,212.077,7.5,0.380282,227.704,6.97887,0.316901,111,CJ Chibhabha,0,0,0,0,0,0,0,0,4,9,13,4,9,13,419,247,7,0,1,2.56716,0.149254,23.5373,64.7373,67,1
West Indies,176,217.33,7.15909,0.3125,225.278,7.57386,0.380682,112,LMP Simmons,0,0,0,0,0,0,0,0,0,4,4,0,4,4,0,151,1,0,1,3.3125,0.28125,30.5938,71.4338,64,4
West Indies,176,217.33,7.15909,0.3125,225.278,7.57386,0.380682,112,D Ganga,0,0,0,0,0,0,0,0,0,4,4,0,4,4,0,151,1,0,1,1,0,20.5,39.0476,2,3
West Indies,176,217.33,7.15909,0.3125,225.278,7.57386,0.380682,112,CH Gayle,0,0,0,0,0,0,0,0,0,4,4,0,4,4,0,151,1,0,1,4.58621,0.206897,31.1293,89.4255,116,4
West Indies,176,217.33,7.15909,0.3125,225.278,7.57386,0.380682,112,MN Samuels,0,0,0,0,0,0,0,0,0,4,4,0,4,4,0,151,1,0,1,3.74757,0.23301,31.6214,74.5821,103,4
Pakistan,211,222.621,7.38389,0.393365,235.517,7.54976,0.336493,112,Mohammad Hafeez,0,0,0,0,0,0,0,0,4,14,18,4,14,18,152,154,2,1,1,4.04511,0.255639,34.3534,78.0625,133,4
Pakistan,211,222.621,7.38389,0.393365,235.517,7.54976,0.336493,112,Kamran Akmal,0,0,0,0,0,0,0,0,4,14,18,4,14,18,152,154,2,1,1,3.01124,0.11236,23.0787,81.4433,89,4
Pakistan,211,222.621,7.38389,0.393365,235.517,7.54976,0.336493,112,Imran Farhat,0,0,0,0,0,0,0,0,4,14,18,4,14,18,152,154,2,1,1,3.03333,0.266667,27.0333,62.9658,30,4
West Indies,176,217.33,7.15909,0.3125,225.278,7.57386,0.380682,113,CH Gayle,0,0,0,0,0,0,0,0,12,8,20,12,8,20,0,207,3,0,1,4.58621,0.206897,31.1293,89.4255,116,4
West Indies,176,217.33,7.15909,0.3125,225.278,7.57386,0.380682,113,BC Lara,0,0,0,0,0,0,0,0,12,8,20,12,8,20,0,207,3,0,1,3.35714,0.178571,29.3571,75.7604,28,4
West Indies,176,217.33,7.15909,0.3125,225.278,7.57386,0.380682,113,LMP Simmons,0,0,0,0,0,0,0,0,12,8,20,12,8,20,0,207,3,0,1,3.3125,0.28125,30.5938,71.4338,64,4
Pakistan,211,222.621,7.38389,0.393365,235.517,7.54976,0.336493,113,Mohammad Hafeez,0,0,0,0,0,0,0,0,0,12,12,0,12,12,208,192,5,1,1,4.04511,0.255639,34.3534,78.0625,133,4
Pakistan,211,222.621,7.38389,0.393365,235.517,7.54976,0.336493,113,Imran Farhat,0,0,0,0,0,0,0,0,0,12,12,0,12,12,208,192,5,1,1,3.03333,0.266667,27.0333,62.9658,30,4
Pakistan,211,222.621,7.38389,0.393365,235.517,7.54976,0.336493,114,Imran Farhat,0,0,0,0,0,0,0,0,0,4,4,0,4,4,0,209,3,1,1,3.03333,0.266667,27.0333,62.9658,30,4
Pakistan,211,222.621,7.38389,0.393365,235.517,7.54976,0.336493,114,Shahid Afridi,0,0,0,0,0,0,0,0,0,4,4,0,4,4,0,209,3,1,1,2.72917,0.0972222,21.4097,127.766,144,0
Pakistan,211,222.621,7.38389,0.393365,235.517,7.54976,0.336493,114,Yasir Hameed,0,0,0,0,0,0,0,0,0,4,4,0,4,4,0,209,3,1,1,1.2,0.2,28.2,51.2727,5,3
West Indies,176,217.33,7.15909,0.3125,225.278,7.57386,0.380682,114,CH Gayle,0,0,0,0,0,0,0,0,16,3,19,16,3,19,210,212,5,0,1,4.58621,0.206897,31.1293,89.4255,116,4
West Indies,176,217.33,7.15909,0.3125,225.278,7.57386,0.380682,114,S Chanderpaul,0,0,0,0,0,0,0,0,16,3,19,16,3,19,210,212,5,0,1,3.57143,0.396825,40.8254,68.0783,63,4
West Indies,176,217.33,7.15909,0.3125,225.278,7.57386,0.380682,114,LMP Simmons,0,0,0,0,0,0,0,0,16,3,19,16,3,19,210,212,5,0,1,3.3125,0.28125,30.5938,71.4338,64,4
West Indies,176,217.33,7.15909,0.3125,225.278,7.57386,0.380682,114,MN Samuels,0,0,0,0,0,0,0,0,16,3,19,16,3,19,210,212,5,0,1,3.74757,0.23301,31.6214,74.5821,103,4
West Indies,176,217.33,7.15909,0.3125,225.278,7.57386,0.380682,115,CH Gayle,0,0,0,0,0,0,0,0,12,10,22,12,10,22,0,238,0,0,1,4.58621,0.206897,31.1293,89.4255,116,4
West Indies,176,217.33,7.15909,0.3125,225.278,7.57386,0.380682,115,S Chanderpaul,0,0,0,0,0,0,0,0,12,10,22,12,10,22,0,238,0,0,1,3.57143,0.396825,40.8254,68.0783,63,4
West Indies,176,217.33,7.15909,0.3125,225.278,7.57386,0.380682,115,LMP Simmons,0,0,0,0,0,0,0,0,12,10,22,12,10,22,0,238,0,0,1,3.3125,0.28125,30.5938,71.4338,64,4
Pakistan,211,222.621,7.38389,0.393365,235.517,7.54976,0.336493,115,Mohammad Hafeez,0,0,0,0,0,0,0,0,12,3,15,12,3,15,239,239,3,0,1,4.04511,0.255639,34.3534,78.0625,133,4
Pakistan,211,222.621,7.38389,0.393365,235.517,7.54976,0.336493,115,Kamran Akmal,0,0,0,0,0,0,0,0,12,3,15,12,3,15,239,239,3,0,1,3.01124,0.11236,23.0787,81.4433,89,4
England,221,237.176,7.17647,0.289593,230.633,7.45701,0.384615,116,AN Cook,0,0,0,0,0,0,0,0,0,8,8,0,8,8,0,225,3,1,1,4.17045,0.272727,35.75,75.5524,88,4
England,221,237.176,7.17647,0.289593,230.633,7.45701,0.384615,116,MJ Prior,0,0,0,0,0,0,0,0,0,8,8,0,8,8,0,225,3,1,1,2.27083,0.0625,21.6875,76.4879,48,4
West Indies,176,217.33,7.15909,0.3125,225.278,7.57386,0.380682,116,CH Gayle,0,0,0,0,0,0,0,0,4,5,9,4,5,9,226,146,3,0,1,4.58621,0.206897,31.1293,89.4255,116,4
West Indies,176,217.33,7.15909,0.3125,225.278,7.57386,0.380682,116,DS Smith,0,0,0,0,0,0,0,0,4,5,9,4,5,9,226,146,3,0,1,2.61765,0.147059,23.5588,71.2,34,4
West Indies,176,217.33,7.15909,0.3125,225.278,7.57386,0.380682,116,RS Morton,0,0,0,0,0,0,0,0,4,5,9,4,5,9,226,146,3,0,1,2.2963,0.222222,28.8889,67.0103,27,4
West Indies,176,217.33,7.15909,0.3125,225.278,7.57386,0.380682,116,MN Samuels,0,0,0,0,0,0,0,0,4,5,9,4,5,9,226,146,3,0,1,3.74757,0.23301,31.6214,74.5821,103,4
West Indies,176,217.33,7.15909,0.3125,225.278,7.57386,0.380682,116,S Chanderpaul,0,0,0,0,0,0,0,0,4,5,9,4,5,9,226,146,3,0,1,3.57143,0.396825,40.8254,68.0783,63,4
West Indies,176,217.33,7.15909,0.3125,225.278,7.57386,0.380682,117,CH Gayle,0,0,0,0,0,0,0,0,10,6,16,10,6,16,0,278,7,0,1,4.58621,0.206897,31.1293,89.4255,116,4
West Indies,176,217.33,7.15909,0.3125,225.278,7.57386,0.380682,117,DS Smith,0,0,0,0,0,0,0,0,10,6,16,10,6,16,0,278,7,0,1,2.61765,0.147059,23.5588,71.2,34,4
England,221,237.176,7.17647,0.289593,230.633,7.45701,0.384615,117,AN Cook,0,0,0,0,0,0,0,0,12,8,20,12,8,20,279,217,3,1,1,4.17045,0.272727,35.75,75.5524,88,4
England,221,237.176,7.17647,0.289593,230.633,7.45701,0.384615,117,MJ Prior,0,0,0,0,0,0,0,0,12,8,20,12,8,20,279,217,3,1,1,2.27083,0.0625,21.6875,76.4879,48,4
England,221,237.176,7.17647,0.289593,230.633,7.45701,0.384615,118,AN Cook,0,0,0,0,0,0,0,0,4,11,15,4,11,15,0,288,1,1,1,4.17045,0.272727,35.75,75.5524,88,4
England,221,237.176,7.17647,0.289593,230.633,7.45701,0.384615,118,MJ Prior,0,0,0,0,0,0,0,0,4,11,15,4,11,15,0,288,1,1,1,2.27083,0.0625,21.6875,76.4879,48,4
India,259,242.378,7.15058,0.339768,244.568,7.12741,0.30888,118,SC Ganguly,0,0,0,0,0,0,0,0,4,9,13,4,9,13,289,184,6,0,1,4.56,0.36,36.8,68.2999,25,4
India,259,242.378,7.15058,0.339768,244.568,7.12741,0.30888,118,SR Tendulkar,0,0,0,0,0,0,0,0,4,9,13,4,9,13,289,184,6,0,1,5.89773,0.363636,45.6023,84.5376,88,4
India,259,242.378,7.15058,0.339768,244.568,7.12741,0.30888,118,G Gambhir,0,0,0,0,0,0,0,0,4,9,13,4,9,13,289,184,6,0,1,3.99145,0.333333,37.4701,84.1944,117,4
India,259,242.378,7.15058,0.339768,244.568,7.12741,0.30888,119,SC Ganguly,0,0,0,0,0,0,0,0,16,5,21,16,5,21,0,329,1,0,1,4.56,0.36,36.8,68.2999,25,4
India,259,242.378,7.15058,0.339768,244.568,7.12741,0.30888,119,SR Tendulkar,0,0,0,0,0,0,0,0,16,5,21,16,5,21,0,329,1,0,1,5.89773,0.363636,45.6023,84.5376,88,4
England,221,237.176,7.17647,0.289593,230.633,7.45701,0.384615,119,AN Cook,0,0,0,0,0,0,0,0,28,6,34,28,6,34,330,320,3,1,1,4.17045,0.272727,35.75,75.5524,88,4
England,221,237.176,7.17647,0.289593,230.633,7.45701,0.384615,119,MJ Prior,0,0,0,0,0,0,0,0,28,6,34,28,6,34,330,320,3,1,1,2.27083,0.0625,21.6875,76.4879,48,4
England,221,237.176,7.17647,0.289593,230.633,7.45701,0.384615,120,AN Cook,0,0,0,0,0,0,0,0,8,8,16,8,8,16,0,281,2,1,1,4.17045,0.272727,35.75,75.5524,88,4
England,221,237.176,7.17647,0.289593,230.633,7.45701,0.384615,120,MJ Prior,0,0,0,0,0,0,0,0,8,8,16,8,8,16,0,281,2,1,1,2.27083,0.0625,21.6875,76.4879,48,4
India,259,242.378,7.15058,0.339768,244.568,7.12741,0.30888,120,SC Ganguly,0,0,0,0,0,0,0,0,20,3,23,20,3,23,282,239,1,0,1,4.56,0.36,36.8,68.2999,25,4
India,259,242.378,7.15058,0.339768,244.568,7.12741,0.30888,120,SR Tendulkar,0,0,0,0,0,0,0,0,20,3,23,20,3,23,282,239,1,0,1,5.89773,0.363636,45.6023,84.5376,88,4
India,259,242.378,7.15058,0.339768,244.568,7.12741,0.30888,121,SC Ganguly,0,0,0,0,0,0,0,0,16,2,18,16,2,18,0,212,4,0,1,4.56,0.36,36.8,68.2999,25,4
India,259,242.378,7.15058,0.339768,244.568,7.12741,0.30888,121,SR Tendulkar,0,0,0,0,0,0,0,0,16,2,18,16,2,18,0,212,4,0,1,5.89773,0.363636,45.6023,84.5376,88,4
India,259,242.378,7.15058,0.339768,244.568,7.12741,0.30888,121,KD Karthik,0,0,0,0,0,0,0,0,16,2,18,16,2,18,0,212,4,0,1,2.46429,0.107143,21.6786,71.8769,56,1
England,221,237.176,7.17647,0.289593,230.633,7.45701,0.384615,121,AN Cook,0,0,0,0,0,0,0,0,16,14,30,16,14,30,213,213,1,1,1,4.17045,0.272727,35.75,75.5524,88,4
England,221,237.176,7.17647,0.289593,230.633,7.45701,0.384615,121,IR Bell,0,0,0,0,0,0,0,0,16,14,30,16,14,30,213,213,1,1,1,3.63433,0.246269,35.3806,75.6623,134,4
England,221,237.176,7.17647,0.289593,230.633,7.45701,0.384615,121,MJ Prior,0,0,0,0,0,0,0,0,16,14,30,16,14,30,213,213,1,1,1,2.27083,0.0625,21.6875,76.4879,48,4
England,221,237.176,7.17647,0.289593,230.633,7.45701,0.384615,121,KP Pietersen,0,0,0,0,0,0,0,0,16,14,30,16,14,30,213,213,1,1,1,3.69892,0.236559,33.4946,82.2117,93,4
India,259,242.378,7.15058,0.339768,244.568,7.12741,0.30888,122,SC Ganguly,0,0,0,0,0,0,0,0,0,6,6,0,6,6,0,324,1,0,1,4.56,0.36,36.8,68.2999,25,4
India,259,242.378,7.15058,0.339768,244.568,7.12741,0.30888,122,SR Tendulkar,0,0,0,0,0,0,0,0,0,6,6,0,6,6,0,324,1,0,1,5.89773,0.363636,45.6023,84.5376,88,4
England,221,237.176,7.17647,0.289593,230.633,7.45701,0.384615,122,AN Cook,0,0,0,0,0,0,0,0,0,12,12,0,12,12,325,242,0,1,1,4.17045,0.272727,35.75,75.5524,88,4
England,221,237.176,7.17647,0.289593,230.633,7.45701,0.384615,122,MJ Prior,0,0,0,0,0,0,0,0,0,12,12,0,12,12,325,242,0,1,1,2.27083,0.0625,21.6875,76.4879,48,4
England,221,237.176,7.17647,0.289593,230.633,7.45701,0.384615,122,IR Bell,0,0,0,0,0,0,0,0,0,12,12,0,12,12,325,242,0,1,1,3.63433,0.246269,35.3806,75.6623,134,4
England,221,237.176,7.17647,0.289593,230.633,7.45701,0.384615,123,AN Cook,0,0,0,0,0,0,0,0,16,6,22,16,6,22,0,316,0,1,1,4.17045,0.272727,35.75,75.5524,88,4
England,221,237.176,7.17647,0.289593,230.633,7.45701,0.384615,123,IR Bell,0,0,0,0,0,0,0,0,16,6,22,16,6,22,0,316,0,1,1,3.63433,0.246269,35.3806,75.6623,134,4
England,221,237.176,7.17647,0.289593,230.633,7.45701,0.384615,123,MJ Prior,0,0,0,0,0,0,0,0,16,6,22,16,6,22,0,316,0,1,1,2.27083,0.0625,21.6875,76.4879,48,4
England,221,237.176,7.17647,0.289593,230.633,7.45701,0.384615,123,KP Pietersen,0,0,0,0,0,0,0,0,16,6,22,16,6,22,0,316,0,1,1,3.69892,0.236559,33.4946,82.2117,93,4
India,259,242.378,7.15058,0.339768,244.568,7.12741,0.30888,123,SC Ganguly,0,0,0,0,0,0,0,0,8,15,23,8,15,23,317,317,2,0,1,4.56,0.36,36.8,68.2999,25,4
India,259,242.378,7.15058,0.339768,244.568,7.12741,0.30888,123,SR Tendulkar,0,0,0,0,0,0,0,0,8,15,23,8,15,23,317,317,2,0,1,5.89773,0.363636,45.6023,84.5376,88,4
India,259,242.378,7.15058,0.339768,244.568,7.12741,0.30888,124,SC Ganguly,0,0,0,0,0,0,0,0,12,9,21,12,9,21,0,187,0,0,1,4.56,0.36,36.8,68.2999,25,4
India,259,242.378,7.15058,0.339768,244.568,7.12741,0.30888,124,SR Tendulkar,0,0,0,0,0,0,0,0,12,9,21,12,9,21,0,187,0,0,1,5.89773,0.363636,45.6023,84.5376,88,4
England,221,237.176,7.17647,0.289593,230.633,7.45701,0.384615,124,MJ Prior,0,0,0,0,0,0,0,0,0,11,11,0,11,11,188,188,12,1,1,2.27083,0.0625,21.6875,76.4879,48,4
England,221,237.176,7.17647,0.289593,230.633,7.45701,0.384615,124,LJ Wright,0,0,0,0,0,0,0,0,0,11,11,0,11,11,188,188,12,1,1,1.92105,0.0263158,17.2368,81.875,38,1
England,221,237.176,7.17647,0.289593,230.633,7.45701,0.384615,124,IR Bell,0,0,0,0,0,0,0,0,0,11,11,0,11,11,188,188,12,1,1,3.63433,0.246269,35.3806,75.6623,134,4
England,221,237.176,7.17647,0.289593,230.633,7.45701,0.384615,124,KP Pietersen,0,0,0,0,0,0,0,0,0,11,11,0,11,11,188,188,12,1,1,3.69892,0.236559,33.4946,82.2117,93,4
Zimbabwe,142,212.077,7.5,0.380282,227.704,6.97887,0.316901,128,V Sibanda,0,0,0,0,0,0,0,0,0,6,6,0,6,6,0,152,0,0,1,2.9697,0.181818,23.5152,63.5545,66,1
Zimbabwe,142,212.077,7.5,0.380282,227.704,6.97887,0.316901,128,TV Mufambisi,0,0,0,0,0,0,0,0,0,6,6,0,6,6,0,152,0,0,1,1.5,0,11.25,63.3803,4,1
Zimbabwe,142,212.077,7.5,0.380282,227.704,6.97887,0.316901,128,CJ Chibhabha,0,0,0,0,0,0,0,0,0,6,6,0,6,6,0,152,0,0,1,2.56716,0.149254,23.5373,64.7373,67,1
South Africa,190,234.274,7.4,0.373684,232.363,7.33158,0.342105,128,LE Bosman,0,0,0,0,0,0,0,0,12,9,21,12,9,21,153,156,3,1,1,4.18182,0.181818,27.1818,97.7124,11,0
South Africa,190,234.274,7.4,0.373684,232.363,7.33158,0.342105,128,HH Dippenaar,0,0,0,0,0,0,0,0,12,9,21,12,9,21,153,156,3,1,1,1.8,0.2,22,54.1872,5,3
South Africa,190,234.274,7.4,0.373684,232.363,7.33158,0.342105,128,AN Petersen,0,0,0,0,0,0,0,0,12,9,21,12,9,21,153,156,3,1,1,3.11111,0.222222,27.6667,81.6393,18,4
Zimbabwe,142,212.077,7.5,0.380282,227.704,6.97887,0.316901,129,S Matsikenyeri,0,0,0,0,0,0,0,0,4,4,8,4,4,8,0,217,6,0,1,2,0.106383,19.9787,75.7869,47,1
Zimbabwe,142,212.077,7.5,0.380282,227.704,6.97887,0.316901,129,BRM Taylor,0,0,0,0,0,0,0,0,4,4,8,4,4,8,0,217,6,0,1,3.3,0.26,33.56,76.3421,100,4
Zimbabwe,142,212.077,7.5,0.380282,227.704,6.97887,0.316901,129,CJ Chibhabha,0,0,0,0,0,0,0,0,4,4,8,4,4,8,0,217,6,0,1,2.56716,0.149254,23.5373,64.7373,67,1
Bangladesh,160,218.438,7.70625,0.4,211.106,7.05,0.325,129,Shahriar Nafees,0,0,0,0,0,0,0,0,4,9,13,4,9,13,218,218,3,1,1,3.40541,0.162162,24.4865,69.1076,37,4
Bangladesh,160,218.438,7.70625,0.4,211.106,7.05,0.325,129,Mehrab Hossain jnr,0,0,0,0,0,0,0,0,4,9,13,4,9,13,218,218,3,1,1,1.7,0.1,18.3,42.4594,10,3
Bangladesh,160,218.438,7.70625,0.4,211.106,7.05,0.325,130,Shahriar Nafees,0,0,0,0,0,0,0,0,28,5,33,28,5,33,0,220,3,1,1,3.40541,0.162162,24.4865,69.1076,37,4
Bangladesh,160,218.438,7.70625,0.4,211.106,7.05,0.325,130,Mehrab Hossain jnr,0,0,0,0,0,0,0,0,28,5,33,28,5,33,0,220,3,1,1,1.7,0.1,18.3,42.4594,10,3
Zimbabwe,142,212.077,7.5,0.380282,227.704,6.97887,0.316901,130,S Matsikenyeri,0,0,0,0,0,0,0,0,4,10,14,4,10,14,221,194,4,0,1,2,0.106383,19.9787,75.7869,47,1
Zimbabwe,142,212.077,7.5,0.380282,227.704,6.97887,0.316901,130,BRM Taylor,0,0,0,0,0,0,0,0,4,10,14,4,10,14,221,194,4,0,1,3.3,0.26,33.56,76.3421,100,4
Zimbabwe,142,212.077,7.5,0.380282,227.704,6.97887,0.316901,130,CJ Chibhabha,0,0,0,0,0,0,0,0,4,10,14,4,10,14,221,194,4,0,1,2.56716,0.149254,23.5373,64.7373,67,1
Zimbabwe,142,212.077,7.5,0.380282,227.704,6.97887,0.316901,131,TMK Mawoyo,0,0,0,0,0,0,0,0,4,9,13,4,9,13,0,146,4,0,1,0.571429,0,8.28571,34.9398,7,3
Zimbabwe,142,212.077,7.5,0.380282,227.704,6.97887,0.316901,131,CJ Chibhabha,0,0,0,0,0,0,0,0,4,9,13,4,9,13,0,146,4,0,1,2.56716,0.149254,23.5373,64.7373,67,1
Zimbabwe,142,212.077,7.5,0.380282,227.704,6.97887,0.316901,131,H Masakadza,0,0,0,0,0,0,0,0,4,9,13,4,9,13,0,146,4,0,1,3.11215,0.186916,26.972,70.0485,107,4
Bangladesh,160,218.438,7.70625,0.4,211.106,7.05,0.325,131,Shahriar Nafees,0,0,0,0,0,0,0,0,8,8,16,8,8,16,147,147,7,1,1,3.40541,0.162162,24.4865,69.1076,37,4
Bangladesh,160,218.438,7.70625,0.4,211.106,7.05,0.325,131,Mehrab Hossain jnr,0,0,0,0,0,0,0,0,8,8,16,8,8,16,147,147,7,1,1,1.7,0.1,18.3,42.4594,10,3
Zimbabwe,142,212.077,7.5,0.380282,227.704,6.97887,0.316901,132,TMK Mawoyo,0,0,0,0,0,0,0,0,12,7,19,12,7,19,0,193,1,0,1,0.571429,0,8.28571,34.9398,7,3
Zimbabwe,142,212.077,7.5,0.380282,227.704,6.97887,0.316901,132,S Matsikenyeri,0,0,0,0,0,0,0,0,12,7,19,12,7,19,0,193,1,0,1,2,0.106383,19.9787,75.7869,47,1
Bangladesh,160,218.438,7.70625,0.4,211.106,7.05,0.325,132,Shahriar Nafees,0,0,0,0,0,0,0,0,8,8,16,8,8,16,194,197,2,1,1,3.40541,0.162162,24.4865,69.1076,37,4
Bangladesh,160,218.438,7.70625,0.4,211.106,7.05,0.325,132,Mehrab Hossain jnr,0,0,0,0,0,0,0,0,8,8,16,8,8,16,194,197,2,1,1,1.7,0.1,18.3,42.4594,10,3
India,259,242.378,7.15058,0.339768,244.568,7.12741,0.30888,136,RV Uthappa,0,0,0,0,0,0,0,0,16,8,24,16,8,24,0,268,9,1,1,3,0.117647,22.1471,89.0071,34,0
India,259,242.378,7.15058,0.339768,244.568,7.12741,0.30888,136,G Gambhir,0,0,0,0,0,0,0,0,16,8,24,16,8,24,0,268,9,1,1,3.99145,0.333333,37.4701,84.1944,117,4
India,259,242.378,7.15058,0.339768,244.568,7.12741,0.30888,136,SK Raina,0,0,0,0,0,0,0,0,16,8,24,16,8,24,0,268,9,1,1,3.11111,0.216374,28.9064,91.8944,171,0
West Indies,176,217.33,7.15909,0.3125,225.278,7.57386,0.380682,136,CH Gayle,0,0,0,0,0,0,0,0,16,4,20,16,4,20,269,270,15,0,1,4.58621,0.206897,31.1293,89.4255,116,4
West Indies,176,217.33,7.15909,0.3125,225.278,7.57386,0.380682,136,RS Morton,0,0,0,0,0,0,0,0,16,4,20,16,4,20,269,270,15,0,1,2.2963,0.222222,28.8889,67.0103,27,4
West Indies,176,217.33,7.15909,0.3125,225.278,7.57386,0.380682,136,DS Smith,0,0,0,0,0,0,0,0,16,4,20,16,4,20,269,270,15,0,1,2.61765,0.147059,23.5588,71.2,34,4
West Indies,176,217.33,7.15909,0.3125,225.278,7.57386,0.380682,136,MN Samuels,0,0,0,0,0,0,0,0,16,4,20,16,4,20,269,270,15,0,1,3.74757,0.23301,31.6214,74.5821,103,4
India,259,242.378,7.15058,0.339768,244.568,7.12741,0.30888,137,RV Uthappa,0,0,0,0,0,0,0,0,20,8,28,20,8,28,0,341,1,1,1,3,0.117647,22.1471,89.0071,34,0
India,259,242.378,7.15058,0.339768,244.568,7.12741,0.30888,137,SC Ganguly,0,0,0,0,0,0,0,0,20,8,28,20,8,28,0,341,1,1,1,4.56,0.36,36.8,68.2999,25,4
West Indies,176,217.33,7.15909,0.3125,225.278,7.57386,0.380682,137,S Chanderpaul,0,0,0,0,0,0,0,0,8,8,16,8,8,16,342,181,1,0,1,3.57143,0.396825,40.8254,68.0783,63,4
West Indies,176,217.33,7.15909,0.3125,225.278,7.57386,0.380682,137,CH Gayle,0,0,0,0,0,0,0,0,8,8,16,8,8,16,342,181,1,0,1,4.58621,0.206897,31.1293,89.4255,116,4
West Indies,176,217.33,7.15909,0.3125,225.278,7.57386,0.380682,137,DS Smith,0,0,0,0,0,0,0,0,8,8,16,8,8,16,342,181,1,0,1,2.61765,0.147059,23.5588,71.2,34,4
Sri Lanka,244,223.373,7.09016,0.344262,227.578,7.47541,0.385246,138,WU Tharanga,0,0,0,0,0,0,0,0,14,8,22,14,8,22,0,257,4,0,1,3.93985,0.263158,32.9699,71.6035,133,4
Sri Lanka,244,223.373,7.09016,0.344262,227.578,7.47541,0.385246,138,ST Jayasuriya,0,0,0,0,0,0,0,0,14,8,22,14,8,22,0,257,4,0,1,4.91549,0.211268,33.9859,98.4898,71,0
Sri Lanka,244,223.373,7.09016,0.344262,227.578,7.47541,0.385246,138,MS Atapattu,0,0,0,0,0,0,0,0,14,8,22,14,8,22,0,257,4,0,1,2.63636,0,24.4545,66.9154,11,4
India,259,242.378,7.15058,0.339768,244.568,7.12741,0.30888,138,RV Uthappa,0,0,0,0,0,0,0,0,20,9,29,20,9,29,258,252,5,1,1,3,0.117647,22.1471,89.0071,34,0
India,259,242.378,7.15058,0.339768,244.568,7.12741,0.30888,138,SC Ganguly,0,0,0,0,0,0,0,0,20,9,29,20,9,29,258,252,5,1,1,4.56,0.36,36.8,68.2999,25,4
India,259,242.378,7.15058,0.339768,244.568,7.12741,0.30888,138,R Dravid,0,0,0,0,0,0,0,0,20,9,29,20,9,29,258,252,5,1,1,2.83721,0.255814,29.8605,72.7067,43,4
India,259,242.378,7.15058,0.339768,244.568,7.12741,0.30888,138,SR Tendulkar,0,0,0,0,0,0,0,0,20,9,29,20,9,29,258,252,5,1,1,5.89773,0.363636,45.6023,84.5376,88,4
Sri Lanka,244,223.373,7.09016,0.344262,227.578,7.47541,0.385246,139,MS Atapattu,0,0,0,0,0,0,0,0,12,5,17,12,5,17,0,259,4,0,1,2.63636,0,24.4545,66.9154,11,4
Sri Lanka,244,223.373,7.09016,0.344262,227.578,7.47541,0.385246,139,ST Jayasuriya,0,0,0,0,0,0,0,0,12,5,17,12,5,17,0,259,4,0,1,4.91549,0.211268,33.9859,98.4898,71,0
India,259,242.378,7.15058,0.339768,244.568,7.12741,0.30888,139,V Sehwag,0,0,0,0,0,0,0,0,20,9,29,20,9,29,260,263,8,1,1,5.88636,0.238636,38.8295,108.649,88,0
India,259,242.378,7.15058,0.339768,244.568,7.12741,0.30888,139,SC Ganguly,0,0,0,0,0,0,0,0,20,9,29,20,9,29,260,263,8,1,1,4.56,0.36,36.8,68.2999,25,4
India,259,242.378,7.15058,0.339768,244.568,7.12741,0.30888,139,RV Uthappa,0,0,0,0,0,0,0,0,20,9,29,20,9,29,260,263,8,1,1,3,0.117647,22.1471,89.0071,34,0
Sri Lanka,244,223.373,7.09016,0.344262,227.578,7.47541,0.385246,140,WU Tharanga,0,0,0,0,0,0,0,0,0,4,4,0,4,4,0,230,3,0,1,3.93985,0.263158,32.9699,71.6035,133,4
Sri Lanka,244,223.373,7.09016,0.344262,227.578,7.47541,0.385246,140,ST Jayasuriya,0,0,0,0,0,0,0,0,0,4,4,0,4,4,0,230,3,0,1,4.91549,0.211268,33.9859,98.4898,71,0
Sri Lanka,244,223.373,7.09016,0.344262,227.578,7.47541,0.385246,140,KC Sangakkara,0,0,0,0,0,0,0,0,0,4,4,0,4,4,0,230,3,0,1,4.33659,0.360976,41.9854,80.6276,205,4
Sri Lanka,244,223.373,7.09016,0.344262,227.578,7.47541,0.385246,140,DPMD Jayawardene,0,0,0,0,0,0,0,0,0,4,4,0,4,4,0,230,3,0,1,3.20833,0.244792,31.6979,79.1109,192,4
Sri Lanka,244,223.373,7.09016,0.344262,227.578,7.47541,0.385246,140,MS Atapattu,0,0,0,0,0,0,0,0,0,4,4,0,4,4,0,230,3,0,1,2.63636,0,24.4545,66.9154,11,4
India,259,242.378,7.15058,0.339768,244.568,7.12741,0.30888,140,SC Ganguly,0,0,0,0,0,0,0,0,24,3,27,24,3,27,231,233,8,1,1,4.56,0.36,36.8,68.2999,25,4
India,259,242.378,7.15058,0.339768,244.568,7.12741,0.30888,140,V Sehwag,0,0,0,0,0,0,0,0,24,3,27,24,3,27,231,233,8,1,1,5.88636,0.238636,38.8295,108.649,88,0
India,259,242.378,7.15058,0.339768,244.568,7.12741,0.30888,140,SR Tendulkar,0,0,0,0,0,0,0,0,24,3,27,24,3,27,231,233,8,1,1,5.89773,0.363636,45.6023,84.5376,88,4
Bangladesh,160,218.438,7.70625,0.4,211.106,7.05,0.325,142,Javed Omar,0,0,0,0,0,0,0,0,20,3,23,20,3,23,0,250,7,1,1,2.66667,0.166667,24.3333,48.0263,6,3
Bangladesh,160,218.438,7.70625,0.4,211.106,7.05,0.325,142,Tamim Iqbal,0,0,0,0,0,0,0,0,20,3,23,20,3,23,0,250,7,1,1,4.05344,0.274809,31.8015,76.8068,131,4
India,259,242.378,7.15058,0.339768,244.568,7.12741,0.30888,142,G Gambhir,0,0,0,0,0,0,0,0,28,6,34,28,6,34,251,251,1,0,1,3.99145,0.333333,37.4701,84.1944,117,4
India,259,242.378,7.15058,0.339768,244.568,7.12741,0.30888,142,V Sehwag,0,0,0,0,0,0,0,0,28,6,34,28,6,34,251,251,1,0,1,5.88636,0.238636,38.8295,108.649,88,0
India,259,242.378,7.15058,0.339768,244.568,7.12741,0.30888,142,MS Dhoni,0,0,0,0,0,0,0,0,28,6,34,28,6,34,251,251,1,0,1,3.47872,0.292553,36.7713,84.1612,188,4
India,259,242.378,7.15058,0.339768,244.568,7.12741,0.30888,143,V Sehwag,0,0,0,0,0,0,0,0,12,8,20,12,8,20,0,284,3,0,1,5.88636,0.238636,38.8295,108.649,88,0
India,259,242.378,7.15058,0.339768,244.568,7.12741,0.30888,143,G Gambhir,0,0,0,0,0,0,0,0,12,8,20,12,8,20,0,284,3,0,1,3.99145,0.333333,37.4701,84.1944,117,4
Bangladesh,160,218.438,7.70625,0.4,211.106,7.05,0.325,143,Javed Omar,0,0,0,0,0,0,0,0,8,7,15,8,7,15,285,238,3,1,1,2.66667,0.166667,24.3333,48.0263,6,3
Bangladesh,160,218.438,7.70625,0.4,211.106,7.05,0.325,143,Tamim Iqbal,0,0,0,0,0,0,0,0,8,7,15,8,7,15,285,238,3,1,1,4.05344,0.274809,31.8015,76.8068,131,4
Sri Lanka,244,223.373,7.09016,0.344262,227.578,7.47541,0.385246,146,WU Tharanga,0,0,0,0,0,0,0,0,4,12,16,4,12,16,0,269,2,1,1,3.93985,0.263158,32.9699,71.6035,133,4
Sri Lanka,244,223.373,7.09016,0.344262,227.578,7.47541,0.385246,146,ST Jayasuriya,0,0,0,0,0,0,0,0,4,12,16,4,12,16,0,269,2,1,1,4.91549,0.211268,33.9859,98.4898,71,0
England,221,237.176,7.17647,0.289593,230.633,7.45701,0.384615,146,AN Cook,0,0,0,0,0,0,0,0,16,9,25,16,9,25,270,150,0,0,1,4.17045,0.272727,35.75,75.5524,88,4
England,221,237.176,7.17647,0.289593,230.633,7.45701,0.384615,146,P Mustard,0,0,0,0,0,0,0,0,16,9,25,16,9,25,270,150,0,0,1,3.33333,0.111111,23.8889,88.1148,9,0
England,221,237.176,7.17647,0.289593,230.633,7.45701,0.384615,147,AN Cook,0,0,0,0,0,0,0,0,4,6,10,4,6,10,0,234,0,0,1,4.17045,0.272727,35.75,75.5524,88,4
England,221,237.176,7.17647,0.289593,230.633,7.45701,0.384615,147,P Mustard,0,0,0,0,0,0,0,0,4,6,10,4,6,10,0,234,0,0,1,3.33333,0.111111,23.8889,88.1148,9,0
England,221,237.176,7.17647,0.289593,230.633,7.45701,0.384615,147,IR Bell,0,0,0,0,0,0,0,0,4,6,10,4,6,10,0,234,0,0,1,3.63433,0.246269,35.3806,75.6623,134,4
Sri Lanka,244,223.373,7.09016,0.344262,227.578,7.47541,0.385246,147,WU Tharanga,0,0,0,0,0,0,0,0,8,10,18,8,10,18,235,169,1,1,1,3.93985,0.263158,32.9699,71.6035,133,4
Sri Lanka,244,223.373,7.09016,0.344262,227.578,7.47541,0.385246,147,ST Jayasuriya,0,0,0,0,0,0,0,0,8,10,18,8,10,18,235,169,1,1,1,4.91549,0.211268,33.9859,98.4898,71,0
Sri Lanka,244,223.373,7.09016,0.344262,227.578,7.47541,0.385246,147,KC Sangakkara,0,0,0,0,0,0,0,0,8,10,18,8,10,18,235,169,1,1,1,4.33659,0.360976,41.9854,80.6276,205,4
Sri Lanka,244,223.373,7.09016,0.344262,227.578,7.47541,0.385246,148,WU Tharanga,0,0,0,0,0,0,0,0,4,1,5,4,1,5,0,211,4,1,1,3.93985,0.263158,32.9699,71.6035,133,4
Sri Lanka,244,223.373,7.09016,0.344262,227.578,7.47541,0.385246,148,ST Jayasuriya,0,0,0,0,0,0,0,0,4,1,5,4,1,5,0,211,4,1,1,4.91549,0.211268,33.9859,98.4898,71,0
England,221,237.176,7.17647,0.289593,230.633,7.45701,0.384615,148,AN Cook,0,0,0,0,0,0,0,0,12,8,20,12,8,20,212,212,2,0,1,4.17045,0.272727,35.75,75.5524,88,4
England,221,237.176,7.17647,0.289593,230.633,7.45701,0.384615,148,P Mustard,0,0,0,0,0,0,0,0,12,8,20,12,8,20,212,212,2,0,1,3.33333,0.111111,23.8889,88.1148,9,0
Sri Lanka,244,223.373,7.09016,0.344262,227.578,7.47541,0.385246,149,MDK Perera,0,0,0,0,0,0,0,0,14,16,30,14,16,30,0,211,3,1,1,1,0,11,54.321,4,3
Sri Lanka,244,223.373,7.09016,0.344262,227.578,7.47541,0.385246,149,ST Jayasuriya,0,0,0,0,0,0,0,0,14,16,30,14,16,30,0,211,3,1,1,4.91549,0.211268,33.9859,98.4898,71,0
England,221,237.176,7.17647,0.289593,230.633,7.45701,0.384615,149,AN Cook,0,0,0,0,0,0,0,0,0,6,6,0,6,6,212,104,1,0,1,4.17045,0.272727,35.75,75.5524,88,4
England,221,237.176,7.17647,0.289593,230.633,7.45701,0.384615,149,P Mustard,0,0,0,0,0,0,0,0,0,6,6,0,6,6,212,104,1,0,1,3.33333,0.111111,23.8889,88.1148,9,0
England,221,237.176,7.17647,0.289593,230.633,7.45701,0.384615,149,IR Bell,0,0,0,0,0,0,0,0,0,6,6,0,6,6,212,104,1,0,1,3.63433,0.246269,35.3806,75.6623,134,4
New Zealand,184,233.745,7.39674,0.36413,227.951,7.30435,0.353261,150,L Vincent,0,0,0,0,0,0,0,0,4,6,10,4,6,10,0,254,10,0,1,3.125,0.25,27.8125,67.5266,16,4
New Zealand,184,233.745,7.39674,0.36413,227.951,7.30435,0.353261,150,BB McCullum,0,0,0,0,0,0,0,0,4,6,10,4,6,10,0,254,10,0,1,3.98611,0.201389,29.9028,98.4004,144,0
New Zealand,184,233.745,7.39674,0.36413,227.951,7.30435,0.353261,150,JM How,0,0,0,0,0,0,0,0,4,6,10,4,6,10,0,254,10,0,1,3.34615,0.192308,29.9231,64.9416,26,4
Australia,228,239.627,7.69737,0.372807,232.079,7.23246,0.337719,150,AC Gilchrist,0,0,0,0,0,0,0,0,26,24,50,26,24,50,255,255,1,1,1,4.3,0.275,31.425,96.1009,40,0
Australia,228,239.627,7.69737,0.372807,232.079,7.23246,0.337719,150,ML Hayden,0,0,0,0,0,0,0,0,26,24,50,26,24,50,255,255,1,1,1,6.37838,0.378378,50.6757,83.3333,37,4
Australia,228,239.627,7.69737,0.372807,232.079,7.23246,0.337719,151,ML Hayden,0,0,0,0,0,0,0,0,16,10,26,16,10,26,0,282,0,1,1,6.37838,0.378378,50.6757,83.3333,37,4
Australia,228,239.627,7.69737,0.372807,232.079,7.23246,0.337719,151,MJ Clarke,0,0,0,0,0,0,0,0,16,10,26,16,10,26,0,282,0,1,1,3.10294,0.301471,35.9265,74.0303,136,4
Australia,228,239.627,7.69737,0.372807,232.079,7.23246,0.337719,151,RT Ponting,0,0,0,0,0,0,0,0,16,10,26,16,10,26,0,282,0,1,1,4.17431,0.33945,38.1009,80.8606,109,4
New Zealand,184,233.745,7.39674,0.36413,227.951,7.30435,0.353261,151,JM How,0,0,0,0,0,0,0,0,4,5,9,4,5,9,283,168,0,0,1,3.34615,0.192308,29.9231,64.9416,26,4
New Zealand,184,233.745,7.39674,0.36413,227.951,7.30435,0.353261,151,BB McCullum,0,0,0,0,0,0,0,0,4,5,9,4,5,9,283,168,0,0,1,3.98611,0.201389,29.9028,98.4004,144,0
New Zealand,184,233.745,7.39674,0.36413,227.951,7.30435,0.353261,151,MS Sinclair,0,0,0,0,0,0,0,0,4,5,9,4,5,9,283,168,0,0,1,2.4,0.2,24.4,91.7293,5,0
New Zealand,184,233.745,7.39674,0.36413,227.951,7.30435,0.353261,151,SB Styris,0,0,0,0,0,0,0,0,4,5,9,4,5,9,283,168,0,0,1,3.20755,0.264151,33.8302,78.7094,53,4
Australia,228,239.627,7.69737,0.372807,232.079,7.23246,0.337719,152,AC Gilchrist,0,0,0,0,0,0,0,0,12,12,24,12,12,24,0,253,0,1,1,4.3,0.275,31.425,96.1009,40,0
Australia,228,239.627,7.69737,0.372807,232.079,7.23246,0.337719,152,ML Hayden,0,0,0,0,0,0,0,0,12,12,24,12,12,24,0,253,0,1,1,6.37838,0.378378,50.6757,83.3333,37,4
Sri Lanka,244,223.373,7.09016,0.344262,227.578,7.47541,0.385246,152,WU Tharanga,0,0,0,0,0,0,0,0,8,9,17,8,9,17,254,125,1,0,1,3.93985,0.263158,32.9699,71.6035,133,4
Sri Lanka,244,223.373,7.09016,0.344262,227.578,7.47541,0.385246,152,ST Jayasuriya,0,0,0,0,0,0,0,0,8,9,17,8,9,17,254,125,1,0,1,4.91549,0.211268,33.9859,98.4898,71,0
Australia,228,239.627,7.69737,0.372807,232.079,7.23246,0.337719,153,AC Gilchrist,0,0,0,0,0,0,0,0,20,10,30,20,10,30,0,159,7,1,1,4.3,0.275,31.425,96.1009,40,0
Australia,228,239.627,7.69737,0.372807,232.079,7.23246,0.337719,153,RT Ponting,0,0,0,0,0,0,0,0,20,10,30,20,10,30,0,159,7,1,1,4.17431,0.33945,38.1009,80.8606,109,4
Australia,228,239.627,7.69737,0.372807,232.079,7.23246,0.337719,153,ML Hayden,0,0,0,0,0,0,0,0,20,10,30,20,10,30,0,159,7,1,1,6.37838,0.378378,50.6757,83.3333,37,4
India,259,242.378,7.15058,0.339768,244.568,7.12741,0.30888,153,V Sehwag,0,0,0,0,0,0,0,0,20,9,29,20,9,29,160,160,1,0,1,5.88636,0.238636,38.8295,108.649,88,0
India,259,242.378,7.15058,0.339768,244.568,7.12741,0.30888,153,SR Tendulkar,0,0,0,0,0,0,0,0,20,9,29,20,9,29,160,160,1,0,1,5.89773,0.363636,45.6023,84.5376,88,4
Australia,228,239.627,7.69737,0.372807,232.079,7.23246,0.337719,154,AC Gilchrist,0,0,0,0,0,0,0,0,18,5,23,18,5,23,0,203,1,1,1,4.3,0.275,31.425,96.1009,40,0
Australia,228,239.627,7.69737,0.372807,232.079,7.23246,0.337719,154,ML Hayden,0,0,0,0,0,0,0,0,18,5,23,18,5,23,0,203,1,1,1,6.37838,0.378378,50.6757,83.3333,37,4
India,259,242.378,7.15058,0.339768,244.568,7.12741,0.30888,154,G Gambhir,0,0,0,0,0,0,0,0,12,8,20,12,8,20,204,153,1,0,1,3.99145,0.333333,37.4701,84.1944,117,4
India,259,242.378,7.15058,0.339768,244.568,7.12741,0.30888,154,SR Tendulkar,0,0,0,0,0,0,0,0,12,8,20,12,8,20,204,153,1,0,1,5.89773,0.363636,45.6023,84.5376,88,4
India,259,242.378,7.15058,0.339768,244.568,7.12741,0.30888,154,IK Pathan,0,0,0,0,0,0,0,0,12,8,20,12,8,20,204,153,1,0,1,1.875,0.025,16.85,78.2811,40,1
Sri Lanka,244,223.373,7.09016,0.344262,227.578,7.47541,0.385246,155,TM Dilshan,0,0,0,0,0,0,0,0,4,3,7,4,3,7,0,238,0,0,1,4.60199,0.273632,38.3632,86.0219,201,4
Sri Lanka,244,223.373,7.09016,0.344262,227.578,7.47541,0.385246,155,KC Sangakkara,0,0,0,0,0,0,0,0,4,3,7,4,3,7,0,238,0,0,1,4.33659,0.360976,41.9854,80.6276,205,4
Sri Lanka,244,223.373,7.09016,0.344262,227.578,7.47541,0.385246,155,ST Jayasuriya,0,0,0,0,0,0,0,0,4,3,7,4,3,7,0,238,0,0,1,4.91549,0.211268,33.9859,98.4898,71,0
Sri Lanka,244,223.373,7.09016,0.344262,227.578,7.47541,0.385246,155,DPMD Jayawardene,0,0,0,0,0,0,0,0,4,3,7,4,3,7,0,238,0,0,1,3.20833,0.244792,31.6979,79.1109,192,4
India,259,242.378,7.15058,0.339768,244.568,7.12741,0.30888,155,G Gambhir,0,0,0,0,0,0,0,0,4,9,13,4,9,13,239,239,3,0,1,3.99145,0.333333,37.4701,84.1944,117,4
India,259,242.378,7.15058,0.339768,244.568,7.12741,0.30888,155,SR Tendulkar,0,0,0,0,0,0,0,0,4,9,13,4,9,13,239,239,3,0,1,5.89773,0.363636,45.6023,84.5376,88,4
India,259,242.378,7.15058,0.339768,244.568,7.12741,0.30888,155,RV Uthappa,0,0,0,0,0,0,0,0,4,9,13,4,9,13,239,239,3,0,1,3,0.117647,22.1471,89.0071,34,0
Australia,228,239.627,7.69737,0.372807,232.079,7.23246,0.337719,156,AC Gilchrist,0,0,0,0,0,0,0,0,4,8,12,4,8,12,0,184,0,1,1,4.3,0.275,31.425,96.1009,40,0
Australia,228,239.627,7.69737,0.372807,232.079,7.23246,0.337719,156,ML Hayden,0,0,0,0,0,0,0,0,4,8,12,4,8,12,0,184,0,1,1,6.37838,0.378378,50.6757,83.3333,37,4
Australia,228,239.627,7.69737,0.372807,232.079,7.23246,0.337719,156,RT Ponting,0,0,0,0,0,0,0,0,4,8,12,4,8,12,0,184,0,1,1,4.17431,0.33945,38.1009,80.8606,109,4
Sri Lanka,244,223.373,7.09016,0.344262,227.578,7.47541,0.385246,156,MDK Perera,0,0,0,0,0,0,0,0,0,8,8,0,8,8,185,77,0,0,1,1,0,11,54.321,4,3
Sri Lanka,244,223.373,7.09016,0.344262,227.578,7.47541,0.385246,156,ST Jayasuriya,0,0,0,0,0,0,0,0,0,8,8,0,8,8,185,77,0,0,1,4.91549,0.211268,33.9859,98.4898,71,0
Sri Lanka,244,223.373,7.09016,0.344262,227.578,7.47541,0.385246,156,KC Sangakkara,0,0,0,0,0,0,0,0,0,8,8,0,8,8,185,77,0,0,1,4.33659,0.360976,41.9854,80.6276,205,4
Sri Lanka,244,223.373,7.09016,0.344262,227.578,7.47541,0.385246,156,DPMD Jayawardene,0,0,0,0,0,0,0,0,0,8,8,0,8,8,185,77,0,0,1,3.20833,0.244792,31.6979,79.1109,192,4
Australia,228,239.627,7.69737,0.372807,232.079,7.23246,0.337719,157,AC Gilchrist,0,0,0,0,0,0,0,0,34,9,43,34,9,43,0,317,1,1,1,4.3,0.275,31.425,96.1009,40,0
Australia,228,239.627,7.69737,0.372807,232.079,7.23246,0.337719,157,ML Hayden,0,0,0,0,0,0,0,0,34,9,43,34,9,43,0,317,1,1,1,6.37838,0.378378,50.6757,83.3333,37,4
Australia,228,239.627,7.69737,0.372807,232.079,7.23246,0.337719,157,RT Ponting,0,0,0,0,0,0,0,0,34,9,43,34,9,43,0,317,1,1,1,4.17431,0.33945,38.1009,80.8606,109,4
India,259,242.378,7.15058,0.339768,244.568,7.12741,0.30888,157,V Sehwag,0,0,0,0,0,0,0,0,16,8,24,16,8,24,318,299,2,0,1,5.88636,0.238636,38.8295,108.649,88,0
India,259,242.378,7.15058,0.339768,244.568,7.12741,0.30888,157,SR Tendulkar,0,0,0,0,0,0,0,0,16,8,24,16,8,24,318,299,2,0,1,5.89773,0.363636,45.6023,84.5376,88,4
India,259,242.378,7.15058,0.339768,244.568,7.12741,0.30888,157,G Gambhir,0,0,0,0,0,0,0,0,16,8,24,16,8,24,318,299,2,0,1,3.99145,0.333333,37.4701,84.1944,117,4
Sri Lanka,244,223.373,7.09016,0.344262,227.578,7.47541,0.385246,158,MDK Perera,0,0,0,0,0,0,0,0,12,6,18,12,6,18,0,179,2,0,1,1,0,11,54.321,4,3
Sri Lanka,244,223.373,7.09016,0.344262,227.578,7.47541,0.385246,158,ST Jayasuriya,0,0,0,0,0,0,0,0,12,6,18,12,6,18,0,179,2,0,1,4.91549,0.211268,33.9859,98.4898,71,0
Sri Lanka,244,223.373,7.09016,0.344262,227.578,7.47541,0.385246,158,KC Sangakkara,0,0,0,0,0,0,0,0,12,6,18,12,6,18,0,179,2,0,1,4.33659,0.360976,41.9854,80.6276,205,4
India,259,242.378,7.15058,0.339768,244.568,7.12741,0.30888,158,RV Uthappa,0,0,0,0,0,0,0,0,20,9,29,20,9,29,180,180,1,0,1,3,0.117647,22.1471,89.0071,34,0
India,259,242.378,7.15058,0.339768,244.568,7.12741,0.30888,158,SR Tendulkar,0,0,0,0,0,0,0,0,20,9,29,20,9,29,180,180,1,0,1,5.89773,0.363636,45.6023,84.5376,88,4
India,259,242.378,7.15058,0.339768,244.568,7.12741,0.30888,158,G Gambhir,0,0,0,0,0,0,0,0,20,9,29,20,9,29,180,180,1,0,1,3.99145,0.333333,37.4701,84.1944,117,4
Sri Lanka,244,223.373,7.09016,0.344262,227.578,7.47541,0.385246,159,MDK Perera,0,0,0,0,0,0,0,0,4,8,12,4,8,12,0,221,0,0,1,1,0,11,54.321,4,3
Sri Lanka,244,223.373,7.09016,0.344262,227.578,7.47541,0.385246,159,ST Jayasuriya,0,0,0,0,0,0,0,0,4,8,12,4,8,12,0,221,0,0,1,4.91549,0.211268,33.9859,98.4898,71,0
Sri Lanka,244,223.373,7.09016,0.344262,227.578,7.47541,0.385246,159,KC Sangakkara,0,0,0,0,0,0,0,0,4,8,12,4,8,12,0,221,0,0,1,4.33659,0.360976,41.9854,80.6276,205,4
Australia,228,239.627,7.69737,0.372807,232.079,7.23246,0.337719,159,AC Gilchrist,0,0,0,0,0,0,0,0,8,11,19,8,11,19,222,208,1,1,1,4.3,0.275,31.425,96.1009,40,0
Australia,228,239.627,7.69737,0.372807,232.079,7.23246,0.337719,159,JR Hopes,0,0,0,0,0,0,0,0,8,11,19,8,11,19,222,208,1,1,1,2.09259,0.0555556,21.2778,91.4809,54,0
Australia,228,239.627,7.69737,0.372807,232.079,7.23246,0.337719,160,AC Gilchrist,0,0,0,0,0,0,0,0,12,9,21,12,9,21,0,239,2,1,1,4.3,0.275,31.425,96.1009,40,0
Australia,228,239.627,7.69737,0.372807,232.079,7.23246,0.337719,160,ML Hayden,0,0,0,0,0,0,0,0,12,9,21,12,9,21,0,239,2,1,1,6.37838,0.378378,50.6757,83.3333,37,4
Australia,228,239.627,7.69737,0.372807,232.079,7.23246,0.337719,160,RT Ponting,0,0,0,0,0,0,0,0,12,9,21,12,9,21,0,239,2,1,1,4.17431,0.33945,38.1009,80.8606,109,4
Australia,228,239.627,7.69737,0.372807,232.079,7.23246,0.337719,160,MJ Clarke,0,0,0,0,0,0,0,0,12,9,21,12,9,21,0,239,2,1,1,3.10294,0.301471,35.9265,74.0303,136,4
India,259,242.378,7.15058,0.339768,244.568,7.12741,0.30888,160,RV Uthappa,0,0,0,0,0,0,0,0,4,15,19,4,15,19,240,242,3,0,1,3,0.117647,22.1471,89.0071,34,0
India,259,242.378,7.15058,0.339768,244.568,7.12741,0.30888,160,SR Tendulkar,0,0,0,0,0,0,0,0,4,15,19,4,15,19,240,242,3,0,1,5.89773,0.363636,45.6023,84.5376,88,4
India,259,242.378,7.15058,0.339768,244.568,7.12741,0.30888,161,RV Uthappa,0,0,0,0,0,0,0,0,0,13,13,0,13,13,0,258,1,0,1,3,0.117647,22.1471,89.0071,34,0
India,259,242.378,7.15058,0.339768,244.568,7.12741,0.30888,161,SR Tendulkar,0,0,0,0,0,0,0,0,0,13,13,0,13,13,0,258,1,0,1,5.89773,0.363636,45.6023,84.5376,88,4
Australia,228,239.627,7.69737,0.372807,232.079,7.23246,0.337719,161,AC Gilchrist,0,0,0,0,0,0,0,0,4,9,13,4,9,13,259,249,0,1,1,4.3,0.275,31.425,96.1009,40,0
Australia,228,239.627,7.69737,0.372807,232.079,7.23246,0.337719,161,RT Ponting,0,0,0,0,0,0,0,0,4,9,13,4,9,13,259,249,0,1,1,4.17431,0.33945,38.1009,80.8606,109,4
Australia,228,239.627,7.69737,0.372807,232.079,7.23246,0.337719,161,ML Hayden,0,0,0,0,0,0,0,0,4,9,13,4,9,13,259,249,0,1,1,6.37838,0.378378,50.6757,83.3333,37,4
Australia,228,239.627,7.69737,0.372807,232.079,7.23246,0.337719,161,MJ Clarke,0,0,0,0,0,0,0,0,4,9,13,4,9,13,259,249,0,1,1,3.10294,0.301471,35.9265,74.0303,136,4
Ireland,55,219.527,7.65455,0.290909,202.727,7.56364,0.4,162,WTS Porterfield,0,0,0,0,0,0,0,0,4,9,13,4,9,13,0,193,2,1,1,2.6,0.142857,24.6857,56.2866,35,3
Ireland,55,219.527,7.65455,0.290909,202.727,7.56364,0.4,162,KED Carroll,0,0,0,0,0,0,0,0,4,9,13,4,9,13,0,193,2,1,1,0.333333,0,9.33333,66.6667,3,1
Ireland,55,219.527,7.65455,0.290909,202.727,7.56364,0.4,162,DI Joyce,0,0,0,0,0,0,0,0,4,9,13,4,9,13,0,193,2,1,1,1.33333,0,9.66667,47.541,3,3
India,259,242.378,7.15058,0.339768,244.568,7.12741,0.30888,162,SC Ganguly,0,0,0,0,0,0,0,0,12,12,24,12,12,24,194,171,6,0,1,4.56,0.36,36.8,68.2999,25,4
India,259,242.378,7.15058,0.339768,244.568,7.12741,0.30888,162,SR Tendulkar,0,0,0,0,0,0,0,0,12,12,24,12,12,24,194,171,6,0,1,5.89773,0.363636,45.6023,84.5376,88,4
India,259,242.378,7.15058,0.339768,244.568,7.12741,0.30888,162,G Gambhir,0,0,0,0,0,0,0,0,12,12,24,12,12,24,194,171,6,0,1,3.99145,0.333333,37.4701,84.1944,117,4
India,259,242.378,7.15058,0.339768,244.568,7.12741,0.30888,163,SC Ganguly,0,0,0,0,0,0,0,0,4,3,7,4,3,7,0,242,5,0,1,4.56,0.36,36.8,68.2999,25,4
India,259,242.378,7.15058,0.339768,244.568,7.12741,0.30888,163,SR Tendulkar,0,0,0,0,0,0,0,0,4,3,7,4,3,7,0,242,5,0,1,5.89773,0.363636,45.6023,84.5376,88,4
South Africa,190,234.274,7.4,0.373684,232.363,7.33158,0.342105,163,AB de Villiers,0,0,0,0,0,0,0,0,4,11,15,4,11,15,243,245,3,0,1,5.04969,0.403727,47.2174,98.8428,161,4
South Africa,190,234.274,7.4,0.373684,232.363,7.33158,0.342105,163,MN van Wyk,0,0,0,0,0,0,0,0,4,11,15,4,11,15,243,245,3,0,1,3.33333,0.266667,27.2,66.9951,15,4
South Africa,190,234.274,7.4,0.373684,232.363,7.33158,0.342105,164,MN van Wyk,0,0,0,0,0,0,0,0,0,5,5,0,5,5,0,226,2,0,1,3.33333,0.266667,27.2,66.9951,15,4
South Africa,190,234.274,7.4,0.373684,232.363,7.33158,0.342105,164,AB de Villiers,0,0,0,0,0,0,0,0,0,5,5,0,5,5,0,226,2,0,1,5.04969,0.403727,47.2174,98.8428,161,4
South Africa,190,234.274,7.4,0.373684,232.363,7.33158,0.342105,164,JH Kallis,0,0,0,0,0,0,0,0,0,5,5,0,5,5,0,226,2,0,1,3.58621,0.356322,37.2644,76.4442,87,4
India,259,242.378,7.15058,0.339768,244.568,7.12741,0.30888,164,SC Ganguly,0,0,0,0,0,0,0,0,16,4,20,16,4,20,227,227,1,0,1,4.56,0.36,36.8,68.2999,25,4
India,259,242.378,7.15058,0.339768,244.568,7.12741,0.30888,164,SR Tendulkar,0,0,0,0,0,0,0,0,16,4,20,16,4,20,227,227,1,0,1,5.89773,0.363636,45.6023,84.5376,88,4
South Africa,190,234.274,7.4,0.373684,232.363,7.33158,0.342105,165,AB de Villiers,0,0,0,0,0,0,0,0,8,4,12,8,4,12,0,148,0,0,1,5.04969,0.403727,47.2174,98.8428,161,4
South Africa,190,234.274,7.4,0.373684,232.363,7.33158,0.342105,165,MN van Wyk,0,0,0,0,0,0,0,0,8,4,12,8,4,12,0,148,0,0,1,3.33333,0.266667,27.2,66.9951,15,4
South Africa,190,234.274,7.4,0.373684,232.363,7.33158,0.342105,165,JH Kallis,0,0,0,0,0,0,0,0,8,4,12,8,4,12,0,148,0,0,1,3.58621,0.356322,37.2644,76.4442,87,4
South Africa,190,234.274,7.4,0.373684,232.363,7.33158,0.342105,165,HH Gibbs,0,0,0,0,0,0,0,0,8,4,12,8,4,12,0,148,0,0,1,4.61538,0.307692,35.6923,83.4157,52,4
India,259,242.378,7.15058,0.339768,244.568,7.12741,0.30888,165,SC Ganguly,0,0,0,0,0,0,0,0,12,8,20,12,8,20,149,152,2,0,1,4.56,0.36,36.8,68.2999,25,4
India,259,242.378,7.15058,0.339768,244.568,7.12741,0.30888,165,SR Tendulkar,0,0,0,0,0,0,0,0,12,8,20,12,8,20,149,152,2,0,1,5.89773,0.363636,45.6023,84.5376,88,4
India,259,242.378,7.15058,0.339768,244.568,7.12741,0.30888,165,G Gambhir,0,0,0,0,0,0,0,0,12,8,20,12,8,20,149,152,2,0,1,3.99145,0.333333,37.4701,84.1944,117,4
India,259,242.378,7.15058,0.339768,244.568,7.12741,0.30888,165,R Dravid,0,0,0,0,0,0,0,0,12,8,20,12,8,20,149,152,2,0,1,2.83721,0.255814,29.8605,72.7067,43,4
Sri Lanka,244,223.373,7.09016,0.344262,227.578,7.47541,0.385246,166,WU Tharanga,0,0,0,0,0,0,0,0,12,5,17,12,5,17,0,234,1,1,1,3.93985,0.263158,32.9699,71.6035,133,4
Sri Lanka,244,223.373,7.09016,0.344262,227.578,7.47541,0.385246,166,ST Jayasuriya,0,0,0,0,0,0,0,0,12,5,17,12,5,17,0,234,1,1,1,4.91549,0.211268,33.9859,98.4898,71,0
Bangladesh,160,218.438,7.70625,0.4,211.106,7.05,0.325,166,Tamim Iqbal,0,0,0,0,0,0,0,0,4,6,10,4,6,10,235,164,3,0,1,4.05344,0.274809,31.8015,76.8068,131,4
Bangladesh,160,218.438,7.70625,0.4,211.106,7.05,0.325,166,Shahriar Nafees,0,0,0,0,0,0,0,0,4,6,10,4,6,10,235,164,3,0,1,3.40541,0.162162,24.4865,69.1076,37,4
Bangladesh,160,218.438,7.70625,0.4,211.106,7.05,0.325,167,Tamim Iqbal,0,0,0,0,0,0,0,0,4,5,9,4,5,9,0,137,4,0,1,4.05344,0.274809,31.8015,76.8068,131,4
Bangladesh,160,218.438,7.70625,0.4,211.106,7.05,0.325,167,Shahriar Nafees,0,0,0,0,0,0,0,0,4,5,9,4,5,9,0,137,4,0,1,3.40541,0.162162,24.4865,69.1076,37,4
Bangladesh,160,218.438,7.70625,0.4,211.106,7.05,0.325,167,Tushar Imran,0,0,0,0,0,0,0,0,4,5,9,4,5,9,0,137,4,0,1,1,0,6.75,32.1429,4,3
Sri Lanka,244,223.373,7.09016,0.344262,227.578,7.47541,0.385246,167,WU Tharanga,0,0,0,0,0,0,0,0,12,9,21,12,9,21,138,141,6,1,1,3.93985,0.263158,32.9699,71.6035,133,4
Sri Lanka,244,223.373,7.09016,0.344262,227.578,7.47541,0.385246,167,ST Jayasuriya,0,0,0,0,0,0,0,0,12,9,21,12,9,21,138,141,6,1,1,4.91549,0.211268,33.9859,98.4898,71,0
Sri Lanka,244,223.373,7.09016,0.344262,227.578,7.47541,0.385246,168,WU Tharanga,0,0,0,0,0,0,0,0,16,8,24,16,8,24,0,196,6,1,1,3.93985,0.263158,32.9699,71.6035,133,4
Sri Lanka,244,223.373,7.09016,0.344262,227.578,7.47541,0.385246,168,ST Jayasuriya,0,0,0,0,0,0,0,0,16,8,24,16,8,24,0,196,6,1,1,4.91549,0.211268,33.9859,98.4898,71,0
Sri Lanka,244,223.373,7.09016,0.344262,227.578,7.47541,0.385246,168,KC Sangakkara,0,0,0,0,0,0,0,0,16,8,24,16,8,24,0,196,6,1,1,4.33659,0.360976,41.9854,80.6276,205,4
Sri Lanka,244,223.373,7.09016,0.344262,227.578,7.47541,0.385246,168,CK Kapugedera,0,0,0,0,0,0,0,0,16,8,24,16,8,24,0,196,6,1,1,1.74138,0.12069,21.1379,68.6066,58,1
Bangladesh,160,218.438,7.70625,0.4,211.106,7.05,0.325,168,Javed Omar,0,0,0,0,0,0,0,0,4,6,10,4,6,10,197,157,14,0,1,2.66667,0.166667,24.3333,48.0263,6,3
Bangladesh,160,218.438,7.70625,0.4,211.106,7.05,0.325,168,Mushfiqur Rahim,0,0,0,0,0,0,0,0,4,6,10,4,6,10,197,157,14,0,1,2.61111,0.18254,27.7778,75.2526,126,4
Bangladesh,160,218.438,7.70625,0.4,211.106,7.05,0.325,168,Tamim Iqbal,0,0,0,0,0,0,0,0,4,6,10,4,6,10,197,157,14,0,1,4.05344,0.274809,31.8015,76.8068,131,4
Bangladesh,160,218.438,7.70625,0.4,211.106,7.05,0.325,168,Mohammad Ashraful,0,0,0,0,0,0,0,0,4,6,10,4,6,10,197,157,14,0,1,2.17722,0.113924,19.4557,63.9085,79,1
England,221,237.176,7.17647,0.289593,230.633,7.45701,0.384615,171,IR Bell,0,0,0,0,0,0,0,0,18,5,23,18,5,23,0,307,4,1,1,3.63433,0.246269,35.3806,75.6623,134,4
England,221,237.176,7.17647,0.289593,230.633,7.45701,0.384615,171,LJ Wright,0,0,0,0,0,0,0,0,18,5,23,18,5,23,0,307,4,1,1,1.92105,0.0263158,17.2368,81.875,38,1
New Zealand,184,233.745,7.39674,0.36413,227.951,7.30435,0.353261,171,JM How,0,0,0,0,0,0,0,0,18,12,30,18,12,30,308,193,4,0,1,3.34615,0.192308,29.9231,64.9416,26,4
New Zealand,184,233.745,7.39674,0.36413,227.951,7.30435,0.353261,171,BB McCullum,0,0,0,0,0,0,0,0,18,12,30,18,12,30,308,193,4,0,1,3.98611,0.201389,29.9028,98.4004,144,0
England,221,237.176,7.17647,0.289593,230.633,7.45701,0.384615,172,IR Bell,0,0,0,0,0,0,0,0,6,12,18,6,12,18,0,245,4,1,1,3.63433,0.246269,35.3806,75.6623,134,4
England,221,237.176,7.17647,0.289593,230.633,7.45701,0.384615,172,LJ Wright,0,0,0,0,0,0,0,0,6,12,18,6,12,18,0,245,4,1,1,1.92105,0.0263158,17.2368,81.875,38,1
New Zealand,184,233.745,7.39674,0.36413,227.951,7.30435,0.353261,172,JM How,0,0,0,0,0,0,0,0,8,5,13,8,5,13,246,246,1,0,1,3.34615,0.192308,29.9231,64.9416,26,4
New Zealand,184,233.745,7.39674,0.36413,227.951,7.30435,0.353261,172,BB McCullum,0,0,0,0,0,0,0,0,8,5,13,8,5,13,246,246,1,0,1,3.98611,0.201389,29.9028,98.4004,144,0
New Zealand,184,233.745,7.39674,0.36413,227.951,7.30435,0.353261,172,LRPL Taylor,0,0,0,0,0,0,0,0,8,5,13,8,5,13,246,246,1,0,1,3.68382,0.301471,36.7206,79.3959,136,4
New Zealand,184,233.745,7.39674,0.36413,227.951,7.30435,0.353261,173,JM How,0,0,0,0,0,0,0,0,0,9,9,0,9,9,0,266,8,0,1,3.34615,0.192308,29.9231,64.9416,26,4
New Zealand,184,233.745,7.39674,0.36413,227.951,7.30435,0.353261,173,BB McCullum,0,0,0,0,0,0,0,0,0,9,9,0,9,9,0,266,8,0,1,3.98611,0.201389,29.9028,98.4004,144,0
England,221,237.176,7.17647,0.289593,230.633,7.45701,0.384615,173,IR Bell,0,0,0,0,0,0,0,0,16,2,18,16,2,18,267,215,5,1,1,3.63433,0.246269,35.3806,75.6623,134,4
England,221,237.176,7.17647,0.289593,230.633,7.45701,0.384615,173,AN Cook,0,0,0,0,0,0,0,0,16,2,18,16,2,18,267,215,5,1,1,4.17045,0.272727,35.75,75.5524,88,4
England,221,237.176,7.17647,0.289593,230.633,7.45701,0.384615,174,IR Bell,0,0,0,0,0,0,0,0,12,13,25,12,13,25,0,275,2,1,1,3.63433,0.246269,35.3806,75.6623,134,4
England,221,237.176,7.17647,0.289593,230.633,7.45701,0.384615,174,MJ Prior,0,0,0,0,0,0,0,0,12,13,25,12,13,25,0,275,2,1,1,2.27083,0.0625,21.6875,76.4879,48,4
South Africa,190,234.274,7.4,0.373684,232.363,7.33158,0.342105,174,HH Gibbs,0,0,0,0,0,0,0,0,8,14,22,8,14,22,276,255,3,0,1,4.61538,0.307692,35.6923,83.4157,52,4
South Africa,190,234.274,7.4,0.373684,232.363,7.33158,0.342105,174,GC Smith,0,0,0,0,0,0,0,0,8,14,22,8,14,22,276,255,3,0,1,3.97,0.29,33.57,79.6819,100,4
South Africa,190,234.274,7.4,0.373684,232.363,7.33158,0.342105,175,GC Smith,0,0,0,0,0,0,0,0,12,8,20,12,8,20,0,83,1,0,1,3.97,0.29,33.57,79.6819,100,4
South Africa,190,234.274,7.4,0.373684,232.363,7.33158,0.342105,175,HH Gibbs,0,0,0,0,0,0,0,0,12,8,20,12,8,20,0,83,1,0,1,4.61538,0.307692,35.6923,83.4157,52,4
South Africa,190,234.274,7.4,0.373684,232.363,7.33158,0.342105,175,JH Kallis,0,0,0,0,0,0,0,0,12,8,20,12,8,20,0,83,1,0,1,3.58621,0.356322,37.2644,76.4442,87,4
England,221,237.176,7.17647,0.289593,230.633,7.45701,0.384615,175,IR Bell,0,0,0,0,0,0,0,0,8,9,17,8,9,17,84,85,4,1,1,3.63433,0.246269,35.3806,75.6623,134,4
England,221,237.176,7.17647,0.289593,230.633,7.45701,0.384615,175,MJ Prior,0,0,0,0,0,0,0,0,8,9,17,8,9,17,84,85,4,1,1,2.27083,0.0625,21.6875,76.4879,48,4
England,221,237.176,7.17647,0.289593,230.633,7.45701,0.384615,176,IR Bell,0,0,0,0,0,0,0,0,26,1,27,26,1,27,0,296,4,1,1,3.63433,0.246269,35.3806,75.6623,134,4
England,221,237.176,7.17647,0.289593,230.633,7.45701,0.384615,176,MJ Prior,0,0,0,0,0,0,0,0,26,1,27,26,1,27,0,296,4,1,1,2.27083,0.0625,21.6875,76.4879,48,4
South Africa,190,234.274,7.4,0.373684,232.363,7.33158,0.342105,176,HM Amla,0,0,0,0,0,0,0,0,0,9,9,0,9,9,297,170,1,0,1,5.20168,0.403361,48.7899,86.9292,119,4
South Africa,190,234.274,7.4,0.373684,232.363,7.33158,0.342105,176,HH Gibbs,0,0,0,0,0,0,0,0,0,9,9,0,9,9,297,170,1,0,1,4.61538,0.307692,35.6923,83.4157,52,4
South Africa,190,234.274,7.4,0.373684,232.363,7.33158,0.342105,177,HH Gibbs,0,0,0,0,0,0,0,0,24,7,31,24,7,31,0,183,5,0,1,4.61538,0.307692,35.6923,83.4157,52,4
South Africa,190,234.274,7.4,0.373684,232.363,7.33158,0.342105,177,HM Amla,0,0,0,0,0,0,0,0,24,7,31,24,7,31,0,183,5,0,1,5.20168,0.403361,48.7899,86.9292,119,4
England,221,237.176,7.17647,0.289593,230.633,7.45701,0.384615,177,IR Bell,0,0,0,0,0,0,0,0,4,12,16,4,12,16,184,137,3,1,1,3.63433,0.246269,35.3806,75.6623,134,4
England,221,237.176,7.17647,0.289593,230.633,7.45701,0.384615,177,MJ Prior,0,0,0,0,0,0,0,0,4,12,16,4,12,16,184,137,3,1,1,2.27083,0.0625,21.6875,76.4879,48,4
England,221,237.176,7.17647,0.289593,230.633,7.45701,0.384615,177,OA Shah,0,0,0,0,0,0,0,0,4,12,16,4,12,16,184,137,3,1,1,3.13043,0.23913,32.6739,81.1994,46,4
England,221,237.176,7.17647,0.289593,230.633,7.45701,0.384615,177,KP Pietersen,0,0,0,0,0,0,0,0,4,12,16,4,12,16,184,137,3,1,1,3.69892,0.236559,33.4946,82.2117,93,4
Australia,228,239.627,7.69737,0.372807,232.079,7.23246,0.337719,178,AC Gilchrist,0,0,0,0,0,0,0,0,8,10,18,8,10,18,0,306,3,0,1,4.3,0.275,31.425,96.1009,40,0
Australia,228,239.627,7.69737,0.372807,232.079,7.23246,0.337719,178,ML Hayden,0,0,0,0,0,0,0,0,8,10,18,8,10,18,0,306,3,0,1,6.37838,0.378378,50.6757,83.3333,37,4
Australia,228,239.627,7.69737,0.372807,232.079,7.23246,0.337719,178,BJ Hodge,0,0,0,0,0,0,0,0,8,10,18,8,10,18,0,306,3,0,1,2.76923,0.153846,26.4615,83.9024,13,4
Australia,228,239.627,7.69737,0.372807,232.079,7.23246,0.337719,178,MJ Clarke,0,0,0,0,0,0,0,0,8,10,18,8,10,18,0,306,3,0,1,3.10294,0.301471,35.9265,74.0303,136,4
India,259,242.378,7.15058,0.339768,244.568,7.12741,0.30888,178,G Gambhir,0,0,0,0,0,0,0,0,20,6,26,20,6,26,307,222,3,1,1,3.99145,0.333333,37.4701,84.1944,117,4
India,259,242.378,7.15058,0.339768,244.568,7.12741,0.30888,178,SR Tendulkar,0,0,0,0,0,0,0,0,20,6,26,20,6,26,307,222,3,1,1,5.89773,0.363636,45.6023,84.5376,88,4
India,259,242.378,7.15058,0.339768,244.568,7.12741,0.30888,178,RV Uthappa,0,0,0,0,0,0,0,0,20,6,26,20,6,26,307,222,3,1,1,3,0.117647,22.1471,89.0071,34,0
Australia,228,239.627,7.69737,0.372807,232.079,7.23246,0.337719,179,AC Gilchrist,0,0,0,0,0,0,0,0,16,13,29,16,13,29,0,290,2,0,1,4.3,0.275,31.425,96.1009,40,0
Australia,228,239.627,7.69737,0.372807,232.079,7.23246,0.337719,179,ML Hayden,0,0,0,0,0,0,0,0,16,13,29,16,13,29,0,290,2,0,1,6.37838,0.378378,50.6757,83.3333,37,4
India,259,242.378,7.15058,0.339768,244.568,7.12741,0.30888,179,G Gambhir,0,0,0,0,0,0,0,0,4,9,13,4,9,13,291,243,2,1,1,3.99145,0.333333,37.4701,84.1944,117,4
India,259,242.378,7.15058,0.339768,244.568,7.12741,0.30888,179,SR Tendulkar,0,0,0,0,0,0,0,0,4,9,13,4,9,13,291,243,2,1,1,5.89773,0.363636,45.6023,84.5376,88,4
India,259,242.378,7.15058,0.339768,244.568,7.12741,0.30888,179,RV Uthappa,0,0,0,0,0,0,0,0,4,9,13,4,9,13,291,243,2,1,1,3,0.117647,22.1471,89.0071,34,0
India,259,242.378,7.15058,0.339768,244.568,7.12741,0.30888,179,R Dravid,0,0,0,0,0,0,0,0,4,9,13,4,9,13,291,243,2,1,1,2.83721,0.255814,29.8605,72.7067,43,4
India,259,242.378,7.15058,0.339768,244.568,7.12741,0.30888,179,Yuvraj Singh,0,0,0,0,0,0,0,0,4,9,13,4,9,13,291,243,2,1,1,4.05833,0.258333,32.525,83.8093,120,4
India,259,242.378,7.15058,0.339768,244.568,7.12741,0.30888,180,SC Ganguly,0,0,0,0,0,0,0,0,4,3,7,4,3,7,0,291,6,1,1,4.56,0.36,36.8,68.2999,25,4
India,259,242.378,7.15058,0.339768,244.568,7.12741,0.30888,180,SR Tendulkar,0,0,0,0,0,0,0,0,4,3,7,4,3,7,0,291,6,1,1,5.89773,0.363636,45.6023,84.5376,88,4
Australia,228,239.627,7.69737,0.372807,232.079,7.23246,0.337719,180,AC Gilchrist,0,0,0,0,0,0,0,0,20,13,33,20,13,33,292,283,4,0,1,4.3,0.275,31.425,96.1009,40,0
Australia,228,239.627,7.69737,0.372807,232.079,7.23246,0.337719,180,ML Hayden,0,0,0,0,0,0,0,0,20,13,33,20,13,33,292,283,4,0,1,6.37838,0.378378,50.6757,83.3333,37,4
Australia,228,239.627,7.69737,0.372807,232.079,7.23246,0.337719,181,AC Gilchrist,0,0,0,0,0,0,0,0,26,7,33,26,7,33,0,317,1,0,1,4.3,0.275,31.425,96.1009,40,0
Australia,228,239.627,7.69737,0.372807,232.079,7.23246,0.337719,181,MJ Clarke,0,0,0,0,0,0,0,0,26,7,33,26,7,33,0,317,1,0,1,3.10294,0.301471,35.9265,74.0303,136,4
Australia,228,239.627,7.69737,0.372807,232.079,7.23246,0.337719,181,RT Ponting,0,0,0,0,0,0,0,0,26,7,33,26,7,33,0,317,1,0,1,4.17431,0.33945,38.1009,80.8606,109,4
India,259,242.378,7.15058,0.339768,244.568,7.12741,0.30888,181,SC Ganguly,0,0,0,0,0,0,0,0,24,3,27,24,3,27,318,299,1,1,1,4.56,0.36,36.8,68.2999,25,4
India,259,242.378,7.15058,0.339768,244.568,7.12741,0.30888,181,SR Tendulkar,0,0,0,0,0,0,0,0,24,3,27,24,3,27,318,299,1,1,1,5.89773,0.363636,45.6023,84.5376,88,4
Australia,228,239.627,7.69737,0.372807,232.079,7.23246,0.337719,182,MJ Clarke,0,0,0,0,0,0,0,0,4,10,14,4,10,14,0,193,10,0,1,3.10294,0.301471,35.9265,74.0303,136,4
Australia,228,239.627,7.69737,0.372807,232.079,7.23246,0.337719,182,RT Ponting,0,0,0,0,0,0,0,0,4,10,14,4,10,14,0,193,10,0,1,4.17431,0.33945,38.1009,80.8606,109,4
Australia,228,239.627,7.69737,0.372807,232.079,7.23246,0.337719,182,AC Gilchrist,0,0,0,0,0,0,0,0,4,10,14,4,10,14,0,193,10,0,1,4.3,0.275,31.425,96.1009,40,0
India,259,242.378,7.15058,0.339768,244.568,7.12741,0.30888,182,SC Ganguly,0,0,0,0,0,0,0,0,8,1,9,8,1,9,194,195,7,1,1,4.56,0.36,36.8,68.2999,25,4
India,259,242.378,7.15058,0.339768,244.568,7.12741,0.30888,182,SR Tendulkar,0,0,0,0,0,0,0,0,8,1,9,8,1,9,194,195,7,1,1,5.89773,0.363636,45.6023,84.5376,88,4
India,259,242.378,7.15058,0.339768,244.568,7.12741,0.30888,182,KD Karthik,0,0,0,0,0,0,0,0,8,1,9,8,1,9,194,195,7,1,1,2.46429,0.107143,21.6786,71.8769,56,1
India,259,242.378,7.15058,0.339768,244.568,7.12741,0.30888,182,Yuvraj Singh,0,0,0,0,0,0,0,0,8,1,9,8,1,9,194,195,7,1,1,4.05833,0.258333,32.525,83.8093,120,4
Pakistan,211,222.621,7.38389,0.393365,235.517,7.54976,0.336493,183,Salman Butt,0,0,0,0,0,0,0,0,16,4,20,16,4,20,0,239,2,0,1,5.4359,0.384615,42.3846,78.8645,39,4
Pakistan,211,222.621,7.38389,0.393365,235.517,7.54976,0.336493,183,Kamran Akmal,0,0,0,0,0,0,0,0,16,4,20,16,4,20,0,239,2,0,1,3.01124,0.11236,23.0787,81.4433,89,4
India,259,242.378,7.15058,0.339768,244.568,7.12741,0.30888,183,SC Ganguly,0,0,0,0,0,0,0,0,16,5,21,16,5,21,240,242,5,1,1,4.56,0.36,36.8,68.2999,25,4
India,259,242.378,7.15058,0.339768,244.568,7.12741,0.30888,183,SR Tendulkar,0,0,0,0,0,0,0,0,16,5,21,16,5,21,240,242,5,1,1,5.89773,0.363636,45.6023,84.5376,88,4
India,259,242.378,7.15058,0.339768,244.568,7.12741,0.30888,183,G Gambhir,0,0,0,0,0,0,0,0,16,5,21,16,5,21,240,242,5,1,1,3.99145,0.333333,37.4701,84.1944,117,4
India,259,242.378,7.15058,0.339768,244.568,7.12741,0.30888,184,SC Ganguly,0,0,0,0,0,0,0,0,8,9,17,8,9,17,0,321,9,1,1,4.56,0.36,36.8,68.2999,25,4
India,259,242.378,7.15058,0.339768,244.568,7.12741,0.30888,184,G Gambhir,0,0,0,0,0,0,0,0,8,9,17,8,9,17,0,321,9,1,1,3.99145,0.333333,37.4701,84.1944,117,4
India,259,242.378,7.15058,0.339768,244.568,7.12741,0.30888,184,SR Tendulkar,0,0,0,0,0,0,0,0,8,9,17,8,9,17,0,321,9,1,1,5.89773,0.363636,45.6023,84.5376,88,4
Pakistan,211,222.621,7.38389,0.393365,235.517,7.54976,0.336493,184,Salman Butt,0,0,0,0,0,0,0,0,12,9,21,12,9,21,322,322,13,0,1,5.4359,0.384615,42.3846,78.8645,39,4
Pakistan,211,222.621,7.38389,0.393365,235.517,7.54976,0.336493,184,Kamran Akmal,0,0,0,0,0,0,0,0,12,9,21,12,9,21,322,322,13,0,1,3.01124,0.11236,23.0787,81.4433,89,4
India,259,242.378,7.15058,0.339768,244.568,7.12741,0.30888,185,SC Ganguly,0,0,0,0,0,0,0,0,20,7,27,20,7,27,0,294,9,1,1,4.56,0.36,36.8,68.2999,25,4
India,259,242.378,7.15058,0.339768,244.568,7.12741,0.30888,185,SR Tendulkar,0,0,0,0,0,0,0,0,20,7,27,20,7,27,0,294,9,1,1,5.89773,0.363636,45.6023,84.5376,88,4
Pakistan,211,222.621,7.38389,0.393365,235.517,7.54976,0.336493,185,Salman Butt,0,0,0,0,0,0,0,0,28,8,36,28,8,36,295,248,1,0,1,5.4359,0.384615,42.3846,78.8645,39,4
Pakistan,211,222.621,7.38389,0.393365,235.517,7.54976,0.336493,185,Shahid Afridi,0,0,0,0,0,0,0,0,28,8,36,28,8,36,295,248,1,0,1,2.72917,0.0972222,21.4097,127.766,144,0
Pakistan,211,222.621,7.38389,0.393365,235.517,7.54976,0.336493,185,Younis Khan,0,0,0,0,0,0,0,0,28,8,36,28,8,36,295,248,1,0,1,2.64655,0.215517,28.5,73.2713,116,4
Pakistan,211,222.621,7.38389,0.393365,235.517,7.54976,0.336493,186,Salman Butt,0,0,0,0,0,0,0,0,4,13,17,4,13,17,0,255,0,0,1,5.4359,0.384615,42.3846,78.8645,39,4
Pakistan,211,222.621,7.38389,0.393365,235.517,7.54976,0.336493,186,Younis Khan,0,0,0,0,0,0,0,0,4,13,17,4,13,17,0,255,0,0,1,2.64655,0.215517,28.5,73.2713,116,4
Pakistan,211,222.621,7.38389,0.393365,235.517,7.54976,0.336493,186,Shoaib Malik,0,0,0,0,0,0,0,0,4,13,17,4,13,17,0,255,0,0,1,2.77551,0.193878,28.7041,81.4418,98,4
India,259,242.378,7.15058,0.339768,244.568,7.12741,0.30888,186,SC Ganguly,0,0,0,0,0,0,0,0,8,3,11,8,3,11,256,260,5,1,1,4.56,0.36,36.8,68.2999,25,4
India,259,242.378,7.15058,0.339768,244.568,7.12741,0.30888,186,SR Tendulkar,0,0,0,0,0,0,0,0,8,3,11,8,3,11,256,260,5,1,1,5.89773,0.363636,45.6023,84.5376,88,4
India,259,242.378,7.15058,0.339768,244.568,7.12741,0.30888,186,G Gambhir,0,0,0,0,0,0,0,0,8,3,11,8,3,11,256,260,5,1,1,3.99145,0.333333,37.4701,84.1944,117,4
Pakistan,211,222.621,7.38389,0.393365,235.517,7.54976,0.336493,187,Salman Butt,0,0,0,0,0,0,0,0,8,7,15,8,7,15,0,306,3,0,1,5.4359,0.384615,42.3846,78.8645,39,4
Pakistan,211,222.621,7.38389,0.393365,235.517,7.54976,0.336493,187,Imran Nazir,0,0,0,0,0,0,0,0,8,7,15,8,7,15,0,306,3,0,1,4.66667,0.133333,29,96.0265,15,0
India,259,242.378,7.15058,0.339768,244.568,7.12741,0.30888,187,G Gambhir,0,0,0,0,0,0,0,0,16,5,21,16,5,21,307,275,3,1,1,3.99145,0.333333,37.4701,84.1944,117,4
India,259,242.378,7.15058,0.339768,244.568,7.12741,0.30888,187,SR Tendulkar,0,0,0,0,0,0,0,0,16,5,21,16,5,21,307,275,3,1,1,5.89773,0.363636,45.6023,84.5376,88,4
India,259,242.378,7.15058,0.339768,244.568,7.12741,0.30888,187,RV Uthappa,0,0,0,0,0,0,0,0,16,5,21,16,5,21,307,275,3,1,1,3,0.117647,22.1471,89.0071,34,0
New Zealand,184,233.745,7.39674,0.36413,227.951,7.30435,0.353261,188,L Vincent,0,0,0,0,0,0,0,0,6,5,11,6,5,11,0,248,2,0,1,3.125,0.25,27.8125,67.5266,16,4
New Zealand,184,233.745,7.39674,0.36413,227.951,7.30435,0.353261,188,BB McCullum,0,0,0,0,0,0,0,0,6,5,11,6,5,11,0,248,2,0,1,3.98611,0.201389,29.9028,98.4004,144,0
New Zealand,184,233.745,7.39674,0.36413,227.951,7.30435,0.353261,188,JM How,0,0,0,0,0,0,0,0,6,5,11,6,5,11,0,248,2,0,1,3.34615,0.192308,29.9231,64.9416,26,4
South Africa,190,234.274,7.4,0.373684,232.363,7.33158,0.342105,188,MN van Wyk,0,0,0,0,0,0,0,0,4,3,7,4,3,7,249,249,2,1,1,3.33333,0.266667,27.2,66.9951,15,4
South Africa,190,234.274,7.4,0.373684,232.363,7.33158,0.342105,188,JH Kallis,0,0,0,0,0,0,0,0,4,3,7,4,3,7,249,249,2,1,1,3.58621,0.356322,37.2644,76.4442,87,4
South Africa,190,234.274,7.4,0.373684,232.363,7.33158,0.342105,188,GC Smith,0,0,0,0,0,0,0,0,4,3,7,4,3,7,249,249,2,1,1,3.97,0.29,33.57,79.6819,100,4
South Africa,190,234.274,7.4,0.373684,232.363,7.33158,0.342105,189,HH Gibbs,0,0,0,0,0,0,0,0,8,6,14,8,6,14,0,209,0,1,1,4.61538,0.307692,35.6923,83.4157,52,4
South Africa,190,234.274,7.4,0.373684,232.363,7.33158,0.342105,189,JH Kallis,0,0,0,0,0,0,0,0,8,6,14,8,6,14,0,209,0,1,1,3.58621,0.356322,37.2644,76.4442,87,4
South Africa,190,234.274,7.4,0.373684,232.363,7.33158,0.342105,189,GC Smith,0,0,0,0,0,0,0,0,8,6,14,8,6,14,0,209,0,1,1,3.97,0.29,33.57,79.6819,100,4
South Africa,190,234.274,7.4,0.373684,232.363,7.33158,0.342105,189,AB de Villiers,0,0,0,0,0,0,0,0,8,6,14,8,6,14,0,209,0,1,1,5.04969,0.403727,47.2174,98.8428,161,4
New Zealand,184,233.745,7.39674,0.36413,227.951,7.30435,0.353261,189,L Vincent,0,0,0,0,0,0,0,0,8,10,18,8,10,18,210,210,0,0,1,3.125,0.25,27.8125,67.5266,16,4
New Zealand,184,233.745,7.39674,0.36413,227.951,7.30435,0.353261,189,JM How,0,0,0,0,0,0,0,0,8,10,18,8,10,18,210,210,0,0,1,3.34615,0.192308,29.9231,64.9416,26,4
New Zealand,184,233.745,7.39674,0.36413,227.951,7.30435,0.353261,189,BB McCullum,0,0,0,0,0,0,0,0,8,10,18,8,10,18,210,210,0,0,1,3.98611,0.201389,29.9028,98.4004,144,0
West Indies,176,217.33,7.15909,0.3125,225.278,7.57386,0.380682,190,DS Smith,0,0,0,0,0,0,0,0,4,11,15,4,11,15,0,175,6,0,1,2.61765,0.147059,23.5588,71.2,34,4
West Indies,176,217.33,7.15909,0.3125,225.278,7.57386,0.380682,190,BA Parchment,0,0,0,0,0,0,0,0,4,11,15,4,11,15,0,175,6,0,1,2.33333,0,17.8333,54.0404,6,3
South Africa,190,234.274,7.4,0.373684,232.363,7.33158,0.342105,190,GC Smith,0,0,0,0,0,0,0,0,4,3,7,4,3,7,176,176,1,1,1,3.97,0.29,33.57,79.6819,100,4
South Africa,190,234.274,7.4,0.373684,232.363,7.33158,0.342105,190,AB de Villiers,0,0,0,0,0,0,0,0,4,3,7,4,3,7,176,176,1,1,1,5.04969,0.403727,47.2174,98.8428,161,4
South Africa,190,234.274,7.4,0.373684,232.363,7.33158,0.342105,190,JH Kallis,0,0,0,0,0,0,0,0,4,3,7,4,3,7,176,176,1,1,1,3.58621,0.356322,37.2644,76.4442,87,4
South Africa,190,234.274,7.4,0.373684,232.363,7.33158,0.342105,190,JP Duminy,0,0,0,0,0,0,0,0,4,3,7,4,3,7,176,176,1,1,1,2.3252,0.186992,29.9675,80.2351,123,4
South Africa,190,234.274,7.4,0.373684,232.363,7.33158,0.342105,191,GC Smith,0,0,0,0,0,0,0,0,8,6,14,8,6,14,0,255,4,1,1,3.97,0.29,33.57,79.6819,100,4
South Africa,190,234.274,7.4,0.373684,232.363,7.33158,0.342105,191,HH Gibbs,0,0,0,0,0,0,0,0,8,6,14,8,6,14,0,255,4,1,1,4.61538,0.307692,35.6923,83.4157,52,4
South Africa,190,234.274,7.4,0.373684,232.363,7.33158,0.342105,191,JH Kallis,0,0,0,0,0,0,0,0,8,6,14,8,6,14,0,255,4,1,1,3.58621,0.356322,37.2644,76.4442,87,4
West Indies,176,217.33,7.15909,0.3125,225.278,7.57386,0.380682,191,BA Parchment,0,0,0,0,0,0,0,0,4,7,11,4,7,11,256,169,2,0,1,2.33333,0,17.8333,54.0404,6,3
West Indies,176,217.33,7.15909,0.3125,225.278,7.57386,0.380682,191,S Chattergoon,0,0,0,0,0,0,0,0,4,7,11,4,7,11,256,169,2,0,1,4.66667,0.166667,27.8333,60.9489,6,4
West Indies,176,217.33,7.15909,0.3125,225.278,7.57386,0.380682,191,RS Morton,0,0,0,0,0,0,0,0,4,7,11,4,7,11,256,169,2,0,1,2.2963,0.222222,28.8889,67.0103,27,4
West Indies,176,217.33,7.15909,0.3125,225.278,7.57386,0.380682,192,BA Parchment,0,0,0,0,0,0,0,0,12,5,17,12,5,17,0,252,1,0,1,2.33333,0,17.8333,54.0404,6,3
West Indies,176,217.33,7.15909,0.3125,225.278,7.57386,0.380682,192,S Chattergoon,0,0,0,0,0,0,0,0,12,5,17,12,5,17,0,252,1,0,1,4.66667,0.166667,27.8333,60.9489,6,4
South Africa,190,234.274,7.4,0.373684,232.363,7.33158,0.342105,192,HH Gibbs,0,0,0,0,0,0,0,0,12,6,18,12,6,18,253,256,3,1,1,4.61538,0.307692,35.6923,83.4157,52,4
South Africa,190,234.274,7.4,0.373684,232.363,7.33158,0.342105,192,GC Smith,0,0,0,0,0,0,0,0,12,6,18,12,6,18,253,256,3,1,1,3.97,0.29,33.57,79.6819,100,4
West Indies,176,217.33,7.15909,0.3125,225.278,7.57386,0.380682,193,BA Parchment,0,0,0,0,0,0,0,0,8,7,15,8,7,15,0,263,0,0,1,2.33333,0,17.8333,54.0404,6,3
West Indies,176,217.33,7.15909,0.3125,225.278,7.57386,0.380682,193,S Chattergoon,0,0,0,0,0,0,0,0,8,7,15,8,7,15,0,263,0,0,1,4.66667,0.166667,27.8333,60.9489,6,4
South Africa,190,234.274,7.4,0.373684,232.363,7.33158,0.342105,193,GC Smith,0,0,0,0,0,0,0,0,12,4,16,12,4,16,264,266,2,1,1,3.97,0.29,33.57,79.6819,100,4
South Africa,190,234.274,7.4,0.373684,232.363,7.33158,0.342105,193,HH Gibbs,0,0,0,0,0,0,0,0,12,4,16,12,4,16,264,266,2,1,1,4.61538,0.307692,35.6923,83.4157,52,4
West Indies,176,217.33,7.15909,0.3125,225.278,7.57386,0.380682,194,BA Parchment,0,0,0,0,0,0,0,0,12,7,19,12,7,19,0,295,2,0,1,2.33333,0,17.8333,54.0404,6,3
West Indies,176,217.33,7.15909,0.3125,225.278,7.57386,0.380682,194,DS Smith,0,0,0,0,0,0,0,0,12,7,19,12,7,19,0,295,2,0,1,2.61765,0.147059,23.5588,71.2,34,4
West Indies,176,217.33,7.15909,0.3125,225.278,7.57386,0.380682,194,S Chanderpaul,0,0,0,0,0,0,0,0,12,7,19,12,7,19,0,295,2,0,1,3.57143,0.396825,40.8254,68.0783,63,4
South Africa,190,234.274,7.4,0.373684,232.363,7.33158,0.342105,194,HH Gibbs,0,0,0,0,0,0,0,0,12,5,17,12,5,17,296,211,2,1,1,4.61538,0.307692,35.6923,83.4157,52,4
South Africa,190,234.274,7.4,0.373684,232.363,7.33158,0.342105,194,GC Smith,0,0,0,0,0,0,0,0,12,5,17,12,5,17,296,211,2,1,1,3.97,0.29,33.57,79.6819,100,4
South Africa,190,234.274,7.4,0.373684,232.363,7.33158,0.342105,194,JH Kallis,0,0,0,0,0,0,0,0,12,5,17,12,5,17,296,211,2,1,1,3.58621,0.356322,37.2644,76.4442,87,4
South Africa,190,234.274,7.4,0.373684,232.363,7.33158,0.342105,195,HH Gibbs,0,0,0,0,0,0,0,0,4,3,7,4,3,7,0,294,10,0,1,4.61538,0.307692,35.6923,83.4157,52,4
South Africa,190,234.274,7.4,0.373684,232.363,7.33158,0.342105,195,GC Smith,0,0,0,0,0,0,0,0,4,3,7,4,3,7,0,294,10,0,1,3.97,0.29,33.57,79.6819,100,4
Pakistan,211,222.621,7.38389,0.393365,235.517,7.54976,0.336493,195,Mohammad Hafeez,0,0,0,0,0,0,0,0,12,8,20,12,8,20,295,249,0,1,1,4.04511,0.255639,34.3534,78.0625,133,4
Pakistan,211,222.621,7.38389,0.393365,235.517,7.54976,0.336493,195,Imran Nazir,0,0,0,0,0,0,0,0,12,8,20,12,8,20,295,249,0,1,1,4.66667,0.133333,29,96.0265,15,0
Pakistan,211,222.621,7.38389,0.393365,235.517,7.54976,0.336493,195,Younis Khan,0,0,0,0,0,0,0,0,12,8,20,12,8,20,295,249,0,1,1,2.64655,0.215517,28.5,73.2713,116,4
Pakistan,211,222.621,7.38389,0.393365,235.517,7.54976,0.336493,196,Imran Nazir,0,0,0,0,0,0,0,0,0,6,6,0,6,6,0,265,5,1,1,4.66667,0.133333,29,96.0265,15,0
Pakistan,211,222.621,7.38389,0.393365,235.517,7.54976,0.336493,196,Kamran Akmal,0,0,0,0,0,0,0,0,0,6,6,0,6,6,0,265,5,1,1,3.01124,0.11236,23.0787,81.4433,89,4
Pakistan,211,222.621,7.38389,0.393365,235.517,7.54976,0.336493,196,Younis Khan,0,0,0,0,0,0,0,0,0,6,6,0,6,6,0,265,5,1,1,2.64655,0.215517,28.5,73.2713,116,4
South Africa,190,234.274,7.4,0.373684,232.363,7.33158,0.342105,196,GC Smith,0,0,0,0,0,0,0,0,8,11,19,8,11,19,266,240,5,0,1,3.97,0.29,33.57,79.6819,100,4
South Africa,190,234.274,7.4,0.373684,232.363,7.33158,0.342105,196,HH Gibbs,0,0,0,0,0,0,0,0,8,11,19,8,11,19,266,240,5,0,1,4.61538,0.307692,35.6923,83.4157,52,4
South Africa,190,234.274,7.4,0.373684,232.363,7.33158,0.342105,196,JH Kallis,0,0,0,0,0,0,0,0,8,11,19,8,11,19,266,240,5,0,1,3.58621,0.356322,37.2644,76.4442,87,4
South Africa,190,234.274,7.4,0.373684,232.363,7.33158,0.342105,196,AB de Villiers,0,0,0,0,0,0,0,0,8,11,19,8,11,19,266,240,5,0,1,5.04969,0.403727,47.2174,98.8428,161,4
South Africa,190,234.274,7.4,0.373684,232.363,7.33158,0.342105,197,HH Gibbs,0,0,0,0,0,0,0,0,12,1,13,12,1,13,0,197,6,0,1,4.61538,0.307692,35.6923,83.4157,52,4
South Africa,190,234.274,7.4,0.373684,232.363,7.33158,0.342105,197,GC Smith,0,0,0,0,0,0,0,0,12,1,13,12,1,13,0,197,6,0,1,3.97,0.29,33.57,79.6819,100,4
Pakistan,211,222.621,7.38389,0.393365,235.517,7.54976,0.336493,197,Yasir Hameed,0,0,0,0,0,0,0,0,10,8,18,10,8,18,198,202,1,1,1,1.2,0.2,28.2,51.2727,5,3
Pakistan,211,222.621,7.38389,0.393365,235.517,7.54976,0.336493,197,Shahid Afridi,0,0,0,0,0,0,0,0,10,8,18,10,8,18,198,202,1,1,1,2.72917,0.0972222,21.4097,127.766,144,0
Pakistan,211,222.621,7.38389,0.393365,235.517,7.54976,0.336493,198,Yasir Hameed,0,0,0,0,0,0,0,0,0,6,6,0,6,6,0,230,1,1,1,1.2,0.2,28.2,51.2727,5,3
Pakistan,211,222.621,7.38389,0.393365,235.517,7.54976,0.336493,198,Shahid Afridi,0,0,0,0,0,0,0,0,0,6,6,0,6,6,0,230,1,1,1,2.72917,0.0972222,21.4097,127.766,144,0
Pakistan,211,222.621,7.38389,0.393365,235.517,7.54976,0.336493,198,Younis Khan,0,0,0,0,0,0,0,0,0,6,6,0,6,6,0,230,1,1,1,2.64655,0.215517,28.5,73.2713,116,4
South Africa,190,234.274,7.4,0.373684,232.363,7.33158,0.342105,198,GC Smith,0,0,0,0,0,0,0,0,12,16,28,12,16,28,231,233,1,0,1,3.97,0.29,33.57,79.6819,100,4
South Africa,190,234.274,7.4,0.373684,232.363,7.33158,0.342105,198,HH Gibbs,0,0,0,0,0,0,0,0,12,16,28,12,16,28,231,233,1,0,1,4.61538,0.307692,35.6923,83.4157,52,4
Bangladesh,160,218.438,7.70625,0.4,211.106,7.05,0.325,199,Tamim Iqbal,0,0,0,0,0,0,0,0,4,11,15,4,11,15,0,201,0,0,1,4.05344,0.274809,31.8015,76.8068,131,4
Bangladesh,160,218.438,7.70625,0.4,211.106,7.05,0.325,199,Junaid Siddique,0,0,0,0,0,0,0,0,4,11,15,4,11,15,0,201,0,0,1,2.16279,0.116279,20.0233,68.225,43,1
New Zealand,184,233.745,7.39674,0.36413,227.951,7.30435,0.353261,199,JM How,0,0,0,0,0,0,0,0,8,11,19,8,11,19,202,203,1,1,1,3.34615,0.192308,29.9231,64.9416,26,4
New Zealand,184,233.745,7.39674,0.36413,227.951,7.30435,0.353261,199,BB McCullum,0,0,0,0,0,0,0,0,8,11,19,8,11,19,202,203,1,1,1,3.98611,0.201389,29.9028,98.4004,144,0
New Zealand,184,233.745,7.39674,0.36413,227.951,7.30435,0.353261,200,JM How,0,0,0,0,0,0,0,0,8,8,16,8,8,16,0,335,5,1,1,3.34615,0.192308,29.9231,64.9416,26,4
New Zealand,184,233.745,7.39674,0.36413,227.951,7.30435,0.353261,200,BB McCullum,0,0,0,0,0,0,0,0,8,8,16,8,8,16,0,335,5,1,1,3.98611,0.201389,29.9028,98.4004,144,0
Bangladesh,160,218.438,7.70625,0.4,211.106,7.05,0.325,200,Tamim Iqbal,0,0,0,0,0,0,0,0,16,8,24,16,8,24,336,181,1,0,1,4.05344,0.274809,31.8015,76.8068,131,4
Bangladesh,160,218.438,7.70625,0.4,211.106,7.05,0.325,200,Junaid Siddique,0,0,0,0,0,0,0,0,16,8,24,16,8,24,336,181,1,0,1,2.16279,0.116279,20.0233,68.225,43,1
Bangladesh,160,218.438,7.70625,0.4,211.106,7.05,0.325,201,Tamim Iqbal,0,0,0,0,0,0,0,0,4,3,7,4,3,7,0,93,0,0,1,4.05344,0.274809,31.8015,76.8068,131,4
Bangladesh,160,218.438,7.70625,0.4,211.106,7.05,0.325,201,Junaid Siddique,0,0,0,0,0,0,0,0,4,3,7,4,3,7,0,93,0,0,1,2.16279,0.116279,20.0233,68.225,43,1
Bangladesh,160,218.438,7.70625,0.4,211.106,7.05,0.325,201,Mohammad Ashraful,0,0,0,0,0,0,0,0,4,3,7,4,3,7,0,93,0,0,1,2.17722,0.113924,19.4557,63.9085,79,1
New Zealand,184,233.745,7.39674,0.36413,227.951,7.30435,0.353261,201,JM How,0,0,0,0,0,0,0,0,58,12,70,58,12,70,94,95,8,1,1,3.34615,0.192308,29.9231,64.9416,26,4
New Zealand,184,233.745,7.39674,0.36413,227.951,7.30435,0.353261,201,BB McCullum,0,0,0,0,0,0,0,0,58,12,70,58,12,70,94,95,8,1,1,3.98611,0.201389,29.9028,98.4004,144,0
England,221,237.176,7.17647,0.289593,230.633,7.45701,0.384615,202,AN Cook,0,0,0,0,0,0,0,0,0,9,9,0,9,9,0,130,3,0,1,4.17045,0.272727,35.75,75.5524,88,4
England,221,237.176,7.17647,0.289593,230.633,7.45701,0.384615,202,P Mustard,0,0,0,0,0,0,0,0,0,9,9,0,9,9,0,130,3,0,1,3.33333,0.111111,23.8889,88.1148,9,0
New Zealand,184,233.745,7.39674,0.36413,227.951,7.30435,0.353261,202,JD Ryder,0,0,0,0,0,0,0,0,18,3,21,18,3,21,131,131,1,1,1,4.88571,0.257143,34.4,97.2536,35,0
New Zealand,184,233.745,7.39674,0.36413,227.951,7.30435,0.353261,202,BB McCullum,0,0,0,0,0,0,0,0,18,3,21,18,3,21,131,131,1,1,1,3.98611,0.201389,29.9028,98.4004,144,0
England,221,237.176,7.17647,0.289593,230.633,7.45701,0.384615,203,AN Cook,0,0,0,0,0,0,0,0,20,12,32,20,12,32,0,158,1,0,1,4.17045,0.272727,35.75,75.5524,88,4
England,221,237.176,7.17647,0.289593,230.633,7.45701,0.384615,203,P Mustard,0,0,0,0,0,0,0,0,20,12,32,20,12,32,0,158,1,0,1,3.33333,0.111111,23.8889,88.1148,9,0
New Zealand,184,233.745,7.39674,0.36413,227.951,7.30435,0.353261,203,JD Ryder,0,0,0,0,0,0,0,0,26,6,32,26,6,32,159,165,2,1,1,4.88571,0.257143,34.4,97.2536,35,0
New Zealand,184,233.745,7.39674,0.36413,227.951,7.30435,0.353261,203,BB McCullum,0,0,0,0,0,0,0,0,26,6,32,26,6,32,159,165,2,1,1,3.98611,0.201389,29.9028,98.4004,144,0
New Zealand,184,233.745,7.39674,0.36413,227.951,7.30435,0.353261,204,JD Ryder,0,0,0,0,0,0,0,0,14,5,19,14,5,19,0,234,1,1,1,4.88571,0.257143,34.4,97.2536,35,0
New Zealand,184,233.745,7.39674,0.36413,227.951,7.30435,0.353261,204,BB McCullum,0,0,0,0,0,0,0,0,14,5,19,14,5,19,0,234,1,1,1,3.98611,0.201389,29.9028,98.4004,144,0
New Zealand,184,233.745,7.39674,0.36413,227.951,7.30435,0.353261,204,JM How,0,0,0,0,0,0,0,0,14,5,19,14,5,19,0,234,1,1,1,3.34615,0.192308,29.9231,64.9416,26,4
England,221,237.176,7.17647,0.289593,230.633,7.45701,0.384615,204,AN Cook,0,0,0,0,0,0,0,0,22,8,30,22,8,30,235,229,1,0,1,4.17045,0.272727,35.75,75.5524,88,4
England,221,237.176,7.17647,0.289593,230.633,7.45701,0.384615,204,P Mustard,0,0,0,0,0,0,0,0,22,8,30,22,8,30,235,229,1,0,1,3.33333,0.111111,23.8889,88.1148,9,0
England,221,237.176,7.17647,0.289593,230.633,7.45701,0.384615,204,IR Bell,0,0,0,0,0,0,0,0,22,8,30,22,8,30,235,229,1,0,1,3.63433,0.246269,35.3806,75.6623,134,4
England,221,237.176,7.17647,0.289593,230.633,7.45701,0.384615,205,AN Cook,0,0,0,0,0,0,0,0,20,5,25,20,5,25,0,340,1,0,1,4.17045,0.272727,35.75,75.5524,88,4
England,221,237.176,7.17647,0.289593,230.633,7.45701,0.384615,205,P Mustard,0,0,0,0,0,0,0,0,20,5,25,20,5,25,0,340,1,0,1,3.33333,0.111111,23.8889,88.1148,9,0
New Zealand,184,233.745,7.39674,0.36413,227.951,7.30435,0.353261,205,JD Ryder,0,0,0,0,0,0,0,0,18,16,34,18,16,34,341,340,2,1,1,4.88571,0.257143,34.4,97.2536,35,0
New Zealand,184,233.745,7.39674,0.36413,227.951,7.30435,0.353261,205,BB McCullum,0,0,0,0,0,0,0,0,18,16,34,18,16,34,341,340,2,1,1,3.98611,0.201389,29.9028,98.4004,144,0
England,221,237.176,7.17647,0.289593,230.633,7.45701,0.384615,206,AN Cook,0,0,0,0,0,0,0,0,0,8,8,0,8,8,0,242,1,0,1,4.17045,0.272727,35.75,75.5524,88,4
England,221,237.176,7.17647,0.289593,230.633,7.45701,0.384615,206,P Mustard,0,0,0,0,0,0,0,0,0,8,8,0,8,8,0,242,1,0,1,3.33333,0.111111,23.8889,88.1148,9,0
England,221,237.176,7.17647,0.289593,230.633,7.45701,0.384615,206,IR Bell,0,0,0,0,0,0,0,0,0,8,8,0,8,8,0,242,1,0,1,3.63433,0.246269,35.3806,75.6623,134,4
New Zealand,184,233.745,7.39674,0.36413,227.951,7.30435,0.353261,206,JD Ryder,0,0,0,0,0,0,0,0,22,11,33,22,11,33,243,213,3,1,1,4.88571,0.257143,34.4,97.2536,35,0
New Zealand,184,233.745,7.39674,0.36413,227.951,7.30435,0.353261,206,BB McCullum,0,0,0,0,0,0,0,0,22,11,33,22,11,33,243,213,3,1,1,3.98611,0.201389,29.9028,98.4004,144,0
Zimbabwe,142,212.077,7.5,0.380282,227.704,6.97887,0.316901,207,V Sibanda,0,0,0,0,0,0,0,0,12,4,16,12,4,16,0,206,5,1,1,2.9697,0.181818,23.5152,63.5545,66,1
Zimbabwe,142,212.077,7.5,0.380282,227.704,6.97887,0.316901,207,H Masakadza,0,0,0,0,0,0,0,0,12,4,16,12,4,16,0,206,5,1,1,3.11215,0.186916,26.972,70.0485,107,4
South Africa,190,234.274,7.4,0.373684,232.363,7.33158,0.342105,207,GC Smith,0,0,0,0,0,0,0,0,4,7,11,4,7,11,207,210,1,0,1,3.97,0.29,33.57,79.6819,100,4
South Africa,190,234.274,7.4,0.373684,232.363,7.33158,0.342105,207,LE Bosman,0,0,0,0,0,0,0,0,4,7,11,4,7,11,207,210,1,0,1,4.18182,0.181818,27.1818,97.7124,11,0
South Africa,190,234.274,7.4,0.373684,232.363,7.33158,0.342105,207,GH Bodi,0,0,0,0,0,0,0,0,4,7,11,4,7,11,207,210,1,0,1,5,0.5,41.5,61.0294,2,4
South Africa,190,234.274,7.4,0.373684,232.363,7.33158,0.342105,208,GC Smith,0,0,0,0,0,0,0,0,8,9,17,8,9,17,0,323,4,0,1,3.97,0.29,33.57,79.6819,100,4
South Africa,190,234.274,7.4,0.373684,232.363,7.33158,0.342105,208,GH Bodi,0,0,0,0,0,0,0,0,8,9,17,8,9,17,0,323,4,0,1,5,0.5,41.5,61.0294,2,4
Zimbabwe,142,212.077,7.5,0.380282,227.704,6.97887,0.316901,208,V Sibanda,0,0,0,0,0,0,0,0,28,2,30,28,2,30,324,295,0,1,1,2.9697,0.181818,23.5152,63.5545,66,1
Zimbabwe,142,212.077,7.5,0.380282,227.704,6.97887,0.316901,208,H Masakadza,0,0,0,0,0,0,0,0,28,2,30,28,2,30,324,295,0,1,1,3.11215,0.186916,26.972,70.0485,107,4
Zimbabwe,142,212.077,7.5,0.380282,227.704,6.97887,0.316901,212,V Sibanda,0,0,0,0,0,0,0,0,8,7,15,8,7,15,0,274,2,1,1,2.9697,0.181818,23.5152,63.5545,66,1
Zimbabwe,142,212.077,7.5,0.380282,227.704,6.97887,0.316901,212,BRM Taylor,0,0,0,0,0,0,0,0,8,7,15,8,7,15,0,274,2,1,1,3.3,0.26,33.56,76.3421,100,4
West Indies,176,217.33,7.15909,0.3125,225.278,7.57386,0.380682,212,CH Gayle,0,0,0,0,0,0,0,0,4,7,11,4,7,11,275,244,1,0,1,4.58621,0.206897,31.1293,89.4255,116,4
West Indies,176,217.33,7.15909,0.3125,225.278,7.57386,0.380682,212,DS Smith,0,0,0,0,0,0,0,0,4,7,11,4,7,11,275,244,1,0,1,2.61765,0.147059,23.5588,71.2,34,4
West Indies,176,217.33,7.15909,0.3125,225.278,7.57386,0.380682,212,S Chanderpaul,0,0,0,0,0,0,0,0,4,7,11,4,7,11,275,244,1,0,1,3.57143,0.396825,40.8254,68.0783,63,4
West Indies,176,217.33,7.15909,0.3125,225.278,7.57386,0.380682,213,CH Gayle,0,0,0,0,0,0,0,0,0,8,8,0,8,8,0,286,0,0,1,4.58621,0.206897,31.1293,89.4255,116,4
West Indies,176,217.33,7.15909,0.3125,225.278,7.57386,0.380682,213,DS Smith,0,0,0,0,0,0,0,0,0,8,8,0,8,8,0,286,0,0,1,2.61765,0.147059,23.5588,71.2,34,4
West Indies,176,217.33,7.15909,0.3125,225.278,7.57386,0.380682,213,RS Morton,0,0,0,0,0,0,0,0,0,8,8,0,8,8,0,286,0,0,1,2.2963,0.222222,28.8889,67.0103,27,4
Zimbabwe,142,212.077,7.5,0.380282,227.704,6.97887,0.316901,213,V Sibanda,0,0,0,0,0,0,0,0,4,4,8,4,4,8,287,176,5,1,1,2.9697,0.181818,23.5152,63.5545,66,1
Zimbabwe,142,212.077,7.5,0.380282,227.704,6.97887,0.316901,213,BRM Taylor,0,0,0,0,0,0,0,0,4,4,8,4,4,8,287,176,5,1,1,3.3,0.26,33.56,76.3421,100,4
Zimbabwe,142,212.077,7.5,0.380282,227.704,6.97887,0.316901,214,V Sibanda,0,0,0,0,0,0,0,0,0,7,7,0,7,7,0,232,3,1,1,2.9697,0.181818,23.5152,63.5545,66,1
Zimbabwe,142,212.077,7.5,0.380282,227.704,6.97887,0.316901,214,H Masakadza,0,0,0,0,0,0,0,0,0,7,7,0,7,7,0,232,3,1,1,3.11215,0.186916,26.972,70.0485,107,4
West Indies,176,217.33,7.15909,0.3125,225.278,7.57386,0.380682,214,DS Smith,0,0,0,0,0,0,0,0,4,9,13,4,9,13,233,234,3,0,1,2.61765,0.147059,23.5588,71.2,34,4
West Indies,176,217.33,7.15909,0.3125,225.278,7.57386,0.380682,214,RS Morton,0,0,0,0,0,0,0,0,4,9,13,4,9,13,233,234,3,0,1,2.2963,0.222222,28.8889,67.0103,27,4
West Indies,176,217.33,7.15909,0.3125,225.278,7.57386,0.380682,214,BA Parchment,0,0,0,0,0,0,0,0,4,9,13,4,9,13,233,234,3,0,1,2.33333,0,17.8333,54.0404,6,3
Sri Lanka,244,223.373,7.09016,0.344262,227.578,7.47541,0.385246,215,WU Tharanga,0,0,0,0,0,0,0,0,8,4,12,8,4,12,0,235,1,0,1,3.93985,0.263158,32.9699,71.6035,133,4
Sri Lanka,244,223.373,7.09016,0.344262,227.578,7.47541,0.385246,215,ML Udawatte,0,0,0,0,0,0,0,0,8,4,12,8,4,12,0,235,1,0,1,2.33333,0,17.1667,62.0482,6,1
Sri Lanka,244,223.373,7.09016,0.344262,227.578,7.47541,0.385246,215,KC Sangakkara,0,0,0,0,0,0,0,0,8,4,12,8,4,12,0,235,1,0,1,4.33659,0.360976,41.9854,80.6276,205,4
West Indies,176,217.33,7.15909,0.3125,225.278,7.57386,0.380682,215,CH Gayle,0,0,0,0,0,0,0,0,8,6,14,8,6,14,236,236,0,1,1,4.58621,0.206897,31.1293,89.4255,116,4
West Indies,176,217.33,7.15909,0.3125,225.278,7.57386,0.380682,215,DS Smith,0,0,0,0,0,0,0,0,8,6,14,8,6,14,236,236,0,1,1,2.61765,0.147059,23.5588,71.2,34,4
Sri Lanka,244,223.373,7.09016,0.344262,227.578,7.47541,0.385246,216,WU Tharanga,0,0,0,0,0,0,0,0,12,6,18,12,6,18,0,112,4,0,1,3.93985,0.263158,32.9699,71.6035,133,4
Sri Lanka,244,223.373,7.09016,0.344262,227.578,7.47541,0.385246,216,ML Udawatte,0,0,0,0,0,0,0,0,12,6,18,12,6,18,0,112,4,0,1,2.33333,0,17.1667,62.0482,6,1
West Indies,176,217.33,7.15909,0.3125,225.278,7.57386,0.380682,216,CH Gayle,0,0,0,0,0,0,0,0,4,10,14,4,10,14,113,125,1,1,1,4.58621,0.206897,31.1293,89.4255,116,4
West Indies,176,217.33,7.15909,0.3125,225.278,7.57386,0.380682,216,DJ Bravo,0,0,0,0,0,0,0,0,4,10,14,4,10,14,113,125,1,1,1,2.35514,0.11215,23.1589,80.9011,107,4
West Indies,176,217.33,7.15909,0.3125,225.278,7.57386,0.380682,216,RR Sarwan,0,0,0,0,0,0,0,0,4,10,14,4,10,14,113,125,1,1,1,2.8254,0.222222,29.1429,69.1005,63,4
Australia,228,239.627,7.69737,0.372807,232.079,7.23246,0.337719,217,SE Marsh,0,0,0,0,0,0,0,0,8,11,19,8,11,19,0,213,0,0,1,3.66667,0.291667,35.5417,74.7918,48,4
Australia,228,239.627,7.69737,0.372807,232.079,7.23246,0.337719,217,SR Watson,0,0,0,0,0,0,0,0,8,11,19,8,11,19,0,213,0,0,1,4.71318,0.286822,37.7907,90.0943,129,4
Australia,228,239.627,7.69737,0.372807,232.079,7.23246,0.337719,217,RT Ponting,0,0,0,0,0,0,0,0,8,11,19,8,11,19,0,213,0,0,1,4.17431,0.33945,38.1009,80.8606,109,4
West Indies,176,217.33,7.15909,0.3125,225.278,7.57386,0.380682,217,XM Marshall,0,0,0,0,0,0,0,0,4,2,6,4,2,6,214,140,2,1,1,1.5,0,10.5,58.3333,8,3
West Indies,176,217.33,7.15909,0.3125,225.278,7.57386,0.380682,217,ADS Fletcher,0,0,0,0,0,0,0,0,4,2,6,4,2,6,214,140,2,1,1,1.8125,0.125,13.5,62.6087,16,1
West Indies,176,217.33,7.15909,0.3125,225.278,7.57386,0.380682,217,CH Gayle,0,0,0,0,0,0,0,0,4,2,6,4,2,6,214,140,2,1,1,4.58621,0.206897,31.1293,89.4255,116,4
West Indies,176,217.33,7.15909,0.3125,225.278,7.57386,0.380682,218,CH Gayle,0,0,0,0,0,0,0,0,4,5,9,4,5,9,0,223,2,1,1,4.58621,0.206897,31.1293,89.4255,116,4
West Indies,176,217.33,7.15909,0.3125,225.278,7.57386,0.380682,218,XM Marshall,0,0,0,0,0,0,0,0,4,5,9,4,5,9,0,223,2,1,1,1.5,0,10.5,58.3333,8,3
Australia,228,239.627,7.69737,0.372807,232.079,7.23246,0.337719,218,SE Marsh,0,0,0,0,0,0,0,0,8,8,16,8,8,16,224,227,2,0,1,3.66667,0.291667,35.5417,74.7918,48,4
Australia,228,239.627,7.69737,0.372807,232.079,7.23246,0.337719,218,RT Ponting,0,0,0,0,0,0,0,0,8,8,16,8,8,16,224,227,2,0,1,4.17431,0.33945,38.1009,80.8606,109,4
Australia,228,239.627,7.69737,0.372807,232.079,7.23246,0.337719,218,SR Watson,0,0,0,0,0,0,0,0,8,8,16,8,8,16,224,227,2,0,1,4.71318,0.286822,37.7907,90.0943,129,4
Australia,228,239.627,7.69737,0.372807,232.079,7.23246,0.337719,219,SE Marsh,0,0,0,0,0,0,0,0,20,6,26,20,6,26,0,282,5,0,1,3.66667,0.291667,35.5417,74.7918,48,4
Australia,228,239.627,7.69737,0.372807,232.079,7.23246,0.337719,219,SR Watson,0,0,0,0,0,0,0,0,20,6,26,20,6,26,0,282,5,0,1,4.71318,0.286822,37.7907,90.0943,129,4
West Indies,176,217.33,7.15909,0.3125,225.278,7.57386,0.380682,219,CH Gayle,0,0,0,0,0,0,0,0,20,7,27,20,7,27,283,281,2,1,1,4.58621,0.206897,31.1293,89.4255,116,4
West Indies,176,217.33,7.15909,0.3125,225.278,7.57386,0.380682,219,XM Marshall,0,0,0,0,0,0,0,0,20,7,27,20,7,27,283,281,2,1,1,1.5,0,10.5,58.3333,8,3
West Indies,176,217.33,7.15909,0.3125,225.278,7.57386,0.380682,219,RR Sarwan,0,0,0,0,0,0,0,0,20,7,27,20,7,27,283,281,2,1,1,2.8254,0.222222,29.1429,69.1005,63,4
Australia,228,239.627,7.69737,0.372807,232.079,7.23246,0.337719,220,SE Marsh,0,0,0,0,0,0,0,0,28,8,36,28,8,36,0,341,1,0,1,3.66667,0.291667,35.5417,74.7918,48,4
Australia,228,239.627,7.69737,0.372807,232.079,7.23246,0.337719,220,SR Watson,0,0,0,0,0,0,0,0,28,8,36,28,8,36,0,341,1,0,1,4.71318,0.286822,37.7907,90.0943,129,4
West Indies,176,217.33,7.15909,0.3125,225.278,7.57386,0.380682,220,CH Gayle,0,0,0,0,0,0,0,0,12,7,19,12,7,19,342,172,2,1,1,4.58621,0.206897,31.1293,89.4255,116,4
West Indies,176,217.33,7.15909,0.3125,225.278,7.57386,0.380682,220,XM Marshall,0,0,0,0,0,0,0,0,12,7,19,12,7,19,342,172,2,1,1,1.5,0,10.5,58.3333,8,3
West Indies,176,217.33,7.15909,0.3125,225.278,7.57386,0.380682,220,RR Sarwan,0,0,0,0,0,0,0,0,12,7,19,12,7,19,342,172,2,1,1,2.8254,0.222222,29.1429,69.1005,63,4
Bangladesh,160,218.438,7.70625,0.4,211.106,7.05,0.325,221,Tamim Iqbal,0,0,0,0,0,0,0,0,12,8,20,12,8,20,0,178,1,1,1,4.05344,0.274809,31.8015,76.8068,131,4
Bangladesh,160,218.438,7.70625,0.4,211.106,7.05,0.325,221,Junaid Siddique,0,0,0,0,0,0,0,0,12,8,20,12,8,20,0,178,1,1,1,2.16279,0.116279,20.0233,68.225,43,1
South Africa,190,234.274,7.4,0.373684,232.363,7.33158,0.342105,221,HH Gibbs,0,0,0,0,0,0,0,0,8,6,14,8,6,14,179,180,2,0,1,4.61538,0.307692,35.6923,83.4157,52,4
South Africa,190,234.274,7.4,0.373684,232.363,7.33158,0.342105,221,GC Smith,0,0,0,0,0,0,0,0,8,6,14,8,6,14,179,180,2,0,1,3.97,0.29,33.57,79.6819,100,4
Bangladesh,160,218.438,7.70625,0.4,211.106,7.05,0.325,222,Tamim Iqbal,0,0,0,0,0,0,0,0,12,3,15,12,3,15,0,173,2,1,1,4.05344,0.274809,31.8015,76.8068,131,4
Bangladesh,160,218.438,7.70625,0.4,211.106,7.05,0.325,222,Mohammad Ashraful,0,0,0,0,0,0,0,0,12,3,15,12,3,15,0,173,2,1,1,2.17722,0.113924,19.4557,63.9085,79,1
Bangladesh,160,218.438,7.70625,0.4,211.106,7.05,0.325,222,Shahriar Nafees,0,0,0,0,0,0,0,0,12,3,15,12,3,15,0,173,2,1,1,3.40541,0.162162,24.4865,69.1076,37,4
Bangladesh,160,218.438,7.70625,0.4,211.106,7.05,0.325,222,Nazimuddin,0,0,0,0,0,0,0,0,12,3,15,12,3,15,0,173,2,1,1,2,0,14.5,62.2318,10,1
South Africa,190,234.274,7.4,0.373684,232.363,7.33158,0.342105,222,GC Smith,0,0,0,0,0,0,0,0,4,9,13,4,9,13,174,179,1,0,1,3.97,0.29,33.57,79.6819,100,4
South Africa,190,234.274,7.4,0.373684,232.363,7.33158,0.342105,222,HH Gibbs,0,0,0,0,0,0,0,0,4,9,13,4,9,13,174,179,1,0,1,4.61538,0.307692,35.6923,83.4157,52,4
South Africa,190,234.274,7.4,0.373684,232.363,7.33158,0.342105,222,HM Amla,0,0,0,0,0,0,0,0,4,9,13,4,9,13,174,179,1,0,1,5.20168,0.403361,48.7899,86.9292,119,4
Bangladesh,160,218.438,7.70625,0.4,211.106,7.05,0.325,223,Tamim Iqbal,0,0,0,0,0,0,0,0,4,4,8,4,4,8,0,143,3,1,1,4.05344,0.274809,31.8015,76.8068,131,4
Bangladesh,160,218.438,7.70625,0.4,211.106,7.05,0.325,223,Shahriar Nafees,0,0,0,0,0,0,0,0,4,4,8,4,4,8,0,143,3,1,1,3.40541,0.162162,24.4865,69.1076,37,4
South Africa,190,234.274,7.4,0.373684,232.363,7.33158,0.342105,223,HH Gibbs,0,0,0,0,0,0,0,0,8,10,18,8,10,18,144,147,0,0,1,4.61538,0.307692,35.6923,83.4157,52,4
South Africa,190,234.274,7.4,0.373684,232.363,7.33158,0.342105,223,GC Smith,0,0,0,0,0,0,0,0,8,10,18,8,10,18,144,147,0,0,1,3.97,0.29,33.57,79.6819,100,4
Zimbabwe,142,212.077,7.5,0.380282,227.704,6.97887,0.316901,226,H Masakadza,0,0,0,0,0,0,0,0,38,2,40,38,2,40,0,303,3,0,1,3.11215,0.186916,26.972,70.0485,107,4
Zimbabwe,142,212.077,7.5,0.380282,227.704,6.97887,0.316901,226,C Zhuwao,0,0,0,0,0,0,0,0,38,2,40,38,2,40,0,303,3,0,1,3,0,16,72.7273,1,1
Ireland,55,219.527,7.65455,0.290909,202.727,7.56364,0.4,226,WTS Porterfield,0,0,0,0,0,0,0,0,8,4,12,8,4,12,304,147,4,0,1,2.6,0.142857,24.6857,56.2866,35,3
Ireland,55,219.527,7.65455,0.290909,202.727,7.56364,0.4,226,NJ O'Brien,0,0,0,0,0,0,0,0,8,4,12,8,4,12,304,147,4,0,1,2.55882,0.176471,25.5882,69.378,34,4
Ireland,55,219.527,7.65455,0.290909,202.727,7.56364,0.4,226,GC Wilson,0,0,0,0,0,0,0,0,8,4,12,8,4,12,304,147,4,0,1,2.22727,0.227273,22,78.1906,22,4
Ireland,55,219.527,7.65455,0.290909,202.727,7.56364,0.4,226,AC Botha,0,0,0,0,0,0,0,0,8,4,12,8,4,12,304,147,4,0,1,1.25,0.0833333,14.3333,53.75,12,3
Pakistan,211,222.621,7.38389,0.393365,235.517,7.54976,0.336493,227,Salman Butt,0,0,0,0,0,0,0,0,16,11,27,16,11,27,0,347,0,0,1,5.4359,0.384615,42.3846,78.8645,39,4
Pakistan,211,222.621,7.38389,0.393365,235.517,7.54976,0.336493,227,Nasir Jamshed,0,0,0,0,0,0,0,0,16,11,27,16,11,27,0,347,0,0,1,3.63043,0.23913,30.2174,73.8184,46,4
Zimbabwe,142,212.077,7.5,0.380282,227.704,6.97887,0.316901,227,V Sibanda,0,0,0,0,0,0,0,0,8,10,18,8,10,18,348,243,7,0,1,2.9697,0.181818,23.5152,63.5545,66,1
Zimbabwe,142,212.077,7.5,0.380282,227.704,6.97887,0.316901,227,H Masakadza,0,0,0,0,0,0,0,0,8,10,18,8,10,18,348,243,7,0,1,3.11215,0.186916,26.972,70.0485,107,4
Zimbabwe,142,212.077,7.5,0.380282,227.704,6.97887,0.316901,228,V Sibanda,0,0,0,0,0,0,0,0,4,12,16,4,12,16,0,238,0,0,1,2.9697,0.181818,23.5152,63.5545,66,1
Zimbabwe,142,212.077,7.5,0.380282,227.704,6.97887,0.316901,228,H Masakadza,0,0,0,0,0,0,0,0,4,12,16,4,12,16,0,238,0,0,1,3.11215,0.186916,26.972,70.0485,107,4
Zimbabwe,142,212.077,7.5,0.380282,227.704,6.97887,0.316901,228,CJ Chibhabha,0,0,0,0,0,0,0,0,4,12,16,4,12,16,0,238,0,0,1,2.56716,0.149254,23.5373,64.7373,67,1
Pakistan,211,222.621,7.38389,0.393365,235.517,7.54976,0.336493,228,Salman Butt,0,0,0,0,0,0,0,0,20,13,33,20,13,33,239,239,0,0,1,5.4359,0.384615,42.3846,78.8645,39,4
Pakistan,211,222.621,7.38389,0.393365,235.517,7.54976,0.336493,228,Nasir Jamshed,0,0,0,0,0,0,0,0,20,13,33,20,13,33,239,239,0,0,1,3.63043,0.23913,30.2174,73.8184,46,4
Pakistan,211,222.621,7.38389,0.393365,235.517,7.54976,0.336493,229,Salman Butt,0,0,0,0,0,0,0,0,4,2,6,4,2,6,0,272,2,1,1,5.4359,0.384615,42.3846,78.8645,39,4
Pakistan,211,222.621,7.38389,0.393365,235.517,7.54976,0.336493,229,Nasir Jamshed,0,0,0,0,0,0,0,0,4,2,6,4,2,6,0,272,2,1,1,3.63043,0.23913,30.2174,73.8184,46,4
Zimbabwe,142,212.077,7.5,0.380282,227.704,6.97887,0.316901,229,V Sibanda,0,0,0,0,0,0,0,0,0,10,10,0,10,10,273,235,3,0,1,2.9697,0.181818,23.5152,63.5545,66,1
Zimbabwe,142,212.077,7.5,0.380282,227.704,6.97887,0.316901,229,H Masakadza,0,0,0,0,0,0,0,0,0,10,10,0,10,10,273,235,3,0,1,3.11215,0.186916,26.972,70.0485,107,4
Zimbabwe,142,212.077,7.5,0.380282,227.704,6.97887,0.316901,229,SC Williams,0,0,0,0,0,0,0,0,0,10,10,0,10,10,273,235,3,0,1,2.56923,0.276923,28.5385,80.7927,65,4
Zimbabwe,142,212.077,7.5,0.380282,227.704,6.97887,0.316901,230,V Sibanda,0,0,0,0,0,0,0,0,0,6,6,0,6,6,0,244,6,0,1,2.9697,0.181818,23.5152,63.5545,66,1
Zimbabwe,142,212.077,7.5,0.380282,227.704,6.97887,0.316901,230,H Masakadza,0,0,0,0,0,0,0,0,0,6,6,0,6,6,0,244,6,0,1,3.11215,0.186916,26.972,70.0485,107,4
Zimbabwe,142,212.077,7.5,0.380282,227.704,6.97887,0.316901,230,SC Williams,0,0,0,0,0,0,0,0,0,6,6,0,6,6,0,244,6,0,1,2.56923,0.276923,28.5385,80.7927,65,4
Pakistan,211,222.621,7.38389,0.393365,235.517,7.54976,0.336493,230,Nasir Jamshed,0,0,0,0,0,0,0,0,16,5,21,16,5,21,245,245,1,1,1,3.63043,0.23913,30.2174,73.8184,46,4
Pakistan,211,222.621,7.38389,0.393365,235.517,7.54976,0.336493,230,Khalid Latif,0,0,0,0,0,0,0,0,16,5,21,16,5,21,245,245,1,1,1,2.6,0.2,29.4,63.0901,5,4
Pakistan,211,222.621,7.38389,0.393365,235.517,7.54976,0.336493,230,Shoaib Malik,0,0,0,0,0,0,0,0,16,5,21,16,5,21,245,245,1,1,1,2.77551,0.193878,28.7041,81.4418,98,4
Zimbabwe,142,212.077,7.5,0.380282,227.704,6.97887,0.316901,231,V Sibanda,0,0,0,0,0,0,0,0,4,12,16,4,12,16,0,181,7,0,1,2.9697,0.181818,23.5152,63.5545,66,1
Zimbabwe,142,212.077,7.5,0.380282,227.704,6.97887,0.316901,231,H Masakadza,0,0,0,0,0,0,0,0,4,12,16,4,12,16,0,181,7,0,1,3.11215,0.186916,26.972,70.0485,107,4
Pakistan,211,222.621,7.38389,0.393365,235.517,7.54976,0.336493,231,Nasir Jamshed,0,0,0,0,0,0,0,0,12,11,23,12,11,23,182,187,2,1,1,3.63043,0.23913,30.2174,73.8184,46,4
Pakistan,211,222.621,7.38389,0.393365,235.517,7.54976,0.336493,231,Khurram Manzoor,0,0,0,0,0,0,0,0,12,11,23,12,11,23,182,187,2,1,1,3.33333,0.5,33.6667,62.5387,6,4
Sri Lanka,244,223.373,7.09016,0.344262,227.578,7.47541,0.385246,234,ST Jayasuriya,0,0,0,0,0,0,0,0,16,13,29,16,13,29,0,357,2,0,1,4.91549,0.211268,33.9859,98.4898,71,0
Sri Lanka,244,223.373,7.09016,0.344262,227.578,7.47541,0.385246,234,KC Sangakkara,0,0,0,0,0,0,0,0,16,13,29,16,13,29,0,357,2,0,1,4.33659,0.360976,41.9854,80.6276,205,4
Bangladesh,160,218.438,7.70625,0.4,211.106,7.05,0.325,234,Tamim Iqbal,0,0,0,0,0,0,0,0,8,7,15,8,7,15,358,226,0,0,1,4.05344,0.274809,31.8015,76.8068,131,4
Bangladesh,160,218.438,7.70625,0.4,211.106,7.05,0.325,234,Nazimuddin,0,0,0,0,0,0,0,0,8,7,15,8,7,15,358,226,0,0,1,2,0,14.5,62.2318,10,1
Bangladesh,160,218.438,7.70625,0.4,211.106,7.05,0.325,234,Mohammad Ashraful,0,0,0,0,0,0,0,0,8,7,15,8,7,15,358,226,0,0,1,2.17722,0.113924,19.4557,63.9085,79,1
Pakistan,211,222.621,7.38389,0.393365,235.517,7.54976,0.336493,236,Salman Butt,0,0,0,0,0,0,0,0,8,5,13,8,5,13,0,299,0,0,1,5.4359,0.384615,42.3846,78.8645,39,4
Pakistan,211,222.621,7.38389,0.393365,235.517,7.54976,0.336493,236,Shoaib Malik,0,0,0,0,0,0,0,0,8,5,13,8,5,13,0,299,0,0,1,2.77551,0.193878,28.7041,81.4418,98,4
India,259,242.378,7.15058,0.339768,244.568,7.12741,0.30888,236,G Gambhir,0,0,0,0,0,0,0,0,16,7,23,16,7,23,300,301,3,0,1,3.99145,0.333333,37.4701,84.1944,117,4
India,259,242.378,7.15058,0.339768,244.568,7.12741,0.30888,236,V Sehwag,0,0,0,0,0,0,0,0,16,7,23,16,7,23,300,301,3,0,1,5.88636,0.238636,38.8295,108.649,88,0
India,259,242.378,7.15058,0.339768,244.568,7.12741,0.30888,236,SK Raina,0,0,0,0,0,0,0,0,16,7,23,16,7,23,300,301,3,0,1,3.11111,0.216374,28.9064,91.8944,171,0
Bangladesh,160,218.438,7.70625,0.4,211.106,7.05,0.325,237,Tamim Iqbal,0,0,0,0,0,0,0,0,8,11,19,8,11,19,0,283,0,0,1,4.05344,0.274809,31.8015,76.8068,131,4
Bangladesh,160,218.438,7.70625,0.4,211.106,7.05,0.325,237,Nazimuddin,0,0,0,0,0,0,0,0,8,11,19,8,11,19,0,283,0,0,1,2,0,14.5,62.2318,10,1
India,259,242.378,7.15058,0.339768,244.568,7.12741,0.30888,237,G Gambhir,0,0,0,0,0,0,0,0,12,12,24,12,12,24,284,284,2,0,1,3.99145,0.333333,37.4701,84.1944,117,4
India,259,242.378,7.15058,0.339768,244.568,7.12741,0.30888,237,RV Uthappa,0,0,0,0,0,0,0,0,12,12,24,12,12,24,284,284,2,0,1,3,0.117647,22.1471,89.0071,34,0
India,259,242.378,7.15058,0.339768,244.568,7.12741,0.30888,237,RG Sharma,0,0,0,0,0,0,0,0,12,12,24,12,12,24,284,284,2,0,1,3.82836,0.268657,35.9179,83.083,134,4
Sri Lanka,244,223.373,7.09016,0.344262,227.578,7.47541,0.385246,238,ST Jayasuriya,0,0,0,0,0,0,0,0,12,9,21,12,9,21,0,302,4,0,1,4.91549,0.211268,33.9859,98.4898,71,0
Sri Lanka,244,223.373,7.09016,0.344262,227.578,7.47541,0.385246,238,KC Sangakkara,0,0,0,0,0,0,0,0,12,9,21,12,9,21,0,302,4,0,1,4.33659,0.360976,41.9854,80.6276,205,4
Sri Lanka,244,223.373,7.09016,0.344262,227.578,7.47541,0.385246,238,DPMD Jayawardene,0,0,0,0,0,0,0,0,12,9,21,12,9,21,0,302,4,0,1,3.20833,0.244792,31.6979,79.1109,192,4
Pakistan,211,222.621,7.38389,0.393365,235.517,7.54976,0.336493,238,Salman Butt,0,0,0,0,0,0,0,0,20,9,29,20,9,29,303,238,0,0,1,5.4359,0.384615,42.3846,78.8645,39,4
Pakistan,211,222.621,7.38389,0.393365,235.517,7.54976,0.336493,238,Younis Khan,0,0,0,0,0,0,0,0,20,9,29,20,9,29,303,238,0,0,1,2.64655,0.215517,28.5,73.2713,116,4
Pakistan,211,222.621,7.38389,0.393365,235.517,7.54976,0.336493,238,Shoaib Malik,0,0,0,0,0,0,0,0,20,9,29,20,9,29,303,238,0,0,1,2.77551,0.193878,28.7041,81.4418,98,4
Sri Lanka,244,223.373,7.09016,0.344262,227.578,7.47541,0.385246,239,ST Jayasuriya,0,0,0,0,0,0,0,0,12,5,17,12,5,17,0,332,3,0,1,4.91549,0.211268,33.9859,98.4898,71,0
Sri Lanka,244,223.373,7.09016,0.344262,227.578,7.47541,0.385246,239,KC Sangakkara,0,0,0,0,0,0,0,0,12,5,17,12,5,17,0,332,3,0,1,4.33659,0.360976,41.9854,80.6276,205,4
Bangladesh,160,218.438,7.70625,0.4,211.106,7.05,0.325,239,Tamim Iqbal,0,0,0,0,0,0,0,0,4,6,10,4,6,10,333,174,0,0,1,4.05344,0.274809,31.8015,76.8068,131,4
Bangladesh,160,218.438,7.70625,0.4,211.106,7.05,0.325,239,Nazimuddin,0,0,0,0,0,0,0,0,4,6,10,4,6,10,333,174,0,0,1,2,0,14.5,62.2318,10,1
Bangladesh,160,218.438,7.70625,0.4,211.106,7.05,0.325,239,Mohammad Ashraful,0,0,0,0,0,0,0,0,4,6,10,4,6,10,333,174,0,0,1,2.17722,0.113924,19.4557,63.9085,79,1
India,259,242.378,7.15058,0.339768,244.568,7.12741,0.30888,240,G Gambhir,0,0,0,0,0,0,0,0,22,12,34,22,12,34,0,308,5,0,1,3.99145,0.333333,37.4701,84.1944,117,4
India,259,242.378,7.15058,0.339768,244.568,7.12741,0.30888,240,V Sehwag,0,0,0,0,0,0,0,0,22,12,34,22,12,34,0,308,5,0,1,5.88636,0.238636,38.8295,108.649,88,0
Pakistan,211,222.621,7.38389,0.393365,235.517,7.54976,0.336493,240,Salman Butt,0,0,0,0,0,0,0,0,24,11,35,24,11,35,309,309,0,0,1,5.4359,0.384615,42.3846,78.8645,39,4
Pakistan,211,222.621,7.38389,0.393365,235.517,7.54976,0.336493,240,Nasir Jamshed,0,0,0,0,0,0,0,0,24,11,35,24,11,35,309,309,0,0,1,3.63043,0.23913,30.2174,73.8184,46,4
Sri Lanka,244,223.373,7.09016,0.344262,227.578,7.47541,0.385246,241,ST Jayasuriya,0,0,0,0,0,0,0,0,4,9,13,4,9,13,0,308,6,0,1,4.91549,0.211268,33.9859,98.4898,71,0
Sri Lanka,244,223.373,7.09016,0.344262,227.578,7.47541,0.385246,241,KC Sangakkara,0,0,0,0,0,0,0,0,4,9,13,4,9,13,0,308,6,0,1,4.33659,0.360976,41.9854,80.6276,205,4
Sri Lanka,244,223.373,7.09016,0.344262,227.578,7.47541,0.385246,241,DPMD Jayawardene,0,0,0,0,0,0,0,0,4,9,13,4,9,13,0,308,6,0,1,3.20833,0.244792,31.6979,79.1109,192,4
India,259,242.378,7.15058,0.339768,244.568,7.12741,0.30888,241,G Gambhir,0,0,0,0,0,0,0,0,24,12,36,24,12,36,309,310,4,0,1,3.99145,0.333333,37.4701,84.1944,117,4
India,259,242.378,7.15058,0.339768,244.568,7.12741,0.30888,241,V Sehwag,0,0,0,0,0,0,0,0,24,12,36,24,12,36,309,310,4,0,1,5.88636,0.238636,38.8295,108.649,88,0
Bangladesh,160,218.438,7.70625,0.4,211.106,7.05,0.325,242,Tamim Iqbal,0,0,0,0,0,0,0,0,4,17,21,4,17,21,0,115,2,0,1,4.05344,0.274809,31.8015,76.8068,131,4
Bangladesh,160,218.438,7.70625,0.4,211.106,7.05,0.325,242,Nazimuddin,0,0,0,0,0,0,0,0,4,17,21,4,17,21,0,115,2,0,1,2,0,14.5,62.2318,10,1
Bangladesh,160,218.438,7.70625,0.4,211.106,7.05,0.325,242,Mohammad Ashraful,0,0,0,0,0,0,0,0,4,17,21,4,17,21,0,115,2,0,1,2.17722,0.113924,19.4557,63.9085,79,1
Pakistan,211,222.621,7.38389,0.393365,235.517,7.54976,0.336493,242,Salman Butt,0,0,0,0,0,0,0,0,14,8,22,14,8,22,116,116,1,0,1,5.4359,0.384615,42.3846,78.8645,39,4
Pakistan,211,222.621,7.38389,0.393365,235.517,7.54976,0.336493,242,Nasir Jamshed,0,0,0,0,0,0,0,0,14,8,22,14,8,22,116,116,1,0,1,3.63043,0.23913,30.2174,73.8184,46,4
Sri Lanka,244,223.373,7.09016,0.344262,227.578,7.47541,0.385246,243,ST Jayasuriya,0,0,0,0,0,0,0,0,16,7,23,16,7,23,0,273,0,0,1,4.91549,0.211268,33.9859,98.4898,71,0
Sri Lanka,244,223.373,7.09016,0.344262,227.578,7.47541,0.385246,243,KC Sangakkara,0,0,0,0,0,0,0,0,16,7,23,16,7,23,0,273,0,0,1,4.33659,0.360976,41.9854,80.6276,205,4
Sri Lanka,244,223.373,7.09016,0.344262,227.578,7.47541,0.385246,243,DPMD Jayawardene,0,0,0,0,0,0,0,0,16,7,23,16,7,23,0,273,0,0,1,3.20833,0.244792,31.6979,79.1109,192,4
India,259,242.378,7.15058,0.339768,244.568,7.12741,0.30888,243,G Gambhir,0,0,0,0,0,0,0,0,24,10,34,24,10,34,274,173,2,0,1,3.99145,0.333333,37.4701,84.1944,117,4
India,259,242.378,7.15058,0.339768,244.568,7.12741,0.30888,243,V Sehwag,0,0,0,0,0,0,0,0,24,10,34,24,10,34,274,173,2,0,1,5.88636,0.238636,38.8295,108.649,88,0
Bangladesh,160,218.438,7.70625,0.4,211.106,7.05,0.325,244,Tamim Iqbal,0,0,0,0,0,0,0,0,0,8,8,0,8,8,0,117,5,0,1,4.05344,0.274809,31.8015,76.8068,131,4
Bangladesh,160,218.438,7.70625,0.4,211.106,7.05,0.325,244,Junaid Siddique,0,0,0,0,0,0,0,0,0,8,8,0,8,8,0,117,5,0,1,2.16279,0.116279,20.0233,68.225,43,1
Bangladesh,160,218.438,7.70625,0.4,211.106,7.05,0.325,244,Mehrab Hossain jnr,0,0,0,0,0,0,0,0,0,8,8,0,8,8,0,117,5,0,1,1.7,0.1,18.3,42.4594,10,3
Bangladesh,160,218.438,7.70625,0.4,211.106,7.05,0.325,244,Mohammad Ashraful,0,0,0,0,0,0,0,0,0,8,8,0,8,8,0,117,5,0,1,2.17722,0.113924,19.4557,63.9085,79,1
Australia,228,239.627,7.69737,0.372807,232.079,7.23246,0.337719,244,SE Marsh,0,0,0,0,0,0,0,0,8,10,18,8,10,18,118,118,6,1,1,3.66667,0.291667,35.5417,74.7918,48,4
Australia,228,239.627,7.69737,0.372807,232.079,7.23246,0.337719,244,SR Watson,0,0,0,0,0,0,0,0,8,10,18,8,10,18,118,118,6,1,1,4.71318,0.286822,37.7907,90.0943,129,4
Australia,228,239.627,7.69737,0.372807,232.079,7.23246,0.337719,245,SE Marsh,0,0,0,0,0,0,0,0,12,8,20,12,8,20,0,198,1,1,1,3.66667,0.291667,35.5417,74.7918,48,4
Australia,228,239.627,7.69737,0.372807,232.079,7.23246,0.337719,245,SR Watson,0,0,0,0,0,0,0,0,12,8,20,12,8,20,0,198,1,1,1,4.71318,0.286822,37.7907,90.0943,129,4
Bangladesh,160,218.438,7.70625,0.4,211.106,7.05,0.325,245,Tamim Iqbal,0,0,0,0,0,0,0,0,4,8,12,4,8,12,199,125,1,0,1,4.05344,0.274809,31.8015,76.8068,131,4
Bangladesh,160,218.438,7.70625,0.4,211.106,7.05,0.325,245,Junaid Siddique,0,0,0,0,0,0,0,0,4,8,12,4,8,12,199,125,1,0,1,2.16279,0.116279,20.0233,68.225,43,1
Bangladesh,160,218.438,7.70625,0.4,211.106,7.05,0.325,245,Mohammad Ashraful,0,0,0,0,0,0,0,0,4,8,12,4,8,12,199,125,1,0,1,2.17722,0.113924,19.4557,63.9085,79,1
India,259,242.378,7.15058,0.339768,244.568,7.12741,0.30888,246,G Gambhir,0,0,0,0,0,0,0,0,0,8,8,0,8,8,0,146,1,0,1,3.99145,0.333333,37.4701,84.1944,117,4
India,259,242.378,7.15058,0.339768,244.568,7.12741,0.30888,246,SK Raina,0,0,0,0,0,0,0,0,0,8,8,0,8,8,0,146,1,0,1,3.11111,0.216374,28.9064,91.8944,171,0
India,259,242.378,7.15058,0.339768,244.568,7.12741,0.30888,246,V Kohli,0,0,0,0,0,0,0,0,0,8,8,0,8,8,0,146,1,0,1,4.66456,0.379747,44.9937,88.3325,158,4
Sri Lanka,244,223.373,7.09016,0.344262,227.578,7.47541,0.385246,246,ST Jayasuriya,0,0,0,0,0,0,0,0,8,9,17,8,9,17,147,147,1,1,1,4.91549,0.211268,33.9859,98.4898,71,0
Sri Lanka,244,223.373,7.09016,0.344262,227.578,7.47541,0.385246,246,KC Sangakkara,0,0,0,0,0,0,0,0,8,9,17,8,9,17,147,147,1,1,1,4.33659,0.360976,41.9854,80.6276,205,4
Sri Lanka,244,223.373,7.09016,0.344262,227.578,7.47541,0.385246,247,ST Jayasuriya,0,0,0,0,0,0,0,0,4,4,8,4,4,8,0,142,0,1,1,4.91549,0.211268,33.9859,98.4898,71,0
Sri Lanka,244,223.373,7.09016,0.344262,227.578,7.47541,0.385246,247,KC Sangakkara,0,0,0,0,0,0,0,0,4,4,8,4,4,8,0,142,0,1,1,4.33659,0.360976,41.9854,80.6276,205,4
Sri Lanka,244,223.373,7.09016,0.344262,227.578,7.47541,0.385246,247,DPMD Jayawardene,0,0,0,0,0,0,0,0,4,4,8,4,4,8,0,142,0,1,1,3.20833,0.244792,31.6979,79.1109,192,4
India,259,242.378,7.15058,0.339768,244.568,7.12741,0.30888,247,IK Pathan,0,0,0,0,0,0,0,0,8,6,14,8,6,14,143,143,3,0,1,1.875,0.025,16.85,78.2811,40,1
India,259,242.378,7.15058,0.339768,244.568,7.12741,0.30888,247,V Kohli,0,0,0,0,0,0,0,0,8,6,14,8,6,14,143,143,3,0,1,4.66456,0.379747,44.9937,88.3325,158,4
India,259,242.378,7.15058,0.339768,244.568,7.12741,0.30888,247,SK Raina,0,0,0,0,0,0,0,0,8,6,14,8,6,14,143,143,3,0,1,3.11111,0.216374,28.9064,91.8944,171,0
India,259,242.378,7.15058,0.339768,244.568,7.12741,0.30888,247,Yuvraj Singh,0,0,0,0,0,0,0,0,8,6,14,8,6,14,143,143,3,0,1,4.05833,0.258333,32.525,83.8093,120,4
India,259,242.378,7.15058,0.339768,244.568,7.12741,0.30888,248,V Kohli,0,0,0,0,0,0,0,0,8,11,19,8,11,19,0,237,6,0,1,4.66456,0.379747,44.9937,88.3325,158,4
India,259,242.378,7.15058,0.339768,244.568,7.12741,0.30888,248,G Gambhir,0,0,0,0,0,0,0,0,8,11,19,8,11,19,0,237,6,0,1,3.99145,0.333333,37.4701,84.1944,117,4
Sri Lanka,244,223.373,7.09016,0.344262,227.578,7.47541,0.385246,248,ST Jayasuriya,0,0,0,0,0,0,0,0,20,2,22,20,2,22,238,204,0,1,1,4.91549,0.211268,33.9859,98.4898,71,0
Sri Lanka,244,223.373,7.09016,0.344262,227.578,7.47541,0.385246,248,KC Sangakkara,0,0,0,0,0,0,0,0,20,2,22,20,2,22,238,204,0,1,1,4.33659,0.360976,41.9854,80.6276,205,4
Sri Lanka,244,223.373,7.09016,0.344262,227.578,7.47541,0.385246,248,CK Kapugedera,0,0,0,0,0,0,0,0,20,2,22,20,2,22,238,204,0,1,1,1.74138,0.12069,21.1379,68.6066,58,1
Sri Lanka,244,223.373,7.09016,0.344262,227.578,7.47541,0.385246,249,ST Jayasuriya,0,0,0,0,0,0,0,0,4,3,7,4,3,7,0,227,0,1,1,4.91549,0.211268,33.9859,98.4898,71,0
Sri Lanka,244,223.373,7.09016,0.344262,227.578,7.47541,0.385246,249,SM Warnapura,0,0,0,0,0,0,0,0,4,3,7,4,3,7,0,227,0,1,1,2,0,15,46.875,2,3
Sri Lanka,244,223.373,7.09016,0.344262,227.578,7.47541,0.385246,249,ML Udawatte,0,0,0,0,0,0,0,0,4,3,7,4,3,7,0,227,0,1,1,2.33333,0,17.1667,62.0482,6,1
India,259,242.378,7.15058,0.339768,244.568,7.12741,0.30888,249,V Kohli,0,0,0,0,0,0,0,0,14,3,17,14,3,17,228,103,3,0,1,4.66456,0.379747,44.9937,88.3325,158,4
India,259,242.378,7.15058,0.339768,244.568,7.12741,0.30888,249,G Gambhir,0,0,0,0,0,0,0,0,14,3,17,14,3,17,228,103,3,0,1,3.99145,0.333333,37.4701,84.1944,117,4
Pakistan,211,222.621,7.38389,0.393365,235.517,7.54976,0.336493,250,Salman Butt,0,0,0,0,0,0,0,0,16,10,26,16,10,26,0,322,2,1,1,5.4359,0.384615,42.3846,78.8645,39,4
Pakistan,211,222.621,7.38389,0.393365,235.517,7.54976,0.336493,250,Nasir Jamshed,0,0,0,0,0,0,0,0,16,10,26,16,10,26,0,322,2,1,1,3.63043,0.23913,30.2174,73.8184,46,4
Bangladesh,160,218.438,7.70625,0.4,211.106,7.05,0.325,250,Tamim Iqbal,0,0,0,0,0,0,0,0,8,10,18,8,10,18,323,129,3,0,1,4.05344,0.274809,31.8015,76.8068,131,4
Bangladesh,160,218.438,7.70625,0.4,211.106,7.05,0.325,250,Shahriar Nafees,0,0,0,0,0,0,0,0,8,10,18,8,10,18,323,129,3,0,1,3.40541,0.162162,24.4865,69.1076,37,4
Bangladesh,160,218.438,7.70625,0.4,211.106,7.05,0.325,250,Aftab Ahmed,0,0,0,0,0,0,0,0,8,10,18,8,10,18,323,129,3,0,1,2.44118,0.0882353,19.1471,73.8095,34,1
Bangladesh,160,218.438,7.70625,0.4,211.106,7.05,0.325,251,Tamim Iqbal,0,0,0,0,0,0,0,0,20,3,23,20,3,23,0,225,4,0,1,4.05344,0.274809,31.8015,76.8068,131,4
Bangladesh,160,218.438,7.70625,0.4,211.106,7.05,0.325,251,Shahriar Nafees,0,0,0,0,0,0,0,0,20,3,23,20,3,23,0,225,4,0,1,3.40541,0.162162,24.4865,69.1076,37,4
Bangladesh,160,218.438,7.70625,0.4,211.106,7.05,0.325,251,Aftab Ahmed,0,0,0,0,0,0,0,0,20,3,23,20,3,23,0,225,4,0,1,2.44118,0.0882353,19.1471,73.8095,34,1
Pakistan,211,222.621,7.38389,0.393365,235.517,7.54976,0.336493,251,Salman Butt,0,0,0,0,0,0,0,0,24,13,37,24,13,37,226,160,4,1,1,5.4359,0.384615,42.3846,78.8645,39,4
Pakistan,211,222.621,7.38389,0.393365,235.517,7.54976,0.336493,251,Nasir Jamshed,0,0,0,0,0,0,0,0,24,13,37,24,13,37,226,160,4,1,1,3.63043,0.23913,30.2174,73.8184,46,4
Pakistan,211,222.621,7.38389,0.393365,235.517,7.54976,0.336493,252,Salman Butt,0,0,0,0,0,0,0,0,4,10,14,4,10,14,0,308,1,1,1,5.4359,0.384615,42.3846,78.8645,39,4
Pakistan,211,222.621,7.38389,0.393365,235.517,7.54976,0.336493,252,Kamran Akmal,0,0,0,0,0,0,0,0,4,10,14,4,10,14,0,308,1,1,1,3.01124,0.11236,23.0787,81.4433,89,4
Bangladesh,160,218.438,7.70625,0.4,211.106,7.05,0.325,252,Tamim Iqbal,0,0,0,0,0,0,0,0,8,5,13,8,5,13,309,285,4,0,1,4.05344,0.274809,31.8015,76.8068,131,4
Bangladesh,160,218.438,7.70625,0.4,211.106,7.05,0.325,252,Shahriar Nafees,0,0,0,0,0,0,0,0,8,5,13,8,5,13,309,285,4,0,1,3.40541,0.162162,24.4865,69.1076,37,4
Pakistan,211,222.621,7.38389,0.393365,235.517,7.54976,0.336493,253,Salman Butt,0,0,0,0,0,0,0,0,16,7,23,16,7,23,0,329,5,0,1,5.4359,0.384615,42.3846,78.8645,39,4
Pakistan,211,222.621,7.38389,0.393365,235.517,7.54976,0.336493,253,Kamran Akmal,0,0,0,0,0,0,0,0,16,7,23,16,7,23,0,329,5,0,1,3.01124,0.11236,23.0787,81.4433,89,4
Bangladesh,160,218.438,7.70625,0.4,211.106,7.05,0.325,253,Tamim Iqbal,0,0,0,0,0,0,0,0,4,7,11,4,7,11,330,179,1,0,1,4.05344,0.274809,31.8015,76.8068,131,4
Bangladesh,160,218.438,7.70625,0.4,211.106,7.05,0.325,253,Junaid Siddique,0,0,0,0,0,0,0,0,4,7,11,4,7,11,330,179,1,0,1,2.16279,0.116279,20.0233,68.225,43,1
Bangladesh,160,218.438,7.70625,0.4,211.106,7.05,0.325,253,Aftab Ahmed,0,0,0,0,0,0,0,0,4,7,11,4,7,11,330,179,1,0,1,2.44118,0.0882353,19.1471,73.8095,34,1
Pakistan,211,222.621,7.38389,0.393365,235.517,7.54976,0.336493,254,Salman Butt,0,0,0,0,0,0,0,0,12,9,21,12,9,21,0,233,0,0,1,5.4359,0.384615,42.3846,78.8645,39,4
Pakistan,211,222.621,7.38389,0.393365,235.517,7.54976,0.336493,254,Kamran Akmal,0,0,0,0,0,0,0,0,12,9,21,12,9,21,0,233,0,0,1,3.01124,0.11236,23.0787,81.4433,89,4
Bangladesh,160,218.438,7.70625,0.4,211.106,7.05,0.325,254,Tamim Iqbal,0,0,0,0,0,0,0,0,8,11,19,8,11,19,234,163,3,1,1,4.05344,0.274809,31.8015,76.8068,131,4
Bangladesh,160,218.438,7.70625,0.4,211.106,7.05,0.325,254,Shahriar Nafees,0,0,0,0,0,0,0,0,8,11,19,8,11,19,234,163,3,1,1,3.40541,0.162162,24.4865,69.1076,37,4
India,259,242.378,7.15058,0.339768,244.568,7.12741,0.30888,255,G Gambhir,0,0,0,0,0,0,0,0,20,13,33,20,13,33,0,330,10,0,1,3.99145,0.333333,37.4701,84.1944,117,4
India,259,242.378,7.15058,0.339768,244.568,7.12741,0.30888,255,V Sehwag,0,0,0,0,0,0,0,0,20,13,33,20,13,33,0,330,10,0,1,5.88636,0.238636,38.8295,108.649,88,0
Pakistan,211,222.621,7.38389,0.393365,235.517,7.54976,0.336493,255,Salman Butt,0,0,0,0,0,0,0,0,18,8,26,18,8,26,331,190,0,0,1,5.4359,0.384615,42.3846,78.8645,39,4
Pakistan,211,222.621,7.38389,0.393365,235.517,7.54976,0.336493,255,Kamran Akmal,0,0,0,0,0,0,0,0,18,8,26,18,8,26,331,190,0,0,1,3.01124,0.11236,23.0787,81.4433,89,4
Pakistan,211,222.621,7.38389,0.393365,235.517,7.54976,0.336493,255,Younis Khan,0,0,0,0,0,0,0,0,18,8,26,18,8,26,331,190,0,0,1,2.64655,0.215517,28.5,73.2713,116,4
Pakistan,211,222.621,7.38389,0.393365,235.517,7.54976,0.336493,255,Mohammad Yousuf,0,0,0,0,0,0,0,0,18,8,26,18,8,26,331,190,0,0,1,3.27586,0.275862,36.7931,73.9176,58,4
Pakistan,211,222.621,7.38389,0.393365,235.517,7.54976,0.336493,255,Misbah-ul-Haq,0,0,0,0,0,0,0,0,18,8,26,18,8,26,331,190,0,0,1,2.95238,0.285714,34.9921,71.8195,126,4
Bangladesh,160,218.438,7.70625,0.4,211.106,7.05,0.325,256,Tamim Iqbal,0,0,0,0,0,0,0,0,4,8,12,4,8,12,0,222,1,1,1,4.05344,0.274809,31.8015,76.8068,131,4
Bangladesh,160,218.438,7.70625,0.4,211.106,7.05,0.325,256,Mohammad Ashraful,0,0,0,0,0,0,0,0,4,8,12,4,8,12,0,222,1,1,1,2.17722,0.113924,19.4557,63.9085,79,1
Bangladesh,160,218.438,7.70625,0.4,211.106,7.05,0.325,256,Shahriar Nafees,0,0,0,0,0,0,0,0,4,8,12,4,8,12,0,222,1,1,1,3.40541,0.162162,24.4865,69.1076,37,4
India,259,242.378,7.15058,0.339768,244.568,7.12741,0.30888,256,G Gambhir,0,0,0,0,0,0,0,0,12,14,26,12,14,26,223,223,0,0,1,3.99145,0.333333,37.4701,84.1944,117,4
India,259,242.378,7.15058,0.339768,244.568,7.12741,0.30888,256,V Sehwag,0,0,0,0,0,0,0,0,12,14,26,12,14,26,223,223,0,0,1,5.88636,0.238636,38.8295,108.649,88,0
Pakistan,211,222.621,7.38389,0.393365,235.517,7.54976,0.336493,257,Salman Butt,0,0,0,0,0,0,0,0,8,5,13,8,5,13,0,315,0,0,1,5.4359,0.384615,42.3846,78.8645,39,4
Pakistan,211,222.621,7.38389,0.393365,235.517,7.54976,0.336493,257,Kamran Akmal,0,0,0,0,0,0,0,0,8,5,13,8,5,13,0,315,0,0,1,3.01124,0.11236,23.0787,81.4433,89,4
India,259,242.378,7.15058,0.339768,244.568,7.12741,0.30888,257,G Gambhir,0,0,0,0,0,0,0,0,20,5,25,20,5,25,316,290,3,0,1,3.99145,0.333333,37.4701,84.1944,117,4
India,259,242.378,7.15058,0.339768,244.568,7.12741,0.30888,257,V Sehwag,0,0,0,0,0,0,0,0,20,5,25,20,5,25,316,290,3,0,1,5.88636,0.238636,38.8295,108.649,88,0
India,259,242.378,7.15058,0.339768,244.568,7.12741,0.30888,257,RG Sharma,0,0,0,0,0,0,0,0,20,5,25,20,5,25,316,290,3,0,1,3.82836,0.268657,35.9179,83.083,134,4
Australia,228,239.627,7.69737,0.372807,232.079,7.23246,0.337719,258,SR Watson,0,0,0,0,0,0,0,0,12,8,20,12,8,20,0,260,1,0,1,4.71318,0.286822,37.7907,90.0943,129,4
Australia,228,239.627,7.69737,0.372807,232.079,7.23246,0.337719,258,TD Paine,0,0,0,0,0,0,0,0,12,8,20,12,8,20,0,260,1,0,1,3.3913,0.217391,27.6522,65.7704,23,4
Australia,228,239.627,7.69737,0.372807,232.079,7.23246,0.337719,258,CL White,0,0,0,0,0,0,0,0,12,8,20,12,8,20,0,260,1,0,1,2.66176,0.191176,28.8235,80.1308,68,4
England,221,237.176,7.17647,0.289593,230.633,7.45701,0.384615,258,AJ Strauss,0,0,0,0,0,0,0,0,12,7,19,12,7,19,261,256,4,1,1,3.93243,0.27027,33.9054,79.8028,74,4
England,221,237.176,7.17647,0.289593,230.633,7.45701,0.384615,258,RS Bopara,0,0,0,0,0,0,0,0,12,7,19,12,7,19,261,256,4,1,1,2.22115,0.144231,25.1538,75.9361,104,4
England,221,237.176,7.17647,0.289593,230.633,7.45701,0.384615,258,MJ Prior,0,0,0,0,0,0,0,0,12,7,19,12,7,19,261,256,4,1,1,2.27083,0.0625,21.6875,76.4879,48,4
Australia,228,239.627,7.69737,0.372807,232.079,7.23246,0.337719,259,SR Watson,0,0,0,0,0,0,0,0,12,7,19,12,7,19,0,249,1,0,1,4.71318,0.286822,37.7907,90.0943,129,4
Australia,228,239.627,7.69737,0.372807,232.079,7.23246,0.337719,259,TD Paine,0,0,0,0,0,0,0,0,12,7,19,12,7,19,0,249,1,0,1,3.3913,0.217391,27.6522,65.7704,23,4
England,221,237.176,7.17647,0.289593,230.633,7.45701,0.384615,259,AJ Strauss,0,0,0,0,0,0,0,0,8,6,14,8,6,14,250,210,1,1,1,3.93243,0.27027,33.9054,79.8028,74,4
England,221,237.176,7.17647,0.289593,230.633,7.45701,0.384615,259,RS Bopara,0,0,0,0,0,0,0,0,8,6,14,8,6,14,250,210,1,1,1,2.22115,0.144231,25.1538,75.9361,104,4
England,221,237.176,7.17647,0.289593,230.633,7.45701,0.384615,260,AJ Strauss,0,0,0,0,0,0,0,0,12,8,20,12,8,20,0,228,0,1,1,3.93243,0.27027,33.9054,79.8028,74,4
England,221,237.176,7.17647,0.289593,230.633,7.45701,0.384615,260,RS Bopara,0,0,0,0,0,0,0,0,12,8,20,12,8,20,0,228,0,1,1,2.22115,0.144231,25.1538,75.9361,104,4
Australia,228,239.627,7.69737,0.372807,232.079,7.23246,0.337719,260,SR Watson,0,0,0,0,0,0,0,0,4,10,14,4,10,14,229,230,2,0,1,4.71318,0.286822,37.7907,90.0943,129,4
Australia,228,239.627,7.69737,0.372807,232.079,7.23246,0.337719,260,TD Paine,0,0,0,0,0,0,0,0,4,10,14,4,10,14,229,230,2,0,1,3.3913,0.217391,27.6522,65.7704,23,4
England,221,237.176,7.17647,0.289593,230.633,7.45701,0.384615,261,AJ Strauss,0,0,0,0,0,0,0,0,20,7,27,20,7,27,0,220,2,1,1,3.93243,0.27027,33.9054,79.8028,74,4
England,221,237.176,7.17647,0.289593,230.633,7.45701,0.384615,261,JL Denly,0,0,0,0,0,0,0,0,20,7,27,20,7,27,0,220,2,1,1,3.55556,0.222222,29.3333,63.1579,9,4
England,221,237.176,7.17647,0.289593,230.633,7.45701,0.384615,261,RS Bopara,0,0,0,0,0,0,0,0,20,7,27,20,7,27,0,220,2,1,1,2.22115,0.144231,25.1538,75.9361,104,4
Australia,228,239.627,7.69737,0.372807,232.079,7.23246,0.337719,261,SR Watson,0,0,0,0,0,0,0,0,12,7,19,12,7,19,221,221,1,0,1,4.71318,0.286822,37.7907,90.0943,129,4
Australia,228,239.627,7.69737,0.372807,232.079,7.23246,0.337719,261,TD Paine,0,0,0,0,0,0,0,0,12,7,19,12,7,19,221,221,1,0,1,3.3913,0.217391,27.6522,65.7704,23,4
Australia,228,239.627,7.69737,0.372807,232.079,7.23246,0.337719,262,SR Watson,0,0,0,0,0,0,0,0,8,5,13,8,5,13,0,296,6,0,1,4.71318,0.286822,37.7907,90.0943,129,4
Australia,228,239.627,7.69737,0.372807,232.079,7.23246,0.337719,262,TD Paine,0,0,0,0,0,0,0,0,8,5,13,8,5,13,0,296,6,0,1,3.3913,0.217391,27.6522,65.7704,23,4
Australia,228,239.627,7.69737,0.372807,232.079,7.23246,0.337719,262,RT Ponting,0,0,0,0,0,0,0,0,8,5,13,8,5,13,0,296,6,0,1,4.17431,0.33945,38.1009,80.8606,109,4
England,221,237.176,7.17647,0.289593,230.633,7.45701,0.384615,262,AJ Strauss,0,0,0,0,0,0,0,0,12,9,21,12,9,21,297,185,2,1,1,3.93243,0.27027,33.9054,79.8028,74,4
England,221,237.176,7.17647,0.289593,230.633,7.45701,0.384615,262,RS Bopara,0,0,0,0,0,0,0,0,12,9,21,12,9,21,297,185,2,1,1,2.22115,0.144231,25.1538,75.9361,104,4
England,221,237.176,7.17647,0.289593,230.633,7.45701,0.384615,262,JL Denly,0,0,0,0,0,0,0,0,12,9,21,12,9,21,297,185,2,1,1,3.55556,0.222222,29.3333,63.1579,9,4
Australia,228,239.627,7.69737,0.372807,232.079,7.23246,0.337719,263,SR Watson,0,0,0,0,0,0,0,0,16,4,20,16,4,20,0,176,1,0,1,4.71318,0.286822,37.7907,90.0943,129,4
Australia,228,239.627,7.69737,0.372807,232.079,7.23246,0.337719,263,RT Ponting,0,0,0,0,0,0,0,0,16,4,20,16,4,20,0,176,1,0,1,4.17431,0.33945,38.1009,80.8606,109,4
Australia,228,239.627,7.69737,0.372807,232.079,7.23246,0.337719,263,TD Paine,0,0,0,0,0,0,0,0,16,4,20,16,4,20,0,176,1,0,1,3.3913,0.217391,27.6522,65.7704,23,4
Australia,228,239.627,7.69737,0.372807,232.079,7.23246,0.337719,263,MJ Clarke,0,0,0,0,0,0,0,0,16,4,20,16,4,20,0,176,1,0,1,3.10294,0.301471,35.9265,74.0303,136,4
England,221,237.176,7.17647,0.289593,230.633,7.45701,0.384615,263,AJ Strauss,0,0,0,0,0,0,0,0,4,9,13,4,9,13,177,177,11,1,1,3.93243,0.27027,33.9054,79.8028,74,4
England,221,237.176,7.17647,0.289593,230.633,7.45701,0.384615,263,JL Denly,0,0,0,0,0,0,0,0,4,9,13,4,9,13,177,177,11,1,1,3.55556,0.222222,29.3333,63.1579,9,4
South Africa,190,234.274,7.4,0.373684,232.363,7.33158,0.342105,264,HM Amla,0,0,0,0,0,0,0,0,24,2,26,24,2,26,0,283,1,1,1,5.20168,0.403361,48.7899,86.9292,119,4
South Africa,190,234.274,7.4,0.373684,232.363,7.33158,0.342105,264,JL Ontong,0,0,0,0,0,0,0,0,24,2,26,24,2,26,0,283,1,1,1,2.66667,0,22.3333,76.1364,3,4
Bangladesh,160,218.438,7.70625,0.4,211.106,7.05,0.325,264,Tamim Iqbal,0,0,0,0,0,0,0,0,4,8,12,4,8,12,284,222,6,0,1,4.05344,0.274809,31.8015,76.8068,131,4
Bangladesh,160,218.438,7.70625,0.4,211.106,7.05,0.325,264,Imrul Kayes,0,0,0,0,0,0,0,0,4,8,12,4,8,12,284,222,6,0,1,3,0.207547,26.2642,63.6488,53,4
Bangladesh,160,218.438,7.70625,0.4,211.106,7.05,0.325,264,Junaid Siddique,0,0,0,0,0,0,0,0,4,8,12,4,8,12,284,222,6,0,1,2.16279,0.116279,20.0233,68.225,43,1
Australia,228,239.627,7.69737,0.372807,232.079,7.23246,0.337719,265,BJ Haddin,0,0,0,0,0,0,0,0,0,9,9,0,9,9,0,286,0,0,1,3.14737,0.147368,26.7789,81.382,95,4
Australia,228,239.627,7.69737,0.372807,232.079,7.23246,0.337719,265,MJ Clarke,0,0,0,0,0,0,0,0,0,9,9,0,9,9,0,286,0,0,1,3.10294,0.301471,35.9265,74.0303,136,4
Australia,228,239.627,7.69737,0.372807,232.079,7.23246,0.337719,265,RT Ponting,0,0,0,0,0,0,0,0,0,9,9,0,9,9,0,286,0,0,1,4.17431,0.33945,38.1009,80.8606,109,4
South Africa,190,234.274,7.4,0.373684,232.363,7.33158,0.342105,265,HM Amla,0,0,0,0,0,0,0,0,12,8,20,12,8,20,287,145,2,1,1,5.20168,0.403361,48.7899,86.9292,119,4
South Africa,190,234.274,7.4,0.373684,232.363,7.33158,0.342105,265,GC Smith,0,0,0,0,0,0,0,0,12,8,20,12,8,20,287,145,2,1,1,3.97,0.29,33.57,79.6819,100,4
South Africa,190,234.274,7.4,0.373684,232.363,7.33158,0.342105,265,HH Gibbs,0,0,0,0,0,0,0,0,12,8,20,12,8,20,287,145,2,1,1,4.61538,0.307692,35.6923,83.4157,52,4
Australia,228,239.627,7.69737,0.372807,232.079,7.23246,0.337719,266,BJ Haddin,0,0,0,0,0,0,0,0,6,8,14,6,8,14,0,131,0,0,1,3.14737,0.147368,26.7789,81.382,95,4
Australia,228,239.627,7.69737,0.372807,232.079,7.23246,0.337719,266,MJ Clarke,0,0,0,0,0,0,0,0,6,8,14,6,8,14,0,131,0,0,1,3.10294,0.301471,35.9265,74.0303,136,4
Australia,228,239.627,7.69737,0.372807,232.079,7.23246,0.337719,266,RT Ponting,0,0,0,0,0,0,0,0,6,8,14,6,8,14,0,131,0,0,1,4.17431,0.33945,38.1009,80.8606,109,4
Australia,228,239.627,7.69737,0.372807,232.079,7.23246,0.337719,266,DJ Hussey,0,0,0,0,0,0,0,0,6,8,14,6,8,14,0,131,0,0,1,2.54386,0.245614,29.2105,87.8628,57,4
South Africa,190,234.274,7.4,0.373684,232.363,7.33158,0.342105,266,GC Smith,0,0,0,0,0,0,0,0,8,7,15,8,7,15,132,132,1,1,1,3.97,0.29,33.57,79.6819,100,4
South Africa,190,234.274,7.4,0.373684,232.363,7.33158,0.342105,266,HH Gibbs,0,0,0,0,0,0,0,0,8,7,15,8,7,15,132,132,1,1,1,4.61538,0.307692,35.6923,83.4157,52,4
South Africa,190,234.274,7.4,0.373684,232.363,7.33158,0.342105,266,JH Kallis,0,0,0,0,0,0,0,0,8,7,15,8,7,15,132,132,1,1,1,3.58621,0.356322,37.2644,76.4442,87,4
South Africa,190,234.274,7.4,0.373684,232.363,7.33158,0.342105,267,HH Gibbs,0,0,0,0,0,0,0,0,4,10,14,4,10,14,0,289,0,1,1,4.61538,0.307692,35.6923,83.4157,52,4
South Africa,190,234.274,7.4,0.373684,232.363,7.33158,0.342105,267,GC Smith,0,0,0,0,0,0,0,0,4,10,14,4,10,14,0,289,0,1,1,3.97,0.29,33.57,79.6819,100,4
Australia,228,239.627,7.69737,0.372807,232.079,7.23246,0.337719,267,BJ Haddin,0,0,0,0,0,0,0,0,4,10,14,4,10,14,290,264,2,0,1,3.14737,0.147368,26.7789,81.382,95,4
Australia,228,239.627,7.69737,0.372807,232.079,7.23246,0.337719,267,MJ Clarke,0,0,0,0,0,0,0,0,4,10,14,4,10,14,290,264,2,0,1,3.10294,0.301471,35.9265,74.0303,136,4
South Africa,190,234.274,7.4,0.373684,232.363,7.33158,0.342105,268,GC Smith,0,0,0,0,0,0,0,0,4,11,15,4,11,15,0,317,2,1,1,3.97,0.29,33.57,79.6819,100,4
South Africa,190,234.274,7.4,0.373684,232.363,7.33158,0.342105,268,HH Gibbs,0,0,0,0,0,0,0,0,4,11,15,4,11,15,0,317,2,1,1,4.61538,0.307692,35.6923,83.4157,52,4
Australia,228,239.627,7.69737,0.372807,232.079,7.23246,0.337719,268,BJ Haddin,0,0,0,0,0,0,0,0,16,12,28,16,12,28,318,256,2,0,1,3.14737,0.147368,26.7789,81.382,95,4
Australia,228,239.627,7.69737,0.372807,232.079,7.23246,0.337719,268,MJ Clarke,0,0,0,0,0,0,0,0,16,12,28,16,12,28,318,256,2,0,1,3.10294,0.301471,35.9265,74.0303,136,4
Australia,228,239.627,7.69737,0.372807,232.079,7.23246,0.337719,269,BJ Haddin,0,0,0,0,0,0,0,0,16,11,27,16,11,27,0,303,0,0,1,3.14737,0.147368,26.7789,81.382,95,4
Australia,228,239.627,7.69737,0.372807,232.079,7.23246,0.337719,269,MJ Clarke,0,0,0,0,0,0,0,0,16,11,27,16,11,27,0,303,0,0,1,3.10294,0.301471,35.9265,74.0303,136,4
South Africa,190,234.274,7.4,0.373684,232.363,7.33158,0.342105,269,HH Gibbs,0,0,0,0,0,0,0,0,14,12,26,14,12,26,304,256,1,1,1,4.61538,0.307692,35.6923,83.4157,52,4
South Africa,190,234.274,7.4,0.373684,232.363,7.33158,0.342105,269,GC Smith,0,0,0,0,0,0,0,0,14,12,26,14,12,26,304,256,1,1,1,3.97,0.29,33.57,79.6819,100,4
Australia,228,239.627,7.69737,0.372807,232.079,7.23246,0.337719,270,SE Marsh,0,0,0,0,0,0,0,0,8,6,14,8,6,14,0,271,2,1,1,3.66667,0.291667,35.5417,74.7918,48,4
Australia,228,239.627,7.69737,0.372807,232.079,7.23246,0.337719,270,MEK Hussey,0,0,0,0,0,0,0,0,8,6,14,8,6,14,0,271,2,1,1,2.7563,0.260504,34.084,82.4893,119,4
Australia,228,239.627,7.69737,0.372807,232.079,7.23246,0.337719,270,RT Ponting,0,0,0,0,0,0,0,0,8,6,14,8,6,14,0,271,2,1,1,4.17431,0.33945,38.1009,80.8606,109,4
South Africa,190,234.274,7.4,0.373684,232.363,7.33158,0.342105,270,HH Gibbs,0,0,0,0,0,0,0,0,8,8,16,8,8,16,272,272,6,0,1,4.61538,0.307692,35.6923,83.4157,52,4
South Africa,190,234.274,7.4,0.373684,232.363,7.33158,0.342105,270,HM Amla,0,0,0,0,0,0,0,0,8,8,16,8,8,16,272,272,6,0,1,5.20168,0.403361,48.7899,86.9292,119,4
South Africa,190,234.274,7.4,0.373684,232.363,7.33158,0.342105,270,JH Kallis,0,0,0,0,0,0,0,0,8,8,16,8,8,16,272,272,6,0,1,3.58621,0.356322,37.2644,76.4442,87,4
Australia,228,239.627,7.69737,0.372807,232.079,7.23246,0.337719,271,SE Marsh,0,0,0,0,0,0,0,0,18,11,29,18,11,29,0,269,2,1,1,3.66667,0.291667,35.5417,74.7918,48,4
Australia,228,239.627,7.69737,0.372807,232.079,7.23246,0.337719,271,DA Warner,0,0,0,0,0,0,0,0,18,11,29,18,11,29,0,269,2,1,1,4.20312,0.265625,35.2031,87.7336,64,4
South Africa,190,234.274,7.4,0.373684,232.363,7.33158,0.342105,271,HM Amla,0,0,0,0,0,0,0,0,12,11,23,12,11,23,270,270,2,0,1,5.20168,0.403361,48.7899,86.9292,119,4
South Africa,190,234.274,7.4,0.373684,232.363,7.33158,0.342105,271,HH Gibbs,0,0,0,0,0,0,0,0,12,11,23,12,11,23,270,270,2,0,1,4.61538,0.307692,35.6923,83.4157,52,4
Australia,228,239.627,7.69737,0.372807,232.079,7.23246,0.337719,272,SE Marsh,0,0,0,0,0,0,0,0,24,5,29,24,5,29,0,222,3,1,1,3.66667,0.291667,35.5417,74.7918,48,4
Australia,228,239.627,7.69737,0.372807,232.079,7.23246,0.337719,272,DA Warner,0,0,0,0,0,0,0,0,24,5,29,24,5,29,0,222,3,1,1,4.20312,0.265625,35.2031,87.7336,64,4
Australia,228,239.627,7.69737,0.372807,232.079,7.23246,0.337719,272,RT Ponting,0,0,0,0,0,0,0,0,24,5,29,24,5,29,0,222,3,1,1,4.17431,0.33945,38.1009,80.8606,109,4
Australia,228,239.627,7.69737,0.372807,232.079,7.23246,0.337719,272,MEK Hussey,0,0,0,0,0,0,0,0,24,5,29,24,5,29,0,222,3,1,1,2.7563,0.260504,34.084,82.4893,119,4
South Africa,190,234.274,7.4,0.373684,232.363,7.33158,0.342105,272,HM Amla,0,0,0,0,0,0,0,0,20,9,29,20,9,29,223,223,2,0,1,5.20168,0.403361,48.7899,86.9292,119,4
South Africa,190,234.274,7.4,0.373684,232.363,7.33158,0.342105,272,HH Gibbs,0,0,0,0,0,0,0,0,20,9,29,20,9,29,223,223,2,0,1,4.61538,0.307692,35.6923,83.4157,52,4
South Africa,190,234.274,7.4,0.373684,232.363,7.33158,0.342105,273,HM Amla,0,0,0,0,0,0,0,0,12,11,23,12,11,23,0,288,5,0,1,5.20168,0.403361,48.7899,86.9292,119,4
South Africa,190,234.274,7.4,0.373684,232.363,7.33158,0.342105,273,HH Gibbs,0,0,0,0,0,0,0,0,12,11,23,12,11,23,0,288,5,0,1,4.61538,0.307692,35.6923,83.4157,52,4
Australia,228,239.627,7.69737,0.372807,232.079,7.23246,0.337719,273,SE Marsh,0,0,0,0,0,0,0,0,16,4,20,16,4,20,289,249,8,1,1,3.66667,0.291667,35.5417,74.7918,48,4
Australia,228,239.627,7.69737,0.372807,232.079,7.23246,0.337719,273,RT Ponting,0,0,0,0,0,0,0,0,16,4,20,16,4,20,289,249,8,1,1,4.17431,0.33945,38.1009,80.8606,109,4
Australia,228,239.627,7.69737,0.372807,232.079,7.23246,0.337719,273,DA Warner,0,0,0,0,0,0,0,0,16,4,20,16,4,20,289,249,8,1,1,4.20312,0.265625,35.2031,87.7336,64,4
Australia,228,239.627,7.69737,0.372807,232.079,7.23246,0.337719,274,SE Marsh,0,0,0,0,0,0,0,0,8,6,14,8,6,14,0,181,0,1,1,3.66667,0.291667,35.5417,74.7918,48,4
Australia,228,239.627,7.69737,0.372807,232.079,7.23246,0.337719,274,DA Warner,0,0,0,0,0,0,0,0,8,6,14,8,6,14,0,181,0,1,1,4.20312,0.265625,35.2031,87.7336,64,4
New Zealand,184,233.745,7.39674,0.36413,227.951,7.30435,0.353261,274,BB McCullum,0,0,0,0,0,0,0,0,8,2,10,8,2,10,182,182,3,0,1,3.98611,0.201389,29.9028,98.4004,144,0
New Zealand,184,233.745,7.39674,0.36413,227.951,7.30435,0.353261,274,PG Fulton,0,0,0,0,0,0,0,0,8,2,10,8,2,10,182,182,3,0,1,2.75,0.1875,27.4062,67.4615,32,4
New Zealand,184,233.745,7.39674,0.36413,227.951,7.30435,0.353261,274,MJ Guptill,0,0,0,0,0,0,0,0,8,2,10,8,2,10,182,182,3,0,1,4.8087,0.313043,38.1217,82.7482,115,4
Australia,228,239.627,7.69737,0.372807,232.079,7.23246,0.337719,275,DA Warner,0,0,0,0,0,0,0,0,0,9,9,0,9,9,0,225,0,1,1,4.20312,0.265625,35.2031,87.7336,64,4
Australia,228,239.627,7.69737,0.372807,232.079,7.23246,0.337719,275,MJ Clarke,0,0,0,0,0,0,0,0,0,9,9,0,9,9,0,225,0,1,1,3.10294,0.301471,35.9265,74.0303,136,4
Australia,228,239.627,7.69737,0.372807,232.079,7.23246,0.337719,275,BJ Haddin,0,0,0,0,0,0,0,0,0,9,9,0,9,9,0,225,0,1,1,3.14737,0.147368,26.7789,81.382,95,4
New Zealand,184,233.745,7.39674,0.36413,227.951,7.30435,0.353261,275,BB McCullum,0,0,0,0,0,0,0,0,8,11,19,8,11,19,226,226,4,0,1,3.98611,0.201389,29.9028,98.4004,144,0
New Zealand,184,233.745,7.39674,0.36413,227.951,7.30435,0.353261,275,MJ Guptill,0,0,0,0,0,0,0,0,8,11,19,8,11,19,226,226,4,0,1,4.8087,0.313043,38.1217,82.7482,115,4
New Zealand,184,233.745,7.39674,0.36413,227.951,7.30435,0.353261,275,PG Fulton,0,0,0,0,0,0,0,0,8,11,19,8,11,19,226,226,4,0,1,2.75,0.1875,27.4062,67.4615,32,4
Australia,228,239.627,7.69737,0.372807,232.079,7.23246,0.337719,276,BJ Haddin,0,0,0,0,0,0,0,0,12,8,20,12,8,20,0,301,0,1,1,3.14737,0.147368,26.7789,81.382,95,4
Australia,228,239.627,7.69737,0.372807,232.079,7.23246,0.337719,276,MJ Clarke,0,0,0,0,0,0,0,0,12,8,20,12,8,20,0,301,0,1,1,3.10294,0.301471,35.9265,74.0303,136,4
New Zealand,184,233.745,7.39674,0.36413,227.951,7.30435,0.353261,276,MJ Guptill,0,0,0,0,0,0,0,0,8,4,12,8,4,12,302,269,0,0,1,4.8087,0.313043,38.1217,82.7482,115,4
New Zealand,184,233.745,7.39674,0.36413,227.951,7.30435,0.353261,276,PG Fulton,0,0,0,0,0,0,0,0,8,4,12,8,4,12,302,269,0,0,1,2.75,0.1875,27.4062,67.4615,32,4
New Zealand,184,233.745,7.39674,0.36413,227.951,7.30435,0.353261,277,BB McCullum,0,0,0,0,0,0,0,0,0,11,11,0,11,11,0,244,0,0,1,3.98611,0.201389,29.9028,98.4004,144,0
New Zealand,184,233.745,7.39674,0.36413,227.951,7.30435,0.353261,277,MJ Guptill,0,0,0,0,0,0,0,0,0,11,11,0,11,11,0,244,0,0,1,4.8087,0.313043,38.1217,82.7482,115,4
Australia,228,239.627,7.69737,0.372807,232.079,7.23246,0.337719,277,BJ Haddin,0,0,0,0,0,0,0,0,16,10,26,16,10,26,245,247,1,1,1,3.14737,0.147368,26.7789,81.382,95,4
Australia,228,239.627,7.69737,0.372807,232.079,7.23246,0.337719,277,MJ Clarke,0,0,0,0,0,0,0,0,16,10,26,16,10,26,245,247,1,1,1,3.10294,0.301471,35.9265,74.0303,136,4
England,221,237.176,7.17647,0.289593,230.633,7.45701,0.384615,278,AJ Strauss,0,0,0,0,0,0,0,0,0,14,14,0,14,14,0,270,7,0,1,3.93243,0.27027,33.9054,79.8028,74,4
England,221,237.176,7.17647,0.289593,230.633,7.45701,0.384615,278,RS Bopara,0,0,0,0,0,0,0,0,0,14,14,0,14,14,0,270,7,0,1,2.22115,0.144231,25.1538,75.9361,104,4
West Indies,176,217.33,7.15909,0.3125,225.278,7.57386,0.380682,278,CH Gayle,0,0,0,0,0,0,0,0,4,5,9,4,5,9,271,244,1,1,1,4.58621,0.206897,31.1293,89.4255,116,4
West Indies,176,217.33,7.15909,0.3125,225.278,7.57386,0.380682,278,LMP Simmons,0,0,0,0,0,0,0,0,4,5,9,4,5,9,271,244,1,1,1,3.3125,0.28125,30.5938,71.4338,64,4
West Indies,176,217.33,7.15909,0.3125,225.278,7.57386,0.380682,278,RR Sarwan,0,0,0,0,0,0,0,0,4,5,9,4,5,9,271,244,1,1,1,2.8254,0.222222,29.1429,69.1005,63,4
West Indies,176,217.33,7.15909,0.3125,225.278,7.57386,0.380682,279,CH Gayle,0,0,0,0,0,0,0,0,16,7,23,16,7,23,0,264,1,1,1,4.58621,0.206897,31.1293,89.4255,116,4
West Indies,176,217.33,7.15909,0.3125,225.278,7.57386,0.380682,279,LMP Simmons,0,0,0,0,0,0,0,0,16,7,23,16,7,23,0,264,1,1,1,3.3125,0.28125,30.5938,71.4338,64,4
West Indies,176,217.33,7.15909,0.3125,225.278,7.57386,0.380682,279,RR Sarwan,0,0,0,0,0,0,0,0,16,7,23,16,7,23,0,264,1,1,1,2.8254,0.222222,29.1429,69.1005,63,4
England,221,237.176,7.17647,0.289593,230.633,7.45701,0.384615,279,AJ Strauss,0,0,0,0,0,0,0,0,16,5,21,16,5,21,265,243,1,0,1,3.93243,0.27027,33.9054,79.8028,74,4
England,221,237.176,7.17647,0.289593,230.633,7.45701,0.384615,279,RS Bopara,0,0,0,0,0,0,0,0,16,5,21,16,5,21,265,243,1,0,1,2.22115,0.144231,25.1538,75.9361,104,4
England,221,237.176,7.17647,0.289593,230.633,7.45701,0.384615,279,KP Pietersen,0,0,0,0,0,0,0,0,16,5,21,16,5,21,265,243,1,0,1,3.69892,0.236559,33.4946,82.2117,93,4
West Indies,176,217.33,7.15909,0.3125,225.278,7.57386,0.380682,280,CH Gayle,0,0,0,0,0,0,0,0,20,3,23,20,3,23,0,239,0,1,1,4.58621,0.206897,31.1293,89.4255,116,4
West Indies,176,217.33,7.15909,0.3125,225.278,7.57386,0.380682,280,LMP Simmons,0,0,0,0,0,0,0,0,20,3,23,20,3,23,0,239,0,1,1,3.3125,0.28125,30.5938,71.4338,64,4
England,221,237.176,7.17647,0.289593,230.633,7.45701,0.384615,280,AJ Strauss,0,0,0,0,0,0,0,0,24,21,45,24,21,45,240,136,3,0,1,3.93243,0.27027,33.9054,79.8028,74,4
England,221,237.176,7.17647,0.289593,230.633,7.45701,0.384615,280,RS Bopara,0,0,0,0,0,0,0,0,24,21,45,24,21,45,240,136,3,0,1,2.22115,0.144231,25.1538,75.9361,104,4
England,221,237.176,7.17647,0.289593,230.633,7.45701,0.384615,281,AJ Strauss,0,0,0,0,0,0,0,0,12,14,26,12,14,26,0,172,3,0,1,3.93243,0.27027,33.9054,79.8028,74,4
England,221,237.176,7.17647,0.289593,230.633,7.45701,0.384615,281,RS Bopara,0,0,0,0,0,0,0,0,12,14,26,12,14,26,0,172,3,0,1,2.22115,0.144231,25.1538,75.9361,104,4
England,221,237.176,7.17647,0.289593,230.633,7.45701,0.384615,281,KP Pietersen,0,0,0,0,0,0,0,0,12,14,26,12,14,26,0,172,3,0,1,3.69892,0.236559,33.4946,82.2117,93,4
West Indies,176,217.33,7.15909,0.3125,225.278,7.57386,0.380682,281,CH Gayle,0,0,0,0,0,0,0,0,20,9,29,20,9,29,173,146,2,1,1,4.58621,0.206897,31.1293,89.4255,116,4
West Indies,176,217.33,7.15909,0.3125,225.278,7.57386,0.380682,281,RR Sarwan,0,0,0,0,0,0,0,0,20,9,29,20,9,29,173,146,2,1,1,2.8254,0.222222,29.1429,69.1005,63,4
West Indies,176,217.33,7.15909,0.3125,225.278,7.57386,0.380682,281,LMP Simmons,0,0,0,0,0,0,0,0,20,9,29,20,9,29,173,146,2,1,1,3.3125,0.28125,30.5938,71.4338,64,4
India,259,242.378,7.15058,0.339768,244.568,7.12741,0.30888,283,G Gambhir,0,0,0,0,0,0,0,0,16,5,21,16,5,21,0,387,3,1,1,3.99145,0.333333,37.4701,84.1944,117,4
India,259,242.378,7.15058,0.339768,244.568,7.12741,0.30888,283,V Sehwag,0,0,0,0,0,0,0,0,16,5,21,16,5,21,0,387,3,1,1,5.88636,0.238636,38.8295,108.649,88,0
England,221,237.176,7.17647,0.289593,230.633,7.45701,0.384615,283,IR Bell,0,0,0,0,0,0,0,0,8,9,17,8,9,17,388,229,0,0,1,3.63433,0.246269,35.3806,75.6623,134,4
England,221,237.176,7.17647,0.289593,230.633,7.45701,0.384615,283,MJ Prior,0,0,0,0,0,0,0,0,8,9,17,8,9,17,388,229,0,0,1,2.27083,0.0625,21.6875,76.4879,48,4
England,221,237.176,7.17647,0.289593,230.633,7.45701,0.384615,283,OA Shah,0,0,0,0,0,0,0,0,8,9,17,8,9,17,388,229,0,0,1,3.13043,0.23913,32.6739,81.1994,46,4
England,221,237.176,7.17647,0.289593,230.633,7.45701,0.384615,283,KP Pietersen,0,0,0,0,0,0,0,0,8,9,17,8,9,17,388,229,0,0,1,3.69892,0.236559,33.4946,82.2117,93,4
India,259,242.378,7.15058,0.339768,244.568,7.12741,0.30888,284,G Gambhir,0,0,0,0,0,0,0,0,12,6,18,12,6,18,0,292,3,1,1,3.99145,0.333333,37.4701,84.1944,117,4
India,259,242.378,7.15058,0.339768,244.568,7.12741,0.30888,284,V Sehwag,0,0,0,0,0,0,0,0,12,6,18,12,6,18,0,292,3,1,1,5.88636,0.238636,38.8295,108.649,88,0
India,259,242.378,7.15058,0.339768,244.568,7.12741,0.30888,284,SK Raina,0,0,0,0,0,0,0,0,12,6,18,12,6,18,0,292,3,1,1,3.11111,0.216374,28.9064,91.8944,171,0
India,259,242.378,7.15058,0.339768,244.568,7.12741,0.30888,284,RG Sharma,0,0,0,0,0,0,0,0,12,6,18,12,6,18,0,292,3,1,1,3.82836,0.268657,35.9179,83.083,134,4
England,221,237.176,7.17647,0.289593,230.633,7.45701,0.384615,284,IR Bell,0,0,0,0,0,0,0,0,12,7,19,12,7,19,293,238,0,0,1,3.63433,0.246269,35.3806,75.6623,134,4
England,221,237.176,7.17647,0.289593,230.633,7.45701,0.384615,284,MJ Prior,0,0,0,0,0,0,0,0,12,7,19,12,7,19,293,238,0,0,1,2.27083,0.0625,21.6875,76.4879,48,4
England,221,237.176,7.17647,0.289593,230.633,7.45701,0.384615,284,OA Shah,0,0,0,0,0,0,0,0,12,7,19,12,7,19,293,238,0,0,1,3.13043,0.23913,32.6739,81.1994,46,4
England,221,237.176,7.17647,0.289593,230.633,7.45701,0.384615,285,RS Bopara,0,0,0,0,0,0,0,0,12,2,14,12,2,14,0,240,0,0,1,2.22115,0.144231,25.1538,75.9361,104,4
England,221,237.176,7.17647,0.289593,230.633,7.45701,0.384615,285,IR Bell,0,0,0,0,0,0,0,0,12,2,14,12,2,14,0,240,0,0,1,3.63433,0.246269,35.3806,75.6623,134,4
India,259,242.378,7.15058,0.339768,244.568,7.12741,0.30888,285,G Gambhir,0,0,0,0,0,0,0,0,20,5,25,20,5,25,241,198,1,1,1,3.99145,0.333333,37.4701,84.1944,117,4
India,259,242.378,7.15058,0.339768,244.568,7.12741,0.30888,285,V Sehwag,0,0,0,0,0,0,0,0,20,5,25,20,5,25,241,198,1,1,1,5.88636,0.238636,38.8295,108.649,88,0
India,259,242.378,7.15058,0.339768,244.568,7.12741,0.30888,286,V Sehwag,0,0,0,0,0,0,0,0,20,2,22,20,2,22,0,166,0,1,1,5.88636,0.238636,38.8295,108.649,88,0
India,259,242.378,7.15058,0.339768,244.568,7.12741,0.30888,286,SR Tendulkar,0,0,0,0,0,0,0,0,20,2,22,20,2,22,0,166,0,1,1,5.89773,0.363636,45.6023,84.5376,88,4
England,221,237.176,7.17647,0.289593,230.633,7.45701,0.384615,286,RS Bopara,0,0,0,0,0,0,0,0,12,6,18,12,6,18,167,178,1,0,1,2.22115,0.144231,25.1538,75.9361,104,4
England,221,237.176,7.17647,0.289593,230.633,7.45701,0.384615,286,IR Bell,0,0,0,0,0,0,0,0,12,6,18,12,6,18,167,178,1,0,1,3.63433,0.246269,35.3806,75.6623,134,4
England,221,237.176,7.17647,0.289593,230.633,7.45701,0.384615,286,OA Shah,0,0,0,0,0,0,0,0,12,6,18,12,6,18,167,178,1,0,1,3.13043,0.23913,32.6739,81.1994,46,4
England,221,237.176,7.17647,0.289593,230.633,7.45701,0.384615,287,RS Bopara,0,0,0,0,0,0,0,0,8,10,18,8,10,18,0,270,11,0,1,2.22115,0.144231,25.1538,75.9361,104,4
England,221,237.176,7.17647,0.289593,230.633,7.45701,0.384615,287,AN Cook,0,0,0,0,0,0,0,0,8,10,18,8,10,18,0,270,11,0,1,4.17045,0.272727,35.75,75.5524,88,4
India,259,242.378,7.15058,0.339768,244.568,7.12741,0.30888,287,V Sehwag,0,0,0,0,0,0,0,0,28,2,30,28,2,30,271,273,2,1,1,5.88636,0.238636,38.8295,108.649,88,0
India,259,242.378,7.15058,0.339768,244.568,7.12741,0.30888,287,SR Tendulkar,0,0,0,0,0,0,0,0,28,2,30,28,2,30,271,273,2,1,1,5.89773,0.363636,45.6023,84.5376,88,4
India,259,242.378,7.15058,0.339768,244.568,7.12741,0.30888,288,V Kohli,0,0,0,0,0,0,0,0,4,15,19,4,15,19,0,258,2,0,1,4.66456,0.379747,44.9937,88.3325,158,4
India,259,242.378,7.15058,0.339768,244.568,7.12741,0.30888,288,G Gambhir,0,0,0,0,0,0,0,0,4,15,19,4,15,19,0,258,2,0,1,3.99145,0.333333,37.4701,84.1944,117,4
Sri Lanka,244,223.373,7.09016,0.344262,227.578,7.47541,0.385246,288,ST Jayasuriya,0,0,0,0,0,0,0,0,16,5,21,16,5,21,259,212,3,1,1,4.91549,0.211268,33.9859,98.4898,71,0
Sri Lanka,244,223.373,7.09016,0.344262,227.578,7.47541,0.385246,288,SM Warnapura,0,0,0,0,0,0,0,0,16,5,21,16,5,21,259,212,3,1,1,2,0,15,46.875,2,3
New Zealand,184,233.745,7.39674,0.36413,227.951,7.30435,0.353261,289,JD Ryder,0,0,0,0,0,0,0,0,8,4,12,8,4,12,0,270,5,1,1,4.88571,0.257143,34.4,97.2536,35,0
New Zealand,184,233.745,7.39674,0.36413,227.951,7.30435,0.353261,289,BB McCullum,0,0,0,0,0,0,0,0,8,4,12,8,4,12,0,270,5,1,1,3.98611,0.201389,29.9028,98.4004,144,0
India,259,242.378,7.15058,0.339768,244.568,7.12741,0.30888,289,G Gambhir,0,0,0,0,0,0,0,0,22,14,36,22,14,36,271,201,3,0,1,3.99145,0.333333,37.4701,84.1944,117,4
India,259,242.378,7.15058,0.339768,244.568,7.12741,0.30888,289,V Sehwag,0,0,0,0,0,0,0,0,22,14,36,22,14,36,271,201,3,0,1,5.88636,0.238636,38.8295,108.649,88,0
India,259,242.378,7.15058,0.339768,244.568,7.12741,0.30888,290,G Gambhir,0,0,0,0,0,0,0,0,16,9,25,16,9,25,0,149,6,0,1,3.99145,0.333333,37.4701,84.1944,117,4
India,259,242.378,7.15058,0.339768,244.568,7.12741,0.30888,290,V Sehwag,0,0,0,0,0,0,0,0,16,9,25,16,9,25,0,149,6,0,1,5.88636,0.238636,38.8295,108.649,88,0
India,259,242.378,7.15058,0.339768,244.568,7.12741,0.30888,290,SK Raina,0,0,0,0,0,0,0,0,16,9,25,16,9,25,0,149,6,0,1,3.11111,0.216374,28.9064,91.8944,171,0
New Zealand,184,233.745,7.39674,0.36413,227.951,7.30435,0.353261,290,JD Ryder,0,0,0,0,0,0,0,0,8,8,16,8,8,16,150,151,0,1,1,4.88571,0.257143,34.4,97.2536,35,0
New Zealand,184,233.745,7.39674,0.36413,227.951,7.30435,0.353261,290,BB McCullum,0,0,0,0,0,0,0,0,8,8,16,8,8,16,150,151,0,1,1,3.98611,0.201389,29.9028,98.4004,144,0
New Zealand,184,233.745,7.39674,0.36413,227.951,7.30435,0.353261,290,MJ Guptill,0,0,0,0,0,0,0,0,8,8,16,8,8,16,150,151,0,1,1,4.8087,0.313043,38.1217,82.7482,115,4
India,259,242.378,7.15058,0.339768,244.568,7.12741,0.30888,291,V Sehwag,0,0,0,0,0,0,0,0,12,13,25,12,13,25,0,392,4,0,1,5.88636,0.238636,38.8295,108.649,88,0
India,259,242.378,7.15058,0.339768,244.568,7.12741,0.30888,291,SR Tendulkar,0,0,0,0,0,0,0,0,12,13,25,12,13,25,0,392,4,0,1,5.89773,0.363636,45.6023,84.5376,88,4
India,259,242.378,7.15058,0.339768,244.568,7.12741,0.30888,291,G Gambhir,0,0,0,0,0,0,0,0,12,13,25,12,13,25,0,392,4,0,1,3.99145,0.333333,37.4701,84.1944,117,4
New Zealand,184,233.745,7.39674,0.36413,227.951,7.30435,0.353261,291,JD Ryder,0,0,0,0,0,0,0,0,28,6,34,28,6,34,393,334,0,1,1,4.88571,0.257143,34.4,97.2536,35,0
New Zealand,184,233.745,7.39674,0.36413,227.951,7.30435,0.353261,291,BB McCullum,0,0,0,0,0,0,0,0,28,6,34,28,6,34,393,334,0,1,1,3.98611,0.201389,29.9028,98.4004,144,0
West Indies,176,217.33,7.15909,0.3125,225.278,7.57386,0.380682,292,CH Gayle,0,0,0,0,0,0,0,0,12,5,17,12,5,17,0,128,2,0,1,4.58621,0.206897,31.1293,89.4255,116,4
West Indies,176,217.33,7.15909,0.3125,225.278,7.57386,0.380682,292,XM Marshall,0,0,0,0,0,0,0,0,12,5,17,12,5,17,0,128,2,0,1,1.5,0,10.5,58.3333,8,3
West Indies,176,217.33,7.15909,0.3125,225.278,7.57386,0.380682,292,RR Sarwan,0,0,0,0,0,0,0,0,12,5,17,12,5,17,0,128,2,0,1,2.8254,0.222222,29.1429,69.1005,63,4
New Zealand,184,233.745,7.39674,0.36413,227.951,7.30435,0.353261,292,JD Ryder,0,0,0,0,0,0,0,0,16,15,31,16,15,31,129,129,1,1,1,4.88571,0.257143,34.4,97.2536,35,0
New Zealand,184,233.745,7.39674,0.36413,227.951,7.30435,0.353261,292,BB McCullum,0,0,0,0,0,0,0,0,16,15,31,16,15,31,129,129,1,1,1,3.98611,0.201389,29.9028,98.4004,144,0
West Indies,176,217.33,7.15909,0.3125,225.278,7.57386,0.380682,293,CH Gayle,0,0,0,0,0,0,0,0,4,5,9,4,5,9,0,294,2,0,1,4.58621,0.206897,31.1293,89.4255,116,4
West Indies,176,217.33,7.15909,0.3125,225.278,7.57386,0.380682,293,S Chattergoon,0,0,0,0,0,0,0,0,4,5,9,4,5,9,0,294,2,0,1,4.66667,0.166667,27.8333,60.9489,6,4
Pakistan,211,222.621,7.38389,0.393365,235.517,7.54976,0.336493,293,Salman Butt,0,0,0,0,0,0,0,0,8,6,14,8,6,14,295,295,8,0,1,5.4359,0.384615,42.3846,78.8645,39,4
Pakistan,211,222.621,7.38389,0.393365,235.517,7.54976,0.336493,293,Khurram Manzoor,0,0,0,0,0,0,0,0,8,6,14,8,6,14,295,295,8,0,1,3.33333,0.5,33.6667,62.5387,6,4
Pakistan,211,222.621,7.38389,0.393365,235.517,7.54976,0.336493,294,Salman Butt,0,0,0,0,0,0,0,0,0,13,13,0,13,13,0,232,0,0,1,5.4359,0.384615,42.3846,78.8645,39,4
Pakistan,211,222.621,7.38389,0.393365,235.517,7.54976,0.336493,294,Khurram Manzoor,0,0,0,0,0,0,0,0,0,13,13,0,13,13,0,232,0,0,1,3.33333,0.5,33.6667,62.5387,6,4
Pakistan,211,222.621,7.38389,0.393365,235.517,7.54976,0.336493,294,Misbah-ul-Haq,0,0,0,0,0,0,0,0,0,13,13,0,13,13,0,232,0,0,1,2.95238,0.285714,34.9921,71.8195,126,4
Pakistan,211,222.621,7.38389,0.393365,235.517,7.54976,0.336493,294,Younis Khan,0,0,0,0,0,0,0,0,0,13,13,0,13,13,0,232,0,0,1,2.64655,0.215517,28.5,73.2713,116,4
West Indies,176,217.33,7.15909,0.3125,225.278,7.57386,0.380682,294,CH Gayle,0,0,0,0,0,0,0,0,4,2,6,4,2,6,233,208,8,0,1,4.58621,0.206897,31.1293,89.4255,116,4
West Indies,176,217.33,7.15909,0.3125,225.278,7.57386,0.380682,294,S Chattergoon,0,0,0,0,0,0,0,0,4,2,6,4,2,6,233,208,8,0,1,4.66667,0.166667,27.8333,60.9489,6,4
West Indies,176,217.33,7.15909,0.3125,225.278,7.57386,0.380682,294,RR Sarwan,0,0,0,0,0,0,0,0,4,2,6,4,2,6,233,208,8,0,1,2.8254,0.222222,29.1429,69.1005,63,4
West Indies,176,217.33,7.15909,0.3125,225.278,7.57386,0.380682,294,S Chanderpaul,0,0,0,0,0,0,0,0,4,2,6,4,2,6,233,208,8,0,1,3.57143,0.396825,40.8254,68.0783,63,4
Zimbabwe,142,212.077,7.5,0.380282,227.704,6.97887,0.316901,295,H Masakadza,0,0,0,0,0,0,0,0,4,1,5,4,1,5,0,127,8,1,1,3.11215,0.186916,26.972,70.0485,107,4
Zimbabwe,142,212.077,7.5,0.380282,227.704,6.97887,0.316901,295,V Sibanda,0,0,0,0,0,0,0,0,4,1,5,4,1,5,0,127,8,1,1,2.9697,0.181818,23.5152,63.5545,66,1
Sri Lanka,244,223.373,7.09016,0.344262,227.578,7.47541,0.385246,295,WU Tharanga,0,0,0,0,0,0,0,0,6,11,17,6,11,17,128,130,2,0,1,3.93985,0.263158,32.9699,71.6035,133,4
Sri Lanka,244,223.373,7.09016,0.344262,227.578,7.47541,0.385246,295,ML Udawatte,0,0,0,0,0,0,0,0,6,11,17,6,11,17,128,130,2,0,1,2.33333,0,17.1667,62.0482,6,1
Sri Lanka,244,223.373,7.09016,0.344262,227.578,7.47541,0.385246,295,KC Sangakkara,0,0,0,0,0,0,0,0,6,11,17,6,11,17,128,130,2,0,1,4.33659,0.360976,41.9854,80.6276,205,4
Zimbabwe,142,212.077,7.5,0.380282,227.704,6.97887,0.316901,296,H Masakadza,0,0,0,0,0,0,0,0,8,5,13,8,5,13,0,67,6,1,1,3.11215,0.186916,26.972,70.0485,107,4
Zimbabwe,142,212.077,7.5,0.380282,227.704,6.97887,0.316901,296,V Sibanda,0,0,0,0,0,0,0,0,8,5,13,8,5,13,0,67,6,1,1,2.9697,0.181818,23.5152,63.5545,66,1
Zimbabwe,142,212.077,7.5,0.380282,227.704,6.97887,0.316901,296,CJ Chibhabha,0,0,0,0,0,0,0,0,8,5,13,8,5,13,0,67,6,1,1,2.56716,0.149254,23.5373,64.7373,67,1
Sri Lanka,244,223.373,7.09016,0.344262,227.578,7.47541,0.385246,296,WU Tharanga,0,0,0,0,0,0,0,0,4,6,10,4,6,10,68,68,3,0,1,3.93985,0.263158,32.9699,71.6035,133,4
Sri Lanka,244,223.373,7.09016,0.344262,227.578,7.47541,0.385246,296,ML Udawatte,0,0,0,0,0,0,0,0,4,6,10,4,6,10,68,68,3,0,1,2.33333,0,17.1667,62.0482,6,1
Sri Lanka,244,223.373,7.09016,0.344262,227.578,7.47541,0.385246,297,WU Tharanga,0,0,0,0,0,0,0,0,4,9,13,4,9,13,0,171,5,0,1,3.93985,0.263158,32.9699,71.6035,133,4
Sri Lanka,244,223.373,7.09016,0.344262,227.578,7.47541,0.385246,297,ML Udawatte,0,0,0,0,0,0,0,0,4,9,13,4,9,13,0,171,5,0,1,2.33333,0,17.1667,62.0482,6,1
Sri Lanka,244,223.373,7.09016,0.344262,227.578,7.47541,0.385246,297,KC Sangakkara,0,0,0,0,0,0,0,0,4,9,13,4,9,13,0,171,5,0,1,4.33659,0.360976,41.9854,80.6276,205,4
Zimbabwe,142,212.077,7.5,0.380282,227.704,6.97887,0.316901,297,H Masakadza,0,0,0,0,0,0,0,0,16,14,30,16,14,30,172,166,2,1,1,3.11215,0.186916,26.972,70.0485,107,4
Zimbabwe,142,212.077,7.5,0.380282,227.704,6.97887,0.316901,297,V Sibanda,0,0,0,0,0,0,0,0,16,14,30,16,14,30,172,166,2,1,1,2.9697,0.181818,23.5152,63.5545,66,1
India,259,242.378,7.15058,0.339768,244.568,7.12741,0.30888,298,KD Karthik,0,0,0,0,0,0,0,0,10,15,25,10,15,25,0,339,3,0,1,2.46429,0.107143,21.6786,71.8769,56,1
India,259,242.378,7.15058,0.339768,244.568,7.12741,0.30888,298,G Gambhir,0,0,0,0,0,0,0,0,10,15,25,10,15,25,0,339,3,0,1,3.99145,0.333333,37.4701,84.1944,117,4
India,259,242.378,7.15058,0.339768,244.568,7.12741,0.30888,298,RG Sharma,0,0,0,0,0,0,0,0,10,15,25,10,15,25,0,339,3,0,1,3.82836,0.268657,35.9179,83.083,134,4
West Indies,176,217.33,7.15909,0.3125,225.278,7.57386,0.380682,298,CH Gayle,0,0,0,0,0,0,0,0,22,9,31,22,9,31,340,319,3,1,1,4.58621,0.206897,31.1293,89.4255,116,4
West Indies,176,217.33,7.15909,0.3125,225.278,7.57386,0.380682,298,RS Morton,0,0,0,0,0,0,0,0,22,9,31,22,9,31,340,319,3,1,1,2.2963,0.222222,28.8889,67.0103,27,4
India,259,242.378,7.15058,0.339768,244.568,7.12741,0.30888,299,KD Karthik,0,0,0,0,0,0,0,0,4,7,11,4,7,11,0,188,2,0,1,2.46429,0.107143,21.6786,71.8769,56,1
India,259,242.378,7.15058,0.339768,244.568,7.12741,0.30888,299,RG Sharma,0,0,0,0,0,0,0,0,4,7,11,4,7,11,0,188,2,0,1,3.82836,0.268657,35.9179,83.083,134,4
India,259,242.378,7.15058,0.339768,244.568,7.12741,0.30888,299,G Gambhir,0,0,0,0,0,0,0,0,4,7,11,4,7,11,0,188,2,0,1,3.99145,0.333333,37.4701,84.1944,117,4
India,259,242.378,7.15058,0.339768,244.568,7.12741,0.30888,299,Yuvraj Singh,0,0,0,0,0,0,0,0,4,7,11,4,7,11,0,188,2,0,1,4.05833,0.258333,32.525,83.8093,120,4
India,259,242.378,7.15058,0.339768,244.568,7.12741,0.30888,299,MS Dhoni,0,0,0,0,0,0,0,0,4,7,11,4,7,11,0,188,2,0,1,3.47872,0.292553,36.7713,84.1612,188,4
West Indies,176,217.33,7.15909,0.3125,225.278,7.57386,0.380682,299,CH Gayle,0,0,0,0,0,0,0,0,12,7,19,12,7,19,189,192,4,1,1,4.58621,0.206897,31.1293,89.4255,116,4
West Indies,176,217.33,7.15909,0.3125,225.278,7.57386,0.380682,299,RS Morton,0,0,0,0,0,0,0,0,12,7,19,12,7,19,189,192,4,1,1,2.2963,0.222222,28.8889,67.0103,27,4
West Indies,176,217.33,7.15909,0.3125,225.278,7.57386,0.380682,300,CH Gayle,0,0,0,0,0,0,0,0,28,9,37,28,9,37,0,186,0,1,1,4.58621,0.206897,31.1293,89.4255,116,4
West Indies,176,217.33,7.15909,0.3125,225.278,7.57386,0.380682,300,RS Morton,0,0,0,0,0,0,0,0,28,9,37,28,9,37,0,186,0,1,1,2.2963,0.222222,28.8889,67.0103,27,4
West Indies,176,217.33,7.15909,0.3125,225.278,7.57386,0.380682,300,RR Sarwan,0,0,0,0,0,0,0,0,28,9,37,28,9,37,0,186,0,1,1,2.8254,0.222222,29.1429,69.1005,63,4
India,259,242.378,7.15058,0.339768,244.568,7.12741,0.30888,300,KD Karthik,0,0,0,0,0,0,0,0,20,13,33,20,13,33,187,159,3,0,1,2.46429,0.107143,21.6786,71.8769,56,1
India,259,242.378,7.15058,0.339768,244.568,7.12741,0.30888,300,G Gambhir,0,0,0,0,0,0,0,0,20,13,33,20,13,33,187,159,3,0,1,3.99145,0.333333,37.4701,84.1944,117,4
Zimbabwe,142,212.077,7.5,0.380282,227.704,6.97887,0.316901,301,H Masakadza,0,0,0,0,0,0,0,0,16,7,23,16,7,23,0,205,1,0,1,3.11215,0.186916,26.972,70.0485,107,4
Zimbabwe,142,212.077,7.5,0.380282,227.704,6.97887,0.316901,301,V Sibanda,0,0,0,0,0,0,0,0,16,7,23,16,7,23,0,205,1,0,1,2.9697,0.181818,23.5152,63.5545,66,1
Zimbabwe,142,212.077,7.5,0.380282,227.704,6.97887,0.316901,301,S Matsikenyeri,0,0,0,0,0,0,0,0,16,7,23,16,7,23,0,205,1,0,1,2,0.106383,19.9787,75.7869,47,1
Bangladesh,160,218.438,7.70625,0.4,211.106,7.05,0.325,301,Tamim Iqbal,0,0,0,0,0,0,0,0,8,2,10,8,2,10,206,167,1,1,1,4.05344,0.274809,31.8015,76.8068,131,4
Bangladesh,160,218.438,7.70625,0.4,211.106,7.05,0.325,301,Junaid Siddique,0,0,0,0,0,0,0,0,8,2,10,8,2,10,206,167,1,1,1,2.16279,0.116279,20.0233,68.225,43,1
Bangladesh,160,218.438,7.70625,0.4,211.106,7.05,0.325,301,Mushfiqur Rahim,0,0,0,0,0,0,0,0,8,2,10,8,2,10,206,167,1,1,1,2.61111,0.18254,27.7778,75.2526,126,4
Bangladesh,160,218.438,7.70625,0.4,211.106,7.05,0.325,301,Mohammad Ashraful,0,0,0,0,0,0,0,0,8,2,10,8,2,10,206,167,1,1,1,2.17722,0.113924,19.4557,63.9085,79,1
Sri Lanka,244,223.373,7.09016,0.344262,227.578,7.47541,0.385246,302,WU Tharanga,0,0,0,0,0,0,0,0,8,7,15,8,7,15,0,147,1,0,1,3.93985,0.263158,32.9699,71.6035,133,4
Sri Lanka,244,223.373,7.09016,0.344262,227.578,7.47541,0.385246,302,KC Sangakkara,0,0,0,0,0,0,0,0,8,7,15,8,7,15,0,147,1,0,1,4.33659,0.360976,41.9854,80.6276,205,4
Sri Lanka,244,223.373,7.09016,0.344262,227.578,7.47541,0.385246,302,ST Jayasuriya,0,0,0,0,0,0,0,0,8,7,15,8,7,15,0,147,1,0,1,4.91549,0.211268,33.9859,98.4898,71,0
Sri Lanka,244,223.373,7.09016,0.344262,227.578,7.47541,0.385246,302,DPMD Jayawardene,0,0,0,0,0,0,0,0,8,7,15,8,7,15,0,147,1,0,1,3.20833,0.244792,31.6979,79.1109,192,4
Bangladesh,160,218.438,7.70625,0.4,211.106,7.05,0.325,302,Tamim Iqbal,0,0,0,0,0,0,0,0,12,6,18,12,6,18,148,151,1,1,1,4.05344,0.274809,31.8015,76.8068,131,4
Bangladesh,160,218.438,7.70625,0.4,211.106,7.05,0.325,302,Mushfiqur Rahim,0,0,0,0,0,0,0,0,12,6,18,12,6,18,148,151,1,1,1,2.61111,0.18254,27.7778,75.2526,126,4
Bangladesh,160,218.438,7.70625,0.4,211.106,7.05,0.325,302,Mohammad Ashraful,0,0,0,0,0,0,0,0,12,6,18,12,6,18,148,151,1,1,1,2.17722,0.113924,19.4557,63.9085,79,1
Bangladesh,160,218.438,7.70625,0.4,211.106,7.05,0.325,302,Shakib Al Hasan,0,0,0,0,0,0,0,0,12,6,18,12,6,18,148,151,1,1,1,2.86992,0.252033,29.9106,79.0163,123,4
Zimbabwe,142,212.077,7.5,0.380282,227.704,6.97887,0.316901,303,V Sibanda,0,0,0,0,0,0,0,0,12,6,18,12,6,18,0,119,1,0,1,2.9697,0.181818,23.5152,63.5545,66,1
Zimbabwe,142,212.077,7.5,0.380282,227.704,6.97887,0.316901,303,S Matsikenyeri,0,0,0,0,0,0,0,0,12,6,18,12,6,18,0,119,1,0,1,2,0.106383,19.9787,75.7869,47,1
Zimbabwe,142,212.077,7.5,0.380282,227.704,6.97887,0.316901,303,H Masakadza,0,0,0,0,0,0,0,0,12,6,18,12,6,18,0,119,1,0,1,3.11215,0.186916,26.972,70.0485,107,4
Zimbabwe,142,212.077,7.5,0.380282,227.704,6.97887,0.316901,303,T Taibu,0,0,0,0,0,0,0,0,12,6,18,12,6,18,0,119,1,0,1,2.36364,0.254545,29.4,71.0145,55,4
Bangladesh,160,218.438,7.70625,0.4,211.106,7.05,0.325,303,Tamim Iqbal,0,0,0,0,0,0,0,0,4,4,8,4,4,8,120,121,10,1,1,4.05344,0.274809,31.8015,76.8068,131,4
Bangladesh,160,218.438,7.70625,0.4,211.106,7.05,0.325,303,Mehrab Hossain jnr,0,0,0,0,0,0,0,0,4,4,8,4,4,8,120,121,10,1,1,1.7,0.1,18.3,42.4594,10,3
West Indies,176,217.33,7.15909,0.3125,225.278,7.57386,0.380682,304,CH Gayle,0,0,0,0,0,0,0,0,4,6,10,4,6,10,0,160,5,0,1,4.58621,0.206897,31.1293,89.4255,116,4
West Indies,176,217.33,7.15909,0.3125,225.278,7.57386,0.380682,304,LMP Simmons,0,0,0,0,0,0,0,0,4,6,10,4,6,10,0,160,5,0,1,3.3125,0.28125,30.5938,71.4338,64,4
West Indies,176,217.33,7.15909,0.3125,225.278,7.57386,0.380682,304,RR Sarwan,0,0,0,0,0,0,0,0,4,6,10,4,6,10,0,160,5,0,1,2.8254,0.222222,29.1429,69.1005,63,4
West Indies,176,217.33,7.15909,0.3125,225.278,7.57386,0.380682,304,S Chanderpaul,0,0,0,0,0,0,0,0,4,6,10,4,6,10,0,160,5,0,1,3.57143,0.396825,40.8254,68.0783,63,4
England,221,237.176,7.17647,0.289593,230.633,7.45701,0.384615,304,AJ Strauss,0,0,0,0,0,0,0,0,4,7,11,4,7,11,161,161,11,1,1,3.93243,0.27027,33.9054,79.8028,74,4
England,221,237.176,7.17647,0.289593,230.633,7.45701,0.384615,304,RS Bopara,0,0,0,0,0,0,0,0,4,7,11,4,7,11,161,161,11,1,1,2.22115,0.144231,25.1538,75.9361,104,4
England,221,237.176,7.17647,0.289593,230.633,7.45701,0.384615,305,AJ Strauss,0,0,0,0,0,0,0,0,4,10,14,4,10,14,0,328,5,1,1,3.93243,0.27027,33.9054,79.8028,74,4
England,221,237.176,7.17647,0.289593,230.633,7.45701,0.384615,305,RS Bopara,0,0,0,0,0,0,0,0,4,10,14,4,10,14,0,328,5,1,1,2.22115,0.144231,25.1538,75.9361,104,4
West Indies,176,217.33,7.15909,0.3125,225.278,7.57386,0.380682,305,CH Gayle,0,0,0,0,0,0,0,0,20,8,28,20,8,28,329,270,1,0,1,4.58621,0.206897,31.1293,89.4255,116,4
West Indies,176,217.33,7.15909,0.3125,225.278,7.57386,0.380682,305,RS Morton,0,0,0,0,0,0,0,0,20,8,28,20,8,28,329,270,1,0,1,2.2963,0.222222,28.8889,67.0103,27,4
West Indies,176,217.33,7.15909,0.3125,225.278,7.57386,0.380682,305,RR Sarwan,0,0,0,0,0,0,0,0,20,8,28,20,8,28,329,270,1,0,1,2.8254,0.222222,29.1429,69.1005,63,4
West Indies,176,217.33,7.15909,0.3125,225.278,7.57386,0.380682,305,S Chanderpaul,0,0,0,0,0,0,0,0,20,8,28,20,8,28,329,270,1,0,1,3.57143,0.396825,40.8254,68.0783,63,4
England,221,237.176,7.17647,0.289593,230.633,7.45701,0.384615,306,RS Bopara,0,0,0,0,0,0,0,0,4,1,5,4,1,5,0,203,2,0,1,2.22115,0.144231,25.1538,75.9361,104,4
England,221,237.176,7.17647,0.289593,230.633,7.45701,0.384615,306,JL Denly,0,0,0,0,0,0,0,0,4,1,5,4,1,5,0,203,2,0,1,3.55556,0.222222,29.3333,63.1579,9,4
England,221,237.176,7.17647,0.289593,230.633,7.45701,0.384615,306,IJL Trott,0,0,0,0,0,0,0,0,4,1,5,4,1,5,0,203,2,0,1,3.3871,0.403226,43.7903,75.2494,62,4
England,221,237.176,7.17647,0.289593,230.633,7.45701,0.384615,306,MJ Prior,0,0,0,0,0,0,0,0,4,1,5,4,1,5,0,203,2,0,1,2.27083,0.0625,21.6875,76.4879,48,4
Ireland,55,219.527,7.65455,0.290909,202.727,7.56364,0.4,306,WTS Porterfield,0,0,0,0,0,0,0,0,16,13,29,16,13,29,204,112,4,1,1,2.6,0.142857,24.6857,56.2866,35,3
Ireland,55,219.527,7.65455,0.290909,202.727,7.56364,0.4,306,NJ O'Brien,0,0,0,0,0,0,0,0,16,13,29,16,13,29,204,112,4,1,1,2.55882,0.176471,25.5882,69.378,34,4
Ireland,55,219.527,7.65455,0.290909,202.727,7.56364,0.4,306,PR Stirling,0,0,0,0,0,0,0,0,16,13,29,16,13,29,204,112,4,1,1,3.47826,0.173913,24.2174,88.1329,23,0
Ireland,55,219.527,7.65455,0.290909,202.727,7.56364,0.4,306,AC Botha,0,0,0,0,0,0,0,0,16,13,29,16,13,29,204,112,4,1,1,1.25,0.0833333,14.3333,53.75,12,3
Sri Lanka,244,223.373,7.09016,0.344262,227.578,7.47541,0.385246,307,TM Dilshan,0,0,0,0,0,0,0,0,16,12,28,16,12,28,0,219,2,0,1,4.60199,0.273632,38.3632,86.0219,201,4
Sri Lanka,244,223.373,7.09016,0.344262,227.578,7.47541,0.385246,307,ST Jayasuriya,0,0,0,0,0,0,0,0,16,12,28,16,12,28,0,219,2,0,1,4.91549,0.211268,33.9859,98.4898,71,0
Pakistan,211,222.621,7.38389,0.393365,235.517,7.54976,0.336493,307,Khurram Manzoor,0,0,0,0,0,0,0,0,4,3,7,4,3,7,220,220,0,0,1,3.33333,0.5,33.6667,62.5387,6,4
Pakistan,211,222.621,7.38389,0.393365,235.517,7.54976,0.336493,307,Salman Butt,0,0,0,0,0,0,0,0,4,3,7,4,3,7,220,220,0,0,1,5.4359,0.384615,42.3846,78.8645,39,4
Sri Lanka,244,223.373,7.09016,0.344262,227.578,7.47541,0.385246,308,TM Dilshan,0,0,0,0,0,0,0,0,32,3,35,32,3,35,0,290,4,0,1,4.60199,0.273632,38.3632,86.0219,201,4
Sri Lanka,244,223.373,7.09016,0.344262,227.578,7.47541,0.385246,308,ST Jayasuriya,0,0,0,0,0,0,0,0,32,3,35,32,3,35,0,290,4,0,1,4.91549,0.211268,33.9859,98.4898,71,0
Pakistan,211,222.621,7.38389,0.393365,235.517,7.54976,0.336493,308,Khurram Manzoor,0,0,0,0,0,0,0,0,12,6,18,12,6,18,291,161,1,0,1,3.33333,0.5,33.6667,62.5387,6,4
Pakistan,211,222.621,7.38389,0.393365,235.517,7.54976,0.336493,308,Salman Butt,0,0,0,0,0,0,0,0,12,6,18,12,6,18,291,161,1,0,1,5.4359,0.384615,42.3846,78.8645,39,4
Pakistan,211,222.621,7.38389,0.393365,235.517,7.54976,0.336493,308,Younis Khan,0,0,0,0,0,0,0,0,12,6,18,12,6,18,291,161,1,0,1,2.64655,0.215517,28.5,73.2713,116,4
Pakistan,211,222.621,7.38389,0.393365,235.517,7.54976,0.336493,308,Misbah-ul-Haq,0,0,0,0,0,0,0,0,12,6,18,12,6,18,291,161,1,0,1,2.95238,0.285714,34.9921,71.8195,126,4
Pakistan,211,222.621,7.38389,0.393365,235.517,7.54976,0.336493,308,Shoaib Malik,0,0,0,0,0,0,0,0,12,6,18,12,6,18,291,161,1,0,1,2.77551,0.193878,28.7041,81.4418,98,4
Sri Lanka,244,223.373,7.09016,0.344262,227.578,7.47541,0.385246,309,TM Dilshan,0,0,0,0,0,0,0,0,8,6,14,8,6,14,0,309,0,0,1,4.60199,0.273632,38.3632,86.0219,201,4
Sri Lanka,244,223.373,7.09016,0.344262,227.578,7.47541,0.385246,309,ST Jayasuriya,0,0,0,0,0,0,0,0,8,6,14,8,6,14,0,309,0,0,1,4.91549,0.211268,33.9859,98.4898,71,0
Pakistan,211,222.621,7.38389,0.393365,235.517,7.54976,0.336493,309,Khurram Manzoor,0,0,0,0,0,0,0,0,4,6,10,4,6,10,310,75,1,1,1,3.33333,0.5,33.6667,62.5387,6,4
Pakistan,211,222.621,7.38389,0.393365,235.517,7.54976,0.336493,309,Younis Khan,0,0,0,0,0,0,0,0,4,6,10,4,6,10,310,75,1,1,1,2.64655,0.215517,28.5,73.2713,116,4
Pakistan,211,222.621,7.38389,0.393365,235.517,7.54976,0.336493,309,Salman Butt,0,0,0,0,0,0,0,0,4,6,10,4,6,10,310,75,1,1,1,5.4359,0.384615,42.3846,78.8645,39,4
Pakistan,211,222.621,7.38389,0.393365,235.517,7.54976,0.336493,309,Kamran Akmal,0,0,0,0,0,0,0,0,4,6,10,4,6,10,310,75,1,1,1,3.01124,0.11236,23.0787,81.4433,89,4
Sri Lanka,244,223.373,7.09016,0.344262,227.578,7.47541,0.385246,310,TM Dilshan,0,0,0,0,0,0,0,0,8,4,12,8,4,12,0,246,0,1,1,4.60199,0.273632,38.3632,86.0219,201,4
Sri Lanka,244,223.373,7.09016,0.344262,227.578,7.47541,0.385246,310,KC Sangakkara,0,0,0,0,0,0,0,0,8,4,12,8,4,12,0,246,0,1,1,4.33659,0.360976,41.9854,80.6276,205,4
Sri Lanka,244,223.373,7.09016,0.344262,227.578,7.47541,0.385246,310,ST Jayasuriya,0,0,0,0,0,0,0,0,8,4,12,8,4,12,0,246,0,1,1,4.91549,0.211268,33.9859,98.4898,71,0
India,259,242.378,7.15058,0.339768,244.568,7.12741,0.30888,310,G Gambhir,0,0,0,0,0,0,0,0,4,14,18,4,14,18,247,247,1,0,1,3.99145,0.333333,37.4701,84.1944,117,4
India,259,242.378,7.15058,0.339768,244.568,7.12741,0.30888,310,SR Tendulkar,0,0,0,0,0,0,0,0,4,14,18,4,14,18,247,247,1,0,1,5.89773,0.363636,45.6023,84.5376,88,4
India,259,242.378,7.15058,0.339768,244.568,7.12741,0.30888,310,SK Raina,0,0,0,0,0,0,0,0,4,14,18,4,14,18,247,247,1,0,1,3.11111,0.216374,28.9064,91.8944,171,0
India,259,242.378,7.15058,0.339768,244.568,7.12741,0.30888,311,V Sehwag,0,0,0,0,0,0,0,0,16,11,27,16,11,27,0,256,2,0,1,5.88636,0.238636,38.8295,108.649,88,0
India,259,242.378,7.15058,0.339768,244.568,7.12741,0.30888,311,SR Tendulkar,0,0,0,0,0,0,0,0,16,11,27,16,11,27,0,256,2,0,1,5.89773,0.363636,45.6023,84.5376,88,4
India,259,242.378,7.15058,0.339768,244.568,7.12741,0.30888,311,G Gambhir,0,0,0,0,0,0,0,0,16,11,27,16,11,27,0,256,2,0,1,3.99145,0.333333,37.4701,84.1944,117,4
Sri Lanka,244,223.373,7.09016,0.344262,227.578,7.47541,0.385246,311,TM Dilshan,0,0,0,0,0,0,0,0,8,19,27,8,19,27,257,241,4,1,1,4.60199,0.273632,38.3632,86.0219,201,4
Sri Lanka,244,223.373,7.09016,0.344262,227.578,7.47541,0.385246,311,ST Jayasuriya,0,0,0,0,0,0,0,0,8,19,27,8,19,27,257,241,4,1,1,4.91549,0.211268,33.9859,98.4898,71,0
Sri Lanka,244,223.373,7.09016,0.344262,227.578,7.47541,0.385246,311,KC Sangakkara,0,0,0,0,0,0,0,0,8,19,27,8,19,27,257,241,4,1,1,4.33659,0.360976,41.9854,80.6276,205,4
India,259,242.378,7.15058,0.339768,244.568,7.12741,0.30888,312,V Sehwag,0,0,0,0,0,0,0,0,18,7,25,18,7,25,0,363,3,0,1,5.88636,0.238636,38.8295,108.649,88,0
India,259,242.378,7.15058,0.339768,244.568,7.12741,0.30888,312,SR Tendulkar,0,0,0,0,0,0,0,0,18,7,25,18,7,25,0,363,3,0,1,5.89773,0.363636,45.6023,84.5376,88,4
India,259,242.378,7.15058,0.339768,244.568,7.12741,0.30888,312,G Gambhir,0,0,0,0,0,0,0,0,18,7,25,18,7,25,0,363,3,0,1,3.99145,0.333333,37.4701,84.1944,117,4
India,259,242.378,7.15058,0.339768,244.568,7.12741,0.30888,312,Yuvraj Singh,0,0,0,0,0,0,0,0,18,7,25,18,7,25,0,363,3,0,1,4.05833,0.258333,32.525,83.8093,120,4
Sri Lanka,244,223.373,7.09016,0.344262,227.578,7.47541,0.385246,312,TM Dilshan,0,0,0,0,0,0,0,0,12,13,25,12,13,25,364,216,3,1,1,4.60199,0.273632,38.3632,86.0219,201,4
Sri Lanka,244,223.373,7.09016,0.344262,227.578,7.47541,0.385246,312,ST Jayasuriya,0,0,0,0,0,0,0,0,12,13,25,12,13,25,364,216,3,1,1,4.91549,0.211268,33.9859,98.4898,71,0
Sri Lanka,244,223.373,7.09016,0.344262,227.578,7.47541,0.385246,312,KC Sangakkara,0,0,0,0,0,0,0,0,12,13,25,12,13,25,364,216,3,1,1,4.33659,0.360976,41.9854,80.6276,205,4
India,259,242.378,7.15058,0.339768,244.568,7.12741,0.30888,313,V Sehwag,0,0,0,0,0,0,0,0,8,9,17,8,9,17,0,332,6,0,1,5.88636,0.238636,38.8295,108.649,88,0
India,259,242.378,7.15058,0.339768,244.568,7.12741,0.30888,313,G Gambhir,0,0,0,0,0,0,0,0,8,9,17,8,9,17,0,332,6,0,1,3.99145,0.333333,37.4701,84.1944,117,4
India,259,242.378,7.15058,0.339768,244.568,7.12741,0.30888,313,MS Dhoni,0,0,0,0,0,0,0,0,8,9,17,8,9,17,0,332,6,0,1,3.47872,0.292553,36.7713,84.1612,188,4
Sri Lanka,244,223.373,7.09016,0.344262,227.578,7.47541,0.385246,313,TM Dilshan,0,0,0,0,0,0,0,0,16,15,31,16,15,31,333,265,2,1,1,4.60199,0.273632,38.3632,86.0219,201,4
Sri Lanka,244,223.373,7.09016,0.344262,227.578,7.47541,0.385246,313,ST Jayasuriya,0,0,0,0,0,0,0,0,16,15,31,16,15,31,333,265,2,1,1,4.91549,0.211268,33.9859,98.4898,71,0
Sri Lanka,244,223.373,7.09016,0.344262,227.578,7.47541,0.385246,314,TM Dilshan,0,0,0,0,0,0,0,0,16,7,23,16,7,23,0,320,3,1,1,4.60199,0.273632,38.3632,86.0219,201,4
Sri Lanka,244,223.373,7.09016,0.344262,227.578,7.47541,0.385246,314,ST Jayasuriya,0,0,0,0,0,0,0,0,16,7,23,16,7,23,0,320,3,1,1,4.91549,0.211268,33.9859,98.4898,71,0
India,259,242.378,7.15058,0.339768,244.568,7.12741,0.30888,314,G Gambhir,0,0,0,0,0,0,0,0,12,8,20,12,8,20,321,252,2,0,1,3.99145,0.333333,37.4701,84.1944,117,4
India,259,242.378,7.15058,0.339768,244.568,7.12741,0.30888,314,V Sehwag,0,0,0,0,0,0,0,0,12,8,20,12,8,20,321,252,2,0,1,5.88636,0.238636,38.8295,108.649,88,0
India,259,242.378,7.15058,0.339768,244.568,7.12741,0.30888,314,SK Raina,0,0,0,0,0,0,0,0,12,8,20,12,8,20,321,252,2,0,1,3.11111,0.216374,28.9064,91.8944,171,0
India,259,242.378,7.15058,0.339768,244.568,7.12741,0.30888,314,Yuvraj Singh,0,0,0,0,0,0,0,0,12,8,20,12,8,20,321,252,2,0,1,4.05833,0.258333,32.525,83.8093,120,4
South Africa,190,234.274,7.4,0.373684,232.363,7.33158,0.342105,315,HM Amla,0,0,0,0,0,0,0,0,16,9,25,16,9,25,0,250,1,1,1,5.20168,0.403361,48.7899,86.9292,119,4
South Africa,190,234.274,7.4,0.373684,232.363,7.33158,0.342105,315,GC Smith,0,0,0,0,0,0,0,0,16,9,25,16,9,25,0,250,1,1,1,3.97,0.29,33.57,79.6819,100,4
England,221,237.176,7.17647,0.289593,230.633,7.45701,0.384615,315,IJL Trott,0,0,0,0,0,0,0,0,12,7,19,12,7,19,251,252,0,0,1,3.3871,0.403226,43.7903,75.2494,62,4
England,221,237.176,7.17647,0.289593,230.633,7.45701,0.384615,315,AJ Strauss,0,0,0,0,0,0,0,0,12,7,19,12,7,19,251,252,0,0,1,3.93243,0.27027,33.9054,79.8028,74,4
South Africa,190,234.274,7.4,0.373684,232.363,7.33158,0.342105,316,HM Amla,0,0,0,0,0,0,0,0,12,6,18,12,6,18,0,119,2,1,1,5.20168,0.403361,48.7899,86.9292,119,4
South Africa,190,234.274,7.4,0.373684,232.363,7.33158,0.342105,316,GC Smith,0,0,0,0,0,0,0,0,12,6,18,12,6,18,0,119,2,1,1,3.97,0.29,33.57,79.6819,100,4
South Africa,190,234.274,7.4,0.373684,232.363,7.33158,0.342105,316,AB de Villiers,0,0,0,0,0,0,0,0,12,6,18,12,6,18,0,119,2,1,1,5.04969,0.403727,47.2174,98.8428,161,4
England,221,237.176,7.17647,0.289593,230.633,7.45701,0.384615,316,IJL Trott,0,0,0,0,0,0,0,0,12,7,19,12,7,19,120,121,2,0,1,3.3871,0.403226,43.7903,75.2494,62,4
England,221,237.176,7.17647,0.289593,230.633,7.45701,0.384615,316,AJ Strauss,0,0,0,0,0,0,0,0,12,7,19,12,7,19,120,121,2,0,1,3.93243,0.27027,33.9054,79.8028,74,4
Australia,228,239.627,7.69737,0.372807,232.079,7.23246,0.337719,320,SE Marsh,0,0,0,0,0,0,0,0,4,9,13,4,9,13,0,168,2,0,1,3.66667,0.291667,35.5417,74.7918,48,4
Australia,228,239.627,7.69737,0.372807,232.079,7.23246,0.337719,320,BJ Haddin,0,0,0,0,0,0,0,0,4,9,13,4,9,13,0,168,2,0,1,3.14737,0.147368,26.7789,81.382,95,4
Pakistan,211,222.621,7.38389,0.393365,235.517,7.54976,0.336493,320,Salman Butt,0,0,0,0,0,0,0,0,8,3,11,8,3,11,169,171,0,0,1,5.4359,0.384615,42.3846,78.8645,39,4
Pakistan,211,222.621,7.38389,0.393365,235.517,7.54976,0.336493,320,Younis Khan,0,0,0,0,0,0,0,0,8,3,11,8,3,11,169,171,0,0,1,2.64655,0.215517,28.5,73.2713,116,4
Pakistan,211,222.621,7.38389,0.393365,235.517,7.54976,0.336493,320,Kamran Akmal,0,0,0,0,0,0,0,0,8,3,11,8,3,11,169,171,0,0,1,3.01124,0.11236,23.0787,81.4433,89,4
Pakistan,211,222.621,7.38389,0.393365,235.517,7.54976,0.336493,321,Salman Butt,0,0,0,0,0,0,0,0,8,4,12,8,4,12,0,207,1,0,1,5.4359,0.384615,42.3846,78.8645,39,4
Pakistan,211,222.621,7.38389,0.393365,235.517,7.54976,0.336493,321,Ahmed Shehzad,0,0,0,0,0,0,0,0,8,4,12,8,4,12,0,207,1,0,1,3.67143,0.242857,33.2714,70.8118,70,4
Pakistan,211,222.621,7.38389,0.393365,235.517,7.54976,0.336493,321,Younis Khan,0,0,0,0,0,0,0,0,8,4,12,8,4,12,0,207,1,0,1,2.64655,0.215517,28.5,73.2713,116,4
Australia,228,239.627,7.69737,0.372807,232.079,7.23246,0.337719,321,BJ Haddin,0,0,0,0,0,0,0,0,4,12,16,4,12,16,208,208,3,0,1,3.14737,0.147368,26.7789,81.382,95,4
Australia,228,239.627,7.69737,0.372807,232.079,7.23246,0.337719,321,JR Hopes,0,0,0,0,0,0,0,0,4,12,16,4,12,16,208,208,3,0,1,2.09259,0.0555556,21.2778,91.4809,54,0
Australia,228,239.627,7.69737,0.372807,232.079,7.23246,0.337719,321,SR Watson,0,0,0,0,0,0,0,0,4,12,16,4,12,16,208,208,3,0,1,4.71318,0.286822,37.7907,90.0943,129,4
Australia,228,239.627,7.69737,0.372807,232.079,7.23246,0.337719,322,JR Hopes,0,0,0,0,0,0,0,0,20,7,27,20,7,27,0,198,1,0,1,2.09259,0.0555556,21.2778,91.4809,54,0
Australia,228,239.627,7.69737,0.372807,232.079,7.23246,0.337719,322,BJ Haddin,0,0,0,0,0,0,0,0,20,7,27,20,7,27,0,198,1,0,1,3.14737,0.147368,26.7789,81.382,95,4
Pakistan,211,222.621,7.38389,0.393365,235.517,7.54976,0.336493,322,Salman Butt,0,0,0,0,0,0,0,0,8,8,16,8,8,16,199,171,6,0,1,5.4359,0.384615,42.3846,78.8645,39,4
Pakistan,211,222.621,7.38389,0.393365,235.517,7.54976,0.336493,322,Ahmed Shehzad,0,0,0,0,0,0,0,0,8,8,16,8,8,16,199,171,6,0,1,3.67143,0.242857,33.2714,70.8118,70,4
Pakistan,211,222.621,7.38389,0.393365,235.517,7.54976,0.336493,323,Salman Butt,0,0,0,0,0,0,0,0,8,9,17,8,9,17,0,197,1,0,1,5.4359,0.384615,42.3846,78.8645,39,4
Pakistan,211,222.621,7.38389,0.393365,235.517,7.54976,0.336493,323,Younis Khan,0,0,0,0,0,0,0,0,8,9,17,8,9,17,0,197,1,0,1,2.64655,0.215517,28.5,73.2713,116,4
Pakistan,211,222.621,7.38389,0.393365,235.517,7.54976,0.336493,323,Ahmed Shehzad,0,0,0,0,0,0,0,0,8,9,17,8,9,17,0,197,1,0,1,3.67143,0.242857,33.2714,70.8118,70,4
Pakistan,211,222.621,7.38389,0.393365,235.517,7.54976,0.336493,323,Misbah-ul-Haq,0,0,0,0,0,0,0,0,8,9,17,8,9,17,0,197,1,0,1,2.95238,0.285714,34.9921,71.8195,126,4
Australia,228,239.627,7.69737,0.372807,232.079,7.23246,0.337719,323,SR Watson,0,0,0,0,0,0,0,0,8,10,18,8,10,18,198,200,0,0,1,4.71318,0.286822,37.7907,90.0943,129,4
Australia,228,239.627,7.69737,0.372807,232.079,7.23246,0.337719,323,BJ Haddin,0,0,0,0,0,0,0,0,8,10,18,8,10,18,198,200,0,0,1,3.14737,0.147368,26.7789,81.382,95,4
Australia,228,239.627,7.69737,0.372807,232.079,7.23246,0.337719,323,MJ Clarke,0,0,0,0,0,0,0,0,8,10,18,8,10,18,198,200,0,0,1,3.10294,0.301471,35.9265,74.0303,136,4
Australia,228,239.627,7.69737,0.372807,232.079,7.23246,0.337719,324,SR Watson,0,0,0,0,0,0,0,0,12,11,23,12,11,23,0,250,1,0,1,4.71318,0.286822,37.7907,90.0943,129,4
Australia,228,239.627,7.69737,0.372807,232.079,7.23246,0.337719,324,BJ Haddin,0,0,0,0,0,0,0,0,12,11,23,12,11,23,0,250,1,0,1,3.14737,0.147368,26.7789,81.382,95,4
Pakistan,211,222.621,7.38389,0.393365,235.517,7.54976,0.336493,324,Ahmed Shehzad,0,0,0,0,0,0,0,0,0,4,4,0,4,4,251,254,4,0,1,3.67143,0.242857,33.2714,70.8118,70,4
Pakistan,211,222.621,7.38389,0.393365,235.517,7.54976,0.336493,324,Younis Khan,0,0,0,0,0,0,0,0,0,4,4,0,4,4,251,254,4,0,1,2.64655,0.215517,28.5,73.2713,116,4
West Indies,176,217.33,7.15909,0.3125,225.278,7.57386,0.380682,325,DM Richards,0,0,0,0,0,0,0,0,16,16,32,16,16,32,0,274,1,1,1,3.42857,0.285714,25.5714,68.8462,7,4
West Indies,176,217.33,7.15909,0.3125,225.278,7.57386,0.380682,325,ADS Fletcher,0,0,0,0,0,0,0,0,16,16,32,16,16,32,0,274,1,1,1,1.8125,0.125,13.5,62.6087,16,1
Bangladesh,160,218.438,7.70625,0.4,211.106,7.05,0.325,325,Tamim Iqbal,0,0,0,0,0,0,0,0,8,12,20,8,12,20,275,276,0,0,1,4.05344,0.274809,31.8015,76.8068,131,4
Bangladesh,160,218.438,7.70625,0.4,211.106,7.05,0.325,325,Junaid Siddique,0,0,0,0,0,0,0,0,8,12,20,8,12,20,275,276,0,0,1,2.16279,0.116279,20.0233,68.225,43,1
West Indies,176,217.33,7.15909,0.3125,225.278,7.57386,0.380682,326,KOA Powell,0,0,0,0,0,0,0,0,24,3,27,24,3,27,0,248,3,1,1,3.59259,0.222222,26.4815,80.6088,27,4
West Indies,176,217.33,7.15909,0.3125,225.278,7.57386,0.380682,326,DS Smith,0,0,0,0,0,0,0,0,24,3,27,24,3,27,0,248,3,1,1,2.61765,0.147059,23.5588,71.2,34,4
West Indies,176,217.33,7.15909,0.3125,225.278,7.57386,0.380682,326,ADS Fletcher,0,0,0,0,0,0,0,0,24,3,27,24,3,27,0,248,3,1,1,1.8125,0.125,13.5,62.6087,16,1
West Indies,176,217.33,7.15909,0.3125,225.278,7.57386,0.380682,326,TM Dowlin,0,0,0,0,0,0,0,0,24,3,27,24,3,27,0,248,3,1,1,2.1,0.2,22.7,62.7072,10,1
Bangladesh,160,218.438,7.70625,0.4,211.106,7.05,0.325,326,Tamim Iqbal,0,0,0,0,0,0,0,0,28,6,34,28,6,34,249,249,0,0,1,4.05344,0.274809,31.8015,76.8068,131,4
Bangladesh,160,218.438,7.70625,0.4,211.106,7.05,0.325,326,Junaid Siddique,0,0,0,0,0,0,0,0,28,6,34,28,6,34,249,249,0,0,1,2.16279,0.116279,20.0233,68.225,43,1
Sri Lanka,244,223.373,7.09016,0.344262,227.578,7.47541,0.385246,327,WU Tharanga,0,0,0,0,0,0,0,0,4,8,12,4,8,12,0,232,3,1,1,3.93985,0.263158,32.9699,71.6035,133,4
Sri Lanka,244,223.373,7.09016,0.344262,227.578,7.47541,0.385246,327,ST Jayasuriya,0,0,0,0,0,0,0,0,4,8,12,4,8,12,0,232,3,1,1,4.91549,0.211268,33.9859,98.4898,71,0
Pakistan,211,222.621,7.38389,0.393365,235.517,7.54976,0.336493,327,Kamran Akmal,0,0,0,0,0,0,0,0,20,5,25,20,5,25,233,196,0,0,1,3.01124,0.11236,23.0787,81.4433,89,4
Pakistan,211,222.621,7.38389,0.393365,235.517,7.54976,0.336493,327,Shoaib Malik,0,0,0,0,0,0,0,0,20,5,25,20,5,25,233,196,0,0,1,2.77551,0.193878,28.7041,81.4418,98,4
Pakistan,211,222.621,7.38389,0.393365,235.517,7.54976,0.336493,328,Nasir Jamshed,0,0,0,0,0,0,0,0,12,3,15,12,3,15,0,168,1,0,1,3.63043,0.23913,30.2174,73.8184,46,4
Pakistan,211,222.621,7.38389,0.393365,235.517,7.54976,0.336493,328,Younis Khan,0,0,0,0,0,0,0,0,12,3,15,12,3,15,0,168,1,0,1,2.64655,0.215517,28.5,73.2713,116,4
Pakistan,211,222.621,7.38389,0.393365,235.517,7.54976,0.336493,328,Kamran Akmal,0,0,0,0,0,0,0,0,12,3,15,12,3,15,0,168,1,0,1,3.01124,0.11236,23.0787,81.4433,89,4
Sri Lanka,244,223.373,7.09016,0.344262,227.578,7.47541,0.385246,328,WU Tharanga,0,0,0,0,0,0,0,0,12,10,22,12,10,22,169,169,1,1,1,3.93985,0.263158,32.9699,71.6035,133,4
Sri Lanka,244,223.373,7.09016,0.344262,227.578,7.47541,0.385246,328,ST Jayasuriya,0,0,0,0,0,0,0,0,12,10,22,12,10,22,169,169,1,1,1,4.91549,0.211268,33.9859,98.4898,71,0
Sri Lanka,244,223.373,7.09016,0.344262,227.578,7.47541,0.385246,328,KC Sangakkara,0,0,0,0,0,0,0,0,12,10,22,12,10,22,169,169,1,1,1,4.33659,0.360976,41.9854,80.6276,205,4
Pakistan,211,222.621,7.38389,0.393365,235.517,7.54976,0.336493,329,Kamran Akmal,0,0,0,0,0,0,0,0,4,16,20,4,16,20,0,288,2,0,1,3.01124,0.11236,23.0787,81.4433,89,4
Pakistan,211,222.621,7.38389,0.393365,235.517,7.54976,0.336493,329,Nasir Jamshed,0,0,0,0,0,0,0,0,4,16,20,4,16,20,0,288,2,0,1,3.63043,0.23913,30.2174,73.8184,46,4
Pakistan,211,222.621,7.38389,0.393365,235.517,7.54976,0.336493,329,Younis Khan,0,0,0,0,0,0,0,0,4,16,20,4,16,20,0,288,2,0,1,2.64655,0.215517,28.5,73.2713,116,4
Sri Lanka,244,223.373,7.09016,0.344262,227.578,7.47541,0.385246,329,WU Tharanga,0,0,0,0,0,0,0,0,24,6,30,24,6,30,289,289,1,1,1,3.93985,0.263158,32.9699,71.6035,133,4
Sri Lanka,244,223.373,7.09016,0.344262,227.578,7.47541,0.385246,329,DPMD Jayawardene,0,0,0,0,0,0,0,0,24,6,30,24,6,30,289,289,1,1,1,3.20833,0.244792,31.6979,79.1109,192,4
Pakistan,211,222.621,7.38389,0.393365,235.517,7.54976,0.336493,330,Kamran Akmal,0,0,0,0,0,0,0,0,8,9,17,8,9,17,0,321,3,0,1,3.01124,0.11236,23.0787,81.4433,89,4
Pakistan,211,222.621,7.38389,0.393365,235.517,7.54976,0.336493,330,Imran Nazir,0,0,0,0,0,0,0,0,8,9,17,8,9,17,0,321,3,0,1,4.66667,0.133333,29,96.0265,15,0
Sri Lanka,244,223.373,7.09016,0.344262,227.578,7.47541,0.385246,330,WU Tharanga,0,0,0,0,0,0,0,0,22,8,30,22,8,30,322,175,0,1,1,3.93985,0.263158,32.9699,71.6035,133,4
Sri Lanka,244,223.373,7.09016,0.344262,227.578,7.47541,0.385246,330,DPMD Jayawardene,0,0,0,0,0,0,0,0,22,8,30,22,8,30,322,175,0,1,1,3.20833,0.244792,31.6979,79.1109,192,4
Pakistan,211,222.621,7.38389,0.393365,235.517,7.54976,0.336493,331,Kamran Akmal,0,0,0,0,0,0,0,0,12,16,28,12,16,28,0,279,0,0,1,3.01124,0.11236,23.0787,81.4433,89,4
Pakistan,211,222.621,7.38389,0.393365,235.517,7.54976,0.336493,331,Younis Khan,0,0,0,0,0,0,0,0,12,16,28,12,16,28,0,279,0,0,1,2.64655,0.215517,28.5,73.2713,116,4
Pakistan,211,222.621,7.38389,0.393365,235.517,7.54976,0.336493,331,Imran Nazir,0,0,0,0,0,0,0,0,12,16,28,12,16,28,0,279,0,0,1,4.66667,0.133333,29,96.0265,15,0
Sri Lanka,244,223.373,7.09016,0.344262,227.578,7.47541,0.385246,331,WU Tharanga,0,0,0,0,0,0,0,0,16,7,23,16,7,23,280,147,3,1,1,3.93985,0.263158,32.9699,71.6035,133,4
Sri Lanka,244,223.373,7.09016,0.344262,227.578,7.47541,0.385246,331,DPMD Jayawardene,0,0,0,0,0,0,0,0,16,7,23,16,7,23,280,147,3,1,1,3.20833,0.244792,31.6979,79.1109,192,4
Sri Lanka,244,223.373,7.09016,0.344262,227.578,7.47541,0.385246,331,ST Jayasuriya,0,0,0,0,0,0,0,0,16,7,23,16,7,23,280,147,3,1,1,4.91549,0.211268,33.9859,98.4898,71,0
Sri Lanka,244,223.373,7.09016,0.344262,227.578,7.47541,0.385246,331,KC Sangakkara,0,0,0,0,0,0,0,0,16,7,23,16,7,23,280,147,3,1,1,4.33659,0.360976,41.9854,80.6276,205,4
Sri Lanka,244,223.373,7.09016,0.344262,227.578,7.47541,0.385246,332,TM Dilshan,0,0,0,0,0,0,0,0,8,7,15,8,7,15,0,216,0,1,1,4.60199,0.273632,38.3632,86.0219,201,4
Sri Lanka,244,223.373,7.09016,0.344262,227.578,7.47541,0.385246,332,ST Jayasuriya,0,0,0,0,0,0,0,0,8,7,15,8,7,15,0,216,0,1,1,4.91549,0.211268,33.9859,98.4898,71,0
Sri Lanka,244,223.373,7.09016,0.344262,227.578,7.47541,0.385246,332,DPMD Jayawardene,0,0,0,0,0,0,0,0,8,7,15,8,7,15,0,216,0,1,1,3.20833,0.244792,31.6979,79.1109,192,4
Sri Lanka,244,223.373,7.09016,0.344262,227.578,7.47541,0.385246,332,KC Sangakkara,0,0,0,0,0,0,0,0,8,7,15,8,7,15,0,216,0,1,1,4.33659,0.360976,41.9854,80.6276,205,4
New Zealand,184,233.745,7.39674,0.36413,227.951,7.30435,0.353261,332,BB McCullum,0,0,0,0,0,0,0,0,0,7,7,0,7,7,217,119,0,0,1,3.98611,0.201389,29.9028,98.4004,144,0
New Zealand,184,233.745,7.39674,0.36413,227.951,7.30435,0.353261,332,JD Ryder,0,0,0,0,0,0,0,0,0,7,7,0,7,7,217,119,0,0,1,4.88571,0.257143,34.4,97.2536,35,0
New Zealand,184,233.745,7.39674,0.36413,227.951,7.30435,0.353261,332,MJ Guptill,0,0,0,0,0,0,0,0,0,7,7,0,7,7,217,119,0,0,1,4.8087,0.313043,38.1217,82.7482,115,4
New Zealand,184,233.745,7.39674,0.36413,227.951,7.30435,0.353261,332,LRPL Taylor,0,0,0,0,0,0,0,0,0,7,7,0,7,7,217,119,0,0,1,3.68382,0.301471,36.7206,79.3959,136,4
New Zealand,184,233.745,7.39674,0.36413,227.951,7.30435,0.353261,332,GD Elliott,0,0,0,0,0,0,0,0,0,7,7,0,7,7,217,119,0,0,1,2.67188,0.203125,29.4375,79.7629,64,4
Sri Lanka,244,223.373,7.09016,0.344262,227.578,7.47541,0.385246,333,TM Dilshan,0,0,0,0,0,0,0,0,24,11,35,24,11,35,0,307,5,1,1,4.60199,0.273632,38.3632,86.0219,201,4
Sri Lanka,244,223.373,7.09016,0.344262,227.578,7.47541,0.385246,333,ST Jayasuriya,0,0,0,0,0,0,0,0,24,11,35,24,11,35,0,307,5,1,1,4.91549,0.211268,33.9859,98.4898,71,0
India,259,242.378,7.15058,0.339768,244.568,7.12741,0.30888,333,KD Karthik,0,0,0,0,0,0,0,0,16,9,25,16,9,25,308,168,5,0,1,2.46429,0.107143,21.6786,71.8769,56,1
India,259,242.378,7.15058,0.339768,244.568,7.12741,0.30888,333,SR Tendulkar,0,0,0,0,0,0,0,0,16,9,25,16,9,25,308,168,5,0,1,5.89773,0.363636,45.6023,84.5376,88,4
India,259,242.378,7.15058,0.339768,244.568,7.12741,0.30888,334,R Dravid,0,0,0,0,0,0,0,0,8,11,19,8,11,19,0,319,0,0,1,2.83721,0.255814,29.8605,72.7067,43,4
India,259,242.378,7.15058,0.339768,244.568,7.12741,0.30888,334,SR Tendulkar,0,0,0,0,0,0,0,0,8,11,19,8,11,19,0,319,0,0,1,5.89773,0.363636,45.6023,84.5376,88,4
Sri Lanka,244,223.373,7.09016,0.344262,227.578,7.47541,0.385246,334,TM Dilshan,0,0,0,0,0,0,0,0,24,10,34,24,10,34,320,273,1,1,1,4.60199,0.273632,38.3632,86.0219,201,4
Sri Lanka,244,223.373,7.09016,0.344262,227.578,7.47541,0.385246,334,ST Jayasuriya,0,0,0,0,0,0,0,0,24,10,34,24,10,34,320,273,1,1,1,4.91549,0.211268,33.9859,98.4898,71,0
Australia,228,239.627,7.69737,0.372807,232.079,7.23246,0.337719,335,SR Watson,0,0,0,0,0,0,0,0,4,5,9,4,5,9,0,256,5,1,1,4.71318,0.286822,37.7907,90.0943,129,4
Australia,228,239.627,7.69737,0.372807,232.079,7.23246,0.337719,335,SE Marsh,0,0,0,0,0,0,0,0,4,5,9,4,5,9,0,256,5,1,1,3.66667,0.291667,35.5417,74.7918,48,4
West Indies,176,217.33,7.15909,0.3125,225.278,7.57386,0.380682,335,CH Gayle,0,0,0,0,0,0,0,0,4,10,14,4,10,14,257,143,1,0,1,4.58621,0.206897,31.1293,89.4255,116,4
West Indies,176,217.33,7.15909,0.3125,225.278,7.57386,0.380682,335,RS Morton,0,0,0,0,0,0,0,0,4,10,14,4,10,14,257,143,1,0,1,2.2963,0.222222,28.8889,67.0103,27,4
West Indies,176,217.33,7.15909,0.3125,225.278,7.57386,0.380682,335,TM Dowlin,0,0,0,0,0,0,0,0,4,10,14,4,10,14,257,143,1,0,1,2.1,0.2,22.7,62.7072,10,1
West Indies,176,217.33,7.15909,0.3125,225.278,7.57386,0.380682,335,LMP Simmons,0,0,0,0,0,0,0,0,4,10,14,4,10,14,257,143,1,0,1,3.3125,0.28125,30.5938,71.4338,64,4
West Indies,176,217.33,7.15909,0.3125,225.278,7.57386,0.380682,335,N Deonarine,0,0,0,0,0,0,0,0,4,10,14,4,10,14,257,143,1,0,1,2.09091,0.136364,20.9545,65.7632,22,1
West Indies,176,217.33,7.15909,0.3125,225.278,7.57386,0.380682,336,CH Gayle,0,0,0,0,0,0,0,0,0,6,6,0,6,6,0,170,5,0,1,4.58621,0.206897,31.1293,89.4255,116,4
West Indies,176,217.33,7.15909,0.3125,225.278,7.57386,0.380682,336,TM Dowlin,0,0,0,0,0,0,0,0,0,6,6,0,6,6,0,170,5,0,1,2.1,0.2,22.7,62.7072,10,1
West Indies,176,217.33,7.15909,0.3125,225.278,7.57386,0.380682,336,RS Morton,0,0,0,0,0,0,0,0,0,6,6,0,6,6,0,170,5,0,1,2.2963,0.222222,28.8889,67.0103,27,4
West Indies,176,217.33,7.15909,0.3125,225.278,7.57386,0.380682,336,N Deonarine,0,0,0,0,0,0,0,0,0,6,6,0,6,6,0,170,5,0,1,2.09091,0.136364,20.9545,65.7632,22,1
Australia,228,239.627,7.69737,0.372807,232.079,7.23246,0.337719,336,SR Watson,0,0,0,0,0,0,0,0,22,6,28,22,6,28,171,171,2,1,1,4.71318,0.286822,37.7907,90.0943,129,4
Australia,228,239.627,7.69737,0.372807,232.079,7.23246,0.337719,336,SE Marsh,0,0,0,0,0,0,0,0,22,6,28,22,6,28,171,171,2,1,1,3.66667,0.291667,35.5417,74.7918,48,4
Australia,228,239.627,7.69737,0.372807,232.079,7.23246,0.337719,337,SR Watson,0,0,0,0,0,0,0,0,18,11,29,18,11,29,0,324,9,1,1,4.71318,0.286822,37.7907,90.0943,129,4
Australia,228,239.627,7.69737,0.372807,232.079,7.23246,0.337719,337,TD Paine,0,0,0,0,0,0,0,0,18,11,29,18,11,29,0,324,9,1,1,3.3913,0.217391,27.6522,65.7704,23,4
West Indies,176,217.33,7.15909,0.3125,225.278,7.57386,0.380682,337,CH Gayle,0,0,0,0,0,0,0,0,28,12,40,28,12,40,325,274,2,0,1,4.58621,0.206897,31.1293,89.4255,116,4
West Indies,176,217.33,7.15909,0.3125,225.278,7.57386,0.380682,337,TM Dowlin,0,0,0,0,0,0,0,0,28,12,40,28,12,40,325,274,2,0,1,2.1,0.2,22.7,62.7072,10,1
Australia,228,239.627,7.69737,0.372807,232.079,7.23246,0.337719,338,SR Watson,0,0,0,0,0,0,0,0,18,9,27,18,9,27,0,324,1,1,1,4.71318,0.286822,37.7907,90.0943,129,4
Australia,228,239.627,7.69737,0.372807,232.079,7.23246,0.337719,338,BJ Haddin,0,0,0,0,0,0,0,0,18,9,27,18,9,27,0,324,1,1,1,3.14737,0.147368,26.7789,81.382,95,4
West Indies,176,217.33,7.15909,0.3125,225.278,7.57386,0.380682,338,CH Gayle,0,0,0,0,0,0,0,0,12,7,19,12,7,19,325,199,1,0,1,4.58621,0.206897,31.1293,89.4255,116,4
West Indies,176,217.33,7.15909,0.3125,225.278,7.57386,0.380682,338,TM Dowlin,0,0,0,0,0,0,0,0,12,7,19,12,7,19,325,199,1,0,1,2.1,0.2,22.7,62.7072,10,1
West Indies,176,217.33,7.15909,0.3125,225.278,7.57386,0.380682,338,N Deonarine,0,0,0,0,0,0,0,0,12,7,19,12,7,19,325,199,1,0,1,2.09091,0.136364,20.9545,65.7632,22,1
West Indies,176,217.33,7.15909,0.3125,225.278,7.57386,0.380682,338,KA Pollard,0,0,0,0,0,0,0,0,12,7,19,12,7,19,325,199,1,0,1,2.70513,0.115385,24.5,88.0645,78,4
West Indies,176,217.33,7.15909,0.3125,225.278,7.57386,0.380682,338,WW Hinds,0,0,0,0,0,0,0,0,12,7,19,12,7,19,325,199,1,0,1,1.11111,0,12,38.9892,9,3
Pakistan,211,222.621,7.38389,0.393365,235.517,7.54976,0.336493,339,Salman Butt,0,0,0,0,0,0,0,0,16,8,24,16,8,24,0,274,3,0,1,5.4359,0.384615,42.3846,78.8645,39,4
Pakistan,211,222.621,7.38389,0.393365,235.517,7.54976,0.336493,339,Kamran Akmal,0,0,0,0,0,0,0,0,16,8,24,16,8,24,0,274,3,0,1,3.01124,0.11236,23.0787,81.4433,89,4
Australia,228,239.627,7.69737,0.372807,232.079,7.23246,0.337719,339,SR Watson,0,0,0,0,0,0,0,0,4,12,16,4,12,16,275,275,6,1,1,4.71318,0.286822,37.7907,90.0943,129,4
Australia,228,239.627,7.69737,0.372807,232.079,7.23246,0.337719,339,SE Marsh,0,0,0,0,0,0,0,0,4,12,16,4,12,16,275,275,6,1,1,3.66667,0.291667,35.5417,74.7918,48,4
Australia,228,239.627,7.69737,0.372807,232.079,7.23246,0.337719,339,RT Ponting,0,0,0,0,0,0,0,0,4,12,16,4,12,16,275,275,6,1,1,4.17431,0.33945,38.1009,80.8606,109,4
Australia,228,239.627,7.69737,0.372807,232.079,7.23246,0.337719,340,SR Watson,0,0,0,0,0,0,0,0,28,11,39,28,11,39,0,267,1,1,1,4.71318,0.286822,37.7907,90.0943,129,4
Australia,228,239.627,7.69737,0.372807,232.079,7.23246,0.337719,340,SE Marsh,0,0,0,0,0,0,0,0,28,11,39,28,11,39,0,267,1,1,1,3.66667,0.291667,35.5417,74.7918,48,4
Pakistan,211,222.621,7.38389,0.393365,235.517,7.54976,0.336493,340,Salman Butt,0,0,0,0,0,0,0,0,0,6,6,0,6,6,268,127,1,0,1,5.4359,0.384615,42.3846,78.8645,39,4
Pakistan,211,222.621,7.38389,0.393365,235.517,7.54976,0.336493,340,Kamran Akmal,0,0,0,0,0,0,0,0,0,6,6,0,6,6,268,127,1,0,1,3.01124,0.11236,23.0787,81.4433,89,4
Pakistan,211,222.621,7.38389,0.393365,235.517,7.54976,0.336493,340,Younis Khan,0,0,0,0,0,0,0,0,0,6,6,0,6,6,268,127,1,0,1,2.64655,0.215517,28.5,73.2713,116,4
Australia,228,239.627,7.69737,0.372807,232.079,7.23246,0.337719,341,SR Watson,0,0,0,0,0,0,0,0,12,7,19,12,7,19,0,286,1,1,1,4.71318,0.286822,37.7907,90.0943,129,4
Australia,228,239.627,7.69737,0.372807,232.079,7.23246,0.337719,341,SE Marsh,0,0,0,0,0,0,0,0,12,7,19,12,7,19,0,286,1,1,1,3.66667,0.291667,35.5417,74.7918,48,4
Pakistan,211,222.621,7.38389,0.393365,235.517,7.54976,0.336493,341,Salman Butt,0,0,0,0,0,0,0,0,12,7,19,12,7,19,287,246,0,0,1,5.4359,0.384615,42.3846,78.8645,39,4
Pakistan,211,222.621,7.38389,0.393365,235.517,7.54976,0.336493,341,Kamran Akmal,0,0,0,0,0,0,0,0,12,7,19,12,7,19,287,246,0,0,1,3.01124,0.11236,23.0787,81.4433,89,4
Pakistan,211,222.621,7.38389,0.393365,235.517,7.54976,0.336493,341,Younis Khan,0,0,0,0,0,0,0,0,12,7,19,12,7,19,287,246,0,0,1,2.64655,0.215517,28.5,73.2713,116,4
Australia,228,239.627,7.69737,0.372807,232.079,7.23246,0.337719,342,SE Marsh,0,0,0,0,0,0,0,0,12,10,22,12,10,22,0,277,0,1,1,3.66667,0.291667,35.5417,74.7918,48,4
Australia,228,239.627,7.69737,0.372807,232.079,7.23246,0.337719,342,BJ Haddin,0,0,0,0,0,0,0,0,12,10,22,12,10,22,0,277,0,1,1,3.14737,0.147368,26.7789,81.382,95,4
Pakistan,211,222.621,7.38389,0.393365,235.517,7.54976,0.336493,342,Salman Butt,0,0,0,0,0,0,0,0,0,12,12,0,12,12,278,142,3,0,1,5.4359,0.384615,42.3846,78.8645,39,4
Pakistan,211,222.621,7.38389,0.393365,235.517,7.54976,0.336493,342,Younis Khan,0,0,0,0,0,0,0,0,0,12,12,0,12,12,278,142,3,0,1,2.64655,0.215517,28.5,73.2713,116,4
Pakistan,211,222.621,7.38389,0.393365,235.517,7.54976,0.336493,342,Kamran Akmal,0,0,0,0,0,0,0,0,0,12,12,0,12,12,278,142,3,0,1,3.01124,0.11236,23.0787,81.4433,89,4
Pakistan,211,222.621,7.38389,0.393365,235.517,7.54976,0.336493,342,Mohammad Yousuf,0,0,0,0,0,0,0,0,0,12,12,0,12,12,278,142,3,0,1,3.27586,0.275862,36.7931,73.9176,58,4
Zimbabwe,142,212.077,7.5,0.380282,227.704,6.97887,0.316901,343,H Masakadza,0,0,0,0,0,0,0,0,8,6,14,8,6,14,0,207,0,1,1,3.11215,0.186916,26.972,70.0485,107,4
Zimbabwe,142,212.077,7.5,0.380282,227.704,6.97887,0.316901,343,MA Vermeulen,0,0,0,0,0,0,0,0,8,6,14,8,6,14,0,207,0,1,1,1.85714,0.142857,20.2857,68.2692,7,1
Zimbabwe,142,212.077,7.5,0.380282,227.704,6.97887,0.316901,343,CJ Chibhabha,0,0,0,0,0,0,0,0,8,6,14,8,6,14,0,207,0,1,1,2.56716,0.149254,23.5373,64.7373,67,1
Bangladesh,160,218.438,7.70625,0.4,211.106,7.05,0.325,343,Tamim Iqbal,0,0,0,0,0,0,0,0,32,5,37,32,5,37,208,211,0,0,1,4.05344,0.274809,31.8015,76.8068,131,4
Bangladesh,160,218.438,7.70625,0.4,211.106,7.05,0.325,343,Junaid Siddique,0,0,0,0,0,0,0,0,32,5,37,32,5,37,208,211,0,0,1,2.16279,0.116279,20.0233,68.225,43,1
Bangladesh,160,218.438,7.70625,0.4,211.106,7.05,0.325,343,Mohammad Ashraful,0,0,0,0,0,0,0,0,32,5,37,32,5,37,208,211,0,0,1,2.17722,0.113924,19.4557,63.9085,79,1
Bangladesh,160,218.438,7.70625,0.4,211.106,7.05,0.325,344,Tamim Iqbal,0,0,0,0,0,0,0,0,8,18,26,8,18,26,0,320,2,0,1,4.05344,0.274809,31.8015,76.8068,131,4
Bangladesh,160,218.438,7.70625,0.4,211.106,7.05,0.325,344,Junaid Siddique,0,0,0,0,0,0,0,0,8,18,26,8,18,26,0,320,2,0,1,2.16279,0.116279,20.0233,68.225,43,1
Zimbabwe,142,212.077,7.5,0.380282,227.704,6.97887,0.316901,344,MA Vermeulen,0,0,0,0,0,0,0,0,16,13,29,16,13,29,321,271,0,1,1,1.85714,0.142857,20.2857,68.2692,7,1
Zimbabwe,142,212.077,7.5,0.380282,227.704,6.97887,0.316901,344,H Masakadza,0,0,0,0,0,0,0,0,16,13,29,16,13,29,321,271,0,1,1,3.11215,0.186916,26.972,70.0485,107,4
Zimbabwe,142,212.077,7.5,0.380282,227.704,6.97887,0.316901,344,CK Coventry,0,0,0,0,0,0,0,0,16,13,29,16,13,29,321,271,0,1,1,3.33333,0.166667,29.3889,90.273,18,4
Zimbabwe,142,212.077,7.5,0.380282,227.704,6.97887,0.316901,345,MA Vermeulen,0,0,0,0,0,0,0,0,16,8,24,16,8,24,0,323,3,1,1,1.85714,0.142857,20.2857,68.2692,7,1
Zimbabwe,142,212.077,7.5,0.380282,227.704,6.97887,0.316901,345,V Sibanda,0,0,0,0,0,0,0,0,16,8,24,16,8,24,0,323,3,1,1,2.9697,0.181818,23.5152,63.5545,66,1
Zimbabwe,142,212.077,7.5,0.380282,227.704,6.97887,0.316901,345,H Masakadza,0,0,0,0,0,0,0,0,16,8,24,16,8,24,0,323,3,1,1,3.11215,0.186916,26.972,70.0485,107,4
Zimbabwe,142,212.077,7.5,0.380282,227.704,6.97887,0.316901,345,CK Coventry,0,0,0,0,0,0,0,0,16,8,24,16,8,24,0,323,3,1,1,3.33333,0.166667,29.3889,90.273,18,4
Bangladesh,160,218.438,7.70625,0.4,211.106,7.05,0.325,345,Tamim Iqbal,0,0,0,0,0,0,0,0,12,9,21,12,9,21,324,254,1,0,1,4.05344,0.274809,31.8015,76.8068,131,4
Bangladesh,160,218.438,7.70625,0.4,211.106,7.05,0.325,345,Mohammad Ashraful,0,0,0,0,0,0,0,0,12,9,21,12,9,21,324,254,1,0,1,2.17722,0.113924,19.4557,63.9085,79,1
Bangladesh,160,218.438,7.70625,0.4,211.106,7.05,0.325,345,Naeem Islam,0,0,0,0,0,0,0,0,12,9,21,12,9,21,324,254,1,0,1,1.88889,0.111111,18.6889,67.496,45,1
Bangladesh,160,218.438,7.70625,0.4,211.106,7.05,0.325,345,Raqibul Hasan,0,0,0,0,0,0,0,0,12,9,21,12,9,21,324,254,1,0,1,1.85106,0.12766,23.2766,59.2312,47,1
Bangladesh,160,218.438,7.70625,0.4,211.106,7.05,0.325,345,Shakib Al Hasan,0,0,0,0,0,0,0,0,12,9,21,12,9,21,324,254,1,0,1,2.86992,0.252033,29.9106,79.0163,123,4
Zimbabwe,142,212.077,7.5,0.380282,227.704,6.97887,0.316901,346,MA Vermeulen,0,0,0,0,0,0,0,0,14,5,19,14,5,19,0,312,0,1,1,1.85714,0.142857,20.2857,68.2692,7,1
Zimbabwe,142,212.077,7.5,0.380282,227.704,6.97887,0.316901,346,H Masakadza,0,0,0,0,0,0,0,0,14,5,19,14,5,19,0,312,0,1,1,3.11215,0.186916,26.972,70.0485,107,4
Zimbabwe,142,212.077,7.5,0.380282,227.704,6.97887,0.316901,346,CK Coventry,0,0,0,0,0,0,0,0,14,5,19,14,5,19,0,312,0,1,1,3.33333,0.166667,29.3889,90.273,18,4
Bangladesh,160,218.438,7.70625,0.4,211.106,7.05,0.325,346,Tamim Iqbal,0,0,0,0,0,0,0,0,16,15,31,16,15,31,313,313,2,0,1,4.05344,0.274809,31.8015,76.8068,131,4
Bangladesh,160,218.438,7.70625,0.4,211.106,7.05,0.325,346,Junaid Siddique,0,0,0,0,0,0,0,0,16,15,31,16,15,31,313,313,2,0,1,2.16279,0.116279,20.0233,68.225,43,1
Zimbabwe,142,212.077,7.5,0.380282,227.704,6.97887,0.316901,347,V Sibanda,0,0,0,0,0,0,0,0,8,8,16,8,8,16,0,209,5,1,1,2.9697,0.181818,23.5152,63.5545,66,1
Zimbabwe,142,212.077,7.5,0.380282,227.704,6.97887,0.316901,347,H Masakadza,0,0,0,0,0,0,0,0,8,8,16,8,8,16,0,209,5,1,1,3.11215,0.186916,26.972,70.0485,107,4
Zimbabwe,142,212.077,7.5,0.380282,227.704,6.97887,0.316901,347,CK Coventry,0,0,0,0,0,0,0,0,8,8,16,8,8,16,0,209,5,1,1,3.33333,0.166667,29.3889,90.273,18,4
Zimbabwe,142,212.077,7.5,0.380282,227.704,6.97887,0.316901,347,MN Waller,0,0,0,0,0,0,0,0,8,8,16,8,8,16,0,209,5,1,1,2.07895,0.0789474,19.3684,68.9784,38,1
Bangladesh,160,218.438,7.70625,0.4,211.106,7.05,0.325,347,Tamim Iqbal,0,0,0,0,0,0,0,0,4,5,9,4,5,9,210,212,6,0,1,4.05344,0.274809,31.8015,76.8068,131,4
Bangladesh,160,218.438,7.70625,0.4,211.106,7.05,0.325,347,Mushfiqur Rahim,0,0,0,0,0,0,0,0,4,5,9,4,5,9,210,212,6,0,1,2.61111,0.18254,27.7778,75.2526,126,4
Sri Lanka,244,223.373,7.09016,0.344262,227.578,7.47541,0.385246,349,TM Dilshan,0,0,0,0,0,0,0,0,16,4,20,16,4,20,0,319,3,0,1,4.60199,0.273632,38.3632,86.0219,201,4
Sri Lanka,244,223.373,7.09016,0.344262,227.578,7.47541,0.385246,349,ST Jayasuriya,0,0,0,0,0,0,0,0,16,4,20,16,4,20,0,319,3,0,1,4.91549,0.211268,33.9859,98.4898,71,0
Sri Lanka,244,223.373,7.09016,0.344262,227.578,7.47541,0.385246,349,KC Sangakkara,0,0,0,0,0,0,0,0,16,4,20,16,4,20,0,319,3,0,1,4.33659,0.360976,41.9854,80.6276,205,4
South Africa,190,234.274,7.4,0.373684,232.363,7.33158,0.342105,349,GC Smith,0,0,0,0,0,0,0,0,8,10,18,8,10,18,320,206,0,1,1,3.97,0.29,33.57,79.6819,100,4
South Africa,190,234.274,7.4,0.373684,232.363,7.33158,0.342105,349,HM Amla,0,0,0,0,0,0,0,0,8,10,18,8,10,18,320,206,0,1,1,5.20168,0.403361,48.7899,86.9292,119,4
South Africa,190,234.274,7.4,0.373684,232.363,7.33158,0.342105,349,JH Kallis,0,0,0,0,0,0,0,0,8,10,18,8,10,18,320,206,0,1,1,3.58621,0.356322,37.2644,76.4442,87,4
West Indies,176,217.33,7.15909,0.3125,225.278,7.57386,0.380682,350,DM Richards,0,0,0,0,0,0,0,0,4,9,13,4,9,13,0,133,1,0,1,3.42857,0.285714,25.5714,68.8462,7,4
West Indies,176,217.33,7.15909,0.3125,225.278,7.57386,0.380682,350,ADS Fletcher,0,0,0,0,0,0,0,0,4,9,13,4,9,13,0,133,1,0,1,1.8125,0.125,13.5,62.6087,16,1
West Indies,176,217.33,7.15909,0.3125,225.278,7.57386,0.380682,350,DS Smith,0,0,0,0,0,0,0,0,4,9,13,4,9,13,0,133,1,0,1,2.61765,0.147059,23.5588,71.2,34,4
West Indies,176,217.33,7.15909,0.3125,225.278,7.57386,0.380682,350,TM Dowlin,0,0,0,0,0,0,0,0,4,9,13,4,9,13,0,133,1,0,1,2.1,0.2,22.7,62.7072,10,1
West Indies,176,217.33,7.15909,0.3125,225.278,7.57386,0.380682,350,FL Reifer,0,0,0,0,0,0,0,0,4,9,13,4,9,13,0,133,1,0,1,1.16667,0,14.3333,45.2632,6,3
Pakistan,211,222.621,7.38389,0.393365,235.517,7.54976,0.336493,350,Imran Nazir,0,0,0,0,0,0,0,0,14,6,20,14,6,20,134,134,1,0,1,4.66667,0.133333,29,96.0265,15,0
Pakistan,211,222.621,7.38389,0.393365,235.517,7.54976,0.336493,350,Kamran Akmal,0,0,0,0,0,0,0,0,14,6,20,14,6,20,134,134,1,0,1,3.01124,0.11236,23.0787,81.4433,89,4
Pakistan,211,222.621,7.38389,0.393365,235.517,7.54976,0.336493,350,Shoaib Malik,0,0,0,0,0,0,0,0,14,6,20,14,6,20,134,134,1,0,1,2.77551,0.193878,28.7041,81.4418,98,4
New Zealand,184,233.745,7.39674,0.36413,227.951,7.30435,0.353261,351,BB McCullum,0,0,0,0,0,0,0,0,4,8,12,4,8,12,0,214,0,0,1,3.98611,0.201389,29.9028,98.4004,144,0
New Zealand,184,233.745,7.39674,0.36413,227.951,7.30435,0.353261,351,JD Ryder,0,0,0,0,0,0,0,0,4,8,12,4,8,12,0,214,0,0,1,4.88571,0.257143,34.4,97.2536,35,0
South Africa,190,234.274,7.4,0.373684,232.363,7.33158,0.342105,351,GC Smith,0,0,0,0,0,0,0,0,4,12,16,4,12,16,215,217,2,1,1,3.97,0.29,33.57,79.6819,100,4
South Africa,190,234.274,7.4,0.373684,232.363,7.33158,0.342105,351,HM Amla,0,0,0,0,0,0,0,0,4,12,16,4,12,16,215,217,2,1,1,5.20168,0.403361,48.7899,86.9292,119,4
Australia,228,239.627,7.69737,0.372807,232.079,7.23246,0.337719,352,SR Watson,0,0,0,0,0,0,0,0,0,13,13,0,13,13,0,275,5,0,1,4.71318,0.286822,37.7907,90.0943,129,4
Australia,228,239.627,7.69737,0.372807,232.079,7.23246,0.337719,352,RT Ponting,0,0,0,0,0,0,0,0,0,13,13,0,13,13,0,275,5,0,1,4.17431,0.33945,38.1009,80.8606,109,4
Australia,228,239.627,7.69737,0.372807,232.079,7.23246,0.337719,352,TD Paine,0,0,0,0,0,0,0,0,0,13,13,0,13,13,0,275,5,0,1,3.3913,0.217391,27.6522,65.7704,23,4
West Indies,176,217.33,7.15909,0.3125,225.278,7.57386,0.380682,352,DS Smith,0,0,0,0,0,0,0,0,12,5,17,12,5,17,276,225,13,0,1,2.61765,0.147059,23.5588,71.2,34,4
West Indies,176,217.33,7.15909,0.3125,225.278,7.57386,0.380682,352,ADS Fletcher,0,0,0,0,0,0,0,0,12,5,17,12,5,17,276,225,13,0,1,1.8125,0.125,13.5,62.6087,16,1
Pakistan,211,222.621,7.38389,0.393365,235.517,7.54976,0.336493,353,Imran Nazir,0,0,0,0,0,0,0,0,24,7,31,24,7,31,0,302,2,0,1,4.66667,0.133333,29,96.0265,15,0
Pakistan,211,222.621,7.38389,0.393365,235.517,7.54976,0.336493,353,Kamran Akmal,0,0,0,0,0,0,0,0,24,7,31,24,7,31,0,302,2,0,1,3.01124,0.11236,23.0787,81.4433,89,4
India,259,242.378,7.15058,0.339768,244.568,7.12741,0.30888,353,G Gambhir,0,0,0,0,0,0,0,0,16,9,25,16,9,25,303,248,3,0,1,3.99145,0.333333,37.4701,84.1944,117,4
India,259,242.378,7.15058,0.339768,244.568,7.12741,0.30888,353,SR Tendulkar,0,0,0,0,0,0,0,0,16,9,25,16,9,25,303,248,3,0,1,5.89773,0.363636,45.6023,84.5376,88,4
India,259,242.378,7.15058,0.339768,244.568,7.12741,0.30888,353,R Dravid,0,0,0,0,0,0,0,0,16,9,25,16,9,25,303,248,3,0,1,2.83721,0.255814,29.8605,72.7067,43,4
New Zealand,184,233.745,7.39674,0.36413,227.951,7.30435,0.353261,354,BB McCullum,0,0,0,0,0,0,0,0,12,10,22,12,10,22,0,315,4,0,1,3.98611,0.201389,29.9028,98.4004,144,0
New Zealand,184,233.745,7.39674,0.36413,227.951,7.30435,0.353261,354,JD Ryder,0,0,0,0,0,0,0,0,12,10,22,12,10,22,0,315,4,0,1,4.88571,0.257143,34.4,97.2536,35,0
Sri Lanka,244,223.373,7.09016,0.344262,227.578,7.47541,0.385246,354,TM Dilshan,0,0,0,0,0,0,0,0,38,7,45,38,7,45,316,277,1,0,1,4.60199,0.273632,38.3632,86.0219,201,4
Sri Lanka,244,223.373,7.09016,0.344262,227.578,7.47541,0.385246,354,ST Jayasuriya,0,0,0,0,0,0,0,0,38,7,45,38,7,45,316,277,1,0,1,4.91549,0.211268,33.9859,98.4898,71,0
England,221,237.176,7.17647,0.289593,230.633,7.45701,0.384615,355,AJ Strauss,0,0,0,0,0,0,0,0,20,5,25,20,5,25,0,323,2,0,1,3.93243,0.27027,33.9054,79.8028,74,4
England,221,237.176,7.17647,0.289593,230.633,7.45701,0.384615,355,JL Denly,0,0,0,0,0,0,0,0,20,5,25,20,5,25,0,323,2,0,1,3.55556,0.222222,29.3333,63.1579,9,4
South Africa,190,234.274,7.4,0.373684,232.363,7.33158,0.342105,355,GC Smith,0,0,0,0,0,0,0,0,18,9,27,18,9,27,324,301,2,1,1,3.97,0.29,33.57,79.6819,100,4
South Africa,190,234.274,7.4,0.373684,232.363,7.33158,0.342105,355,HH Gibbs,0,0,0,0,0,0,0,0,18,9,27,18,9,27,324,301,2,1,1,4.61538,0.307692,35.6923,83.4157,52,4
England,221,237.176,7.17647,0.289593,230.633,7.45701,0.384615,356,AJ Strauss,0,0,0,0,0,0,0,0,4,7,11,4,7,11,0,146,2,0,1,3.93243,0.27027,33.9054,79.8028,74,4
England,221,237.176,7.17647,0.289593,230.633,7.45701,0.384615,356,OA Shah,0,0,0,0,0,0,0,0,4,7,11,4,7,11,0,146,2,0,1,3.13043,0.23913,32.6739,81.1994,46,4
England,221,237.176,7.17647,0.289593,230.633,7.45701,0.384615,356,JL Denly,0,0,0,0,0,0,0,0,4,7,11,4,7,11,0,146,2,0,1,3.55556,0.222222,29.3333,63.1579,9,4
England,221,237.176,7.17647,0.289593,230.633,7.45701,0.384615,356,PD Collingwood,0,0,0,0,0,0,0,0,4,7,11,4,7,11,0,146,2,0,1,2.62366,0.193548,30.5161,76.8065,93,4
New Zealand,184,233.745,7.39674,0.36413,227.951,7.30435,0.353261,356,BB McCullum,0,0,0,0,0,0,0,0,16,14,30,16,14,30,147,147,4,0,1,3.98611,0.201389,29.9028,98.4004,144,0
New Zealand,184,233.745,7.39674,0.36413,227.951,7.30435,0.353261,356,MJ Guptill,0,0,0,0,0,0,0,0,16,14,30,16,14,30,147,147,4,0,1,4.8087,0.313043,38.1217,82.7482,115,4
Pakistan,211,222.621,7.38389,0.393365,235.517,7.54976,0.336493,357,Kamran Akmal,0,0,0,0,0,0,0,0,8,9,17,8,9,17,0,205,0,0,1,3.01124,0.11236,23.0787,81.4433,89,4
Pakistan,211,222.621,7.38389,0.393365,235.517,7.54976,0.336493,357,Shahid Afridi,0,0,0,0,0,0,0,0,8,9,17,8,9,17,0,205,0,0,1,2.72917,0.0972222,21.4097,127.766,144,0
Australia,228,239.627,7.69737,0.372807,232.079,7.23246,0.337719,357,SR Watson,0,0,0,0,0,0,0,0,30,3,33,30,3,33,206,206,2,0,1,4.71318,0.286822,37.7907,90.0943,129,4
Australia,228,239.627,7.69737,0.372807,232.079,7.23246,0.337719,357,TD Paine,0,0,0,0,0,0,0,0,30,3,33,30,3,33,206,206,2,0,1,3.3913,0.217391,27.6522,65.7704,23,4
West Indies,176,217.33,7.15909,0.3125,225.278,7.57386,0.380682,358,ADS Fletcher,0,0,0,0,0,0,0,0,8,5,13,8,5,13,0,129,0,0,1,1.8125,0.125,13.5,62.6087,16,1
West Indies,176,217.33,7.15909,0.3125,225.278,7.57386,0.380682,358,KOA Powell,0,0,0,0,0,0,0,0,8,5,13,8,5,13,0,129,0,0,1,3.59259,0.222222,26.4815,80.6088,27,4
West Indies,176,217.33,7.15909,0.3125,225.278,7.57386,0.380682,358,DS Smith,0,0,0,0,0,0,0,0,8,5,13,8,5,13,0,129,0,0,1,2.61765,0.147059,23.5588,71.2,34,4
India,259,242.378,7.15058,0.339768,244.568,7.12741,0.30888,358,KD Karthik,0,0,0,0,0,0,0,0,16,6,22,16,6,22,130,130,0,0,1,2.46429,0.107143,21.6786,71.8769,56,1
India,259,242.378,7.15058,0.339768,244.568,7.12741,0.30888,358,G Gambhir,0,0,0,0,0,0,0,0,16,6,22,16,6,22,130,130,0,0,1,3.99145,0.333333,37.4701,84.1944,117,4
India,259,242.378,7.15058,0.339768,244.568,7.12741,0.30888,358,R Dravid,0,0,0,0,0,0,0,0,16,6,22,16,6,22,130,130,0,0,1,2.83721,0.255814,29.8605,72.7067,43,4
India,259,242.378,7.15058,0.339768,244.568,7.12741,0.30888,358,V Kohli,0,0,0,0,0,0,0,0,16,6,22,16,6,22,130,130,0,0,1,4.66456,0.379747,44.9937,88.3325,158,4
England,221,237.176,7.17647,0.289593,230.633,7.45701,0.384615,359,AJ Strauss,0,0,0,0,0,0,0,0,22,9,31,22,9,31,0,257,1,0,1,3.93243,0.27027,33.9054,79.8028,74,4
England,221,237.176,7.17647,0.289593,230.633,7.45701,0.384615,359,JL Denly,0,0,0,0,0,0,0,0,22,9,31,22,9,31,0,257,1,0,1,3.55556,0.222222,29.3333,63.1579,9,4
England,221,237.176,7.17647,0.289593,230.633,7.45701,0.384615,359,OA Shah,0,0,0,0,0,0,0,0,22,9,31,22,9,31,0,257,1,0,1,3.13043,0.23913,32.6739,81.1994,46,4
England,221,237.176,7.17647,0.289593,230.633,7.45701,0.384615,359,PD Collingwood,0,0,0,0,0,0,0,0,22,9,31,22,9,31,0,257,1,0,1,2.62366,0.193548,30.5161,76.8065,93,4
Australia,228,239.627,7.69737,0.372807,232.079,7.23246,0.337719,359,SR Watson,0,0,0,0,0,0,0,0,16,5,21,16,5,21,258,258,1,0,1,4.71318,0.286822,37.7907,90.0943,129,4
Australia,228,239.627,7.69737,0.372807,232.079,7.23246,0.337719,359,TD Paine,0,0,0,0,0,0,0,0,16,5,21,16,5,21,258,258,1,0,1,3.3913,0.217391,27.6522,65.7704,23,4
Australia,228,239.627,7.69737,0.372807,232.079,7.23246,0.337719,359,RT Ponting,0,0,0,0,0,0,0,0,16,5,21,16,5,21,258,258,1,0,1,4.17431,0.33945,38.1009,80.8606,109,4
Pakistan,211,222.621,7.38389,0.393365,235.517,7.54976,0.336493,360,Imran Nazir,0,0,0,0,0,0,0,0,4,6,10,4,6,10,0,233,6,0,1,4.66667,0.133333,29,96.0265,15,0
Pakistan,211,222.621,7.38389,0.393365,235.517,7.54976,0.336493,360,Kamran Akmal,0,0,0,0,0,0,0,0,4,6,10,4,6,10,0,233,6,0,1,3.01124,0.11236,23.0787,81.4433,89,4
New Zealand,184,233.745,7.39674,0.36413,227.951,7.30435,0.353261,360,BB McCullum,0,0,0,0,0,0,0,0,14,8,22,14,8,22,234,234,0,0,1,3.98611,0.201389,29.9028,98.4004,144,0
New Zealand,184,233.745,7.39674,0.36413,227.951,7.30435,0.353261,360,AJ Redmond,0,0,0,0,0,0,0,0,14,8,22,14,8,22,234,234,0,0,1,3.16667,0.166667,25.3333,57.1429,6,3
Australia,228,239.627,7.69737,0.372807,232.079,7.23246,0.337719,361,SR Watson,0,0,0,0,0,0,0,0,16,3,19,16,3,19,0,292,3,0,1,4.71318,0.286822,37.7907,90.0943,129,4
Australia,228,239.627,7.69737,0.372807,232.079,7.23246,0.337719,361,TD Paine,0,0,0,0,0,0,0,0,16,3,19,16,3,19,0,292,3,0,1,3.3913,0.217391,27.6522,65.7704,23,4
Australia,228,239.627,7.69737,0.372807,232.079,7.23246,0.337719,361,RT Ponting,0,0,0,0,0,0,0,0,16,3,19,16,3,19,0,292,3,0,1,4.17431,0.33945,38.1009,80.8606,109,4
India,259,242.378,7.15058,0.339768,244.568,7.12741,0.30888,361,V Sehwag,0,0,0,0,0,0,0,0,20,3,23,20,3,23,293,288,6,1,1,5.88636,0.238636,38.8295,108.649,88,0
India,259,242.378,7.15058,0.339768,244.568,7.12741,0.30888,361,SR Tendulkar,0,0,0,0,0,0,0,0,20,3,23,20,3,23,293,288,6,1,1,5.89773,0.363636,45.6023,84.5376,88,4
India,259,242.378,7.15058,0.339768,244.568,7.12741,0.30888,361,G Gambhir,0,0,0,0,0,0,0,0,20,3,23,20,3,23,293,288,6,1,1,3.99145,0.333333,37.4701,84.1944,117,4
India,259,242.378,7.15058,0.339768,244.568,7.12741,0.30888,362,V Sehwag,0,0,0,0,0,0,0,0,24,4,28,24,4,28,0,354,4,1,1,5.88636,0.238636,38.8295,108.649,88,0
India,259,242.378,7.15058,0.339768,244.568,7.12741,0.30888,362,SR Tendulkar,0,0,0,0,0,0,0,0,24,4,28,24,4,28,0,354,4,1,1,5.89773,0.363636,45.6023,84.5376,88,4
India,259,242.378,7.15058,0.339768,244.568,7.12741,0.30888,362,G Gambhir,0,0,0,0,0,0,0,0,24,4,28,24,4,28,0,354,4,1,1,3.99145,0.333333,37.4701,84.1944,117,4
Australia,228,239.627,7.69737,0.372807,232.079,7.23246,0.337719,362,SR Watson,0,0,0,0,0,0,0,0,12,7,19,12,7,19,355,255,1,0,1,4.71318,0.286822,37.7907,90.0943,129,4
Australia,228,239.627,7.69737,0.372807,232.079,7.23246,0.337719,362,TD Paine,0,0,0,0,0,0,0,0,12,7,19,12,7,19,355,255,1,0,1,3.3913,0.217391,27.6522,65.7704,23,4
Australia,228,239.627,7.69737,0.372807,232.079,7.23246,0.337719,363,SR Watson,0,0,0,0,0,0,0,0,12,7,19,12,7,19,0,229,0,0,1,4.71318,0.286822,37.7907,90.0943,129,4
Australia,228,239.627,7.69737,0.372807,232.079,7.23246,0.337719,363,RT Ponting,0,0,0,0,0,0,0,0,12,7,19,12,7,19,0,229,0,0,1,4.17431,0.33945,38.1009,80.8606,109,4
India,259,242.378,7.15058,0.339768,244.568,7.12741,0.30888,363,V Sehwag,0,0,0,0,0,0,0,0,8,15,23,8,15,23,230,230,1,1,1,5.88636,0.238636,38.8295,108.649,88,0
India,259,242.378,7.15058,0.339768,244.568,7.12741,0.30888,363,SR Tendulkar,0,0,0,0,0,0,0,0,8,15,23,8,15,23,230,230,1,1,1,5.89773,0.363636,45.6023,84.5376,88,4
Australia,228,239.627,7.69737,0.372807,232.079,7.23246,0.337719,364,SR Watson,0,0,0,0,0,0,0,0,4,13,17,4,13,17,0,250,2,0,1,4.71318,0.286822,37.7907,90.0943,129,4
Australia,228,239.627,7.69737,0.372807,232.079,7.23246,0.337719,364,SE Marsh,0,0,0,0,0,0,0,0,4,13,17,4,13,17,0,250,2,0,1,3.66667,0.291667,35.5417,74.7918,48,4
India,259,242.378,7.15058,0.339768,244.568,7.12741,0.30888,364,V Sehwag,0,0,0,0,0,0,0,0,32,6,38,32,6,38,251,226,2,1,1,5.88636,0.238636,38.8295,108.649,88,0
India,259,242.378,7.15058,0.339768,244.568,7.12741,0.30888,364,SR Tendulkar,0,0,0,0,0,0,0,0,32,6,38,32,6,38,251,226,2,1,1,5.89773,0.363636,45.6023,84.5376,88,4
Australia,228,239.627,7.69737,0.372807,232.079,7.23246,0.337719,365,SR Watson,0,0,0,0,0,0,0,0,8,13,21,8,13,21,0,350,2,0,1,4.71318,0.286822,37.7907,90.0943,129,4
Australia,228,239.627,7.69737,0.372807,232.079,7.23246,0.337719,365,SE Marsh,0,0,0,0,0,0,0,0,8,13,21,8,13,21,0,350,2,0,1,3.66667,0.291667,35.5417,74.7918,48,4
India,259,242.378,7.15058,0.339768,244.568,7.12741,0.30888,365,V Sehwag,0,0,0,0,0,0,0,0,4,18,22,4,18,22,351,347,2,1,1,5.88636,0.238636,38.8295,108.649,88,0
India,259,242.378,7.15058,0.339768,244.568,7.12741,0.30888,365,SR Tendulkar,0,0,0,0,0,0,0,0,4,18,22,4,18,22,351,347,2,1,1,5.89773,0.363636,45.6023,84.5376,88,4
India,259,242.378,7.15058,0.339768,244.568,7.12741,0.30888,366,V Sehwag,0,0,0,0,0,0,0,0,18,4,22,18,4,22,0,170,1,1,1,5.88636,0.238636,38.8295,108.649,88,0
India,259,242.378,7.15058,0.339768,244.568,7.12741,0.30888,366,G Gambhir,0,0,0,0,0,0,0,0,18,4,22,18,4,22,0,170,1,1,1,3.99145,0.333333,37.4701,84.1944,117,4
India,259,242.378,7.15058,0.339768,244.568,7.12741,0.30888,366,SR Tendulkar,0,0,0,0,0,0,0,0,18,4,22,18,4,22,0,170,1,1,1,5.89773,0.363636,45.6023,84.5376,88,4
India,259,242.378,7.15058,0.339768,244.568,7.12741,0.30888,366,Yuvraj Singh,0,0,0,0,0,0,0,0,18,4,22,18,4,22,0,170,1,1,1,4.05833,0.258333,32.525,83.8093,120,4
Australia,228,239.627,7.69737,0.372807,232.079,7.23246,0.337719,366,SR Watson,0,0,0,0,0,0,0,0,24,3,27,24,3,27,171,172,1,0,1,4.71318,0.286822,37.7907,90.0943,129,4
Australia,228,239.627,7.69737,0.372807,232.079,7.23246,0.337719,366,SE Marsh,0,0,0,0,0,0,0,0,24,3,27,24,3,27,171,172,1,0,1,3.66667,0.291667,35.5417,74.7918,48,4
Australia,228,239.627,7.69737,0.372807,232.079,7.23246,0.337719,366,RT Ponting,0,0,0,0,0,0,0,0,24,3,27,24,3,27,171,172,1,0,1,4.17431,0.33945,38.1009,80.8606,109,4
Bangladesh,160,218.438,7.70625,0.4,211.106,7.05,0.325,367,Tamim Iqbal,0,0,0,0,0,0,0,0,4,4,8,4,4,8,0,186,0,1,1,4.05344,0.274809,31.8015,76.8068,131,4
Bangladesh,160,218.438,7.70625,0.4,211.106,7.05,0.325,367,Junaid Siddique,0,0,0,0,0,0,0,0,4,4,8,4,4,8,0,186,0,1,1,2.16279,0.116279,20.0233,68.225,43,1
Bangladesh,160,218.438,7.70625,0.4,211.106,7.05,0.325,367,Mohammad Ashraful,0,0,0,0,0,0,0,0,4,4,8,4,4,8,0,186,0,1,1,2.17722,0.113924,19.4557,63.9085,79,1
Bangladesh,160,218.438,7.70625,0.4,211.106,7.05,0.325,367,Raqibul Hasan,0,0,0,0,0,0,0,0,4,4,8,4,4,8,0,186,0,1,1,1.85106,0.12766,23.2766,59.2312,47,1
Zimbabwe,142,212.077,7.5,0.380282,227.704,6.97887,0.316901,367,H Masakadza,0,0,0,0,0,0,0,0,18,7,25,18,7,25,187,189,2,0,1,3.11215,0.186916,26.972,70.0485,107,4
Zimbabwe,142,212.077,7.5,0.380282,227.704,6.97887,0.316901,367,CJ Chibhabha,0,0,0,0,0,0,0,0,18,7,25,18,7,25,187,189,2,0,1,2.56716,0.149254,23.5373,64.7373,67,1
Zimbabwe,142,212.077,7.5,0.380282,227.704,6.97887,0.316901,368,H Masakadza,0,0,0,0,0,0,0,0,24,6,30,24,6,30,0,219,0,0,1,3.11215,0.186916,26.972,70.0485,107,4
Zimbabwe,142,212.077,7.5,0.380282,227.704,6.97887,0.316901,368,CJ Chibhabha,0,0,0,0,0,0,0,0,24,6,30,24,6,30,0,219,0,0,1,2.56716,0.149254,23.5373,64.7373,67,1
Bangladesh,160,218.438,7.70625,0.4,211.106,7.05,0.325,368,Tamim Iqbal,0,0,0,0,0,0,0,0,36,13,49,36,13,49,220,221,0,1,1,4.05344,0.274809,31.8015,76.8068,131,4
Bangladesh,160,218.438,7.70625,0.4,211.106,7.05,0.325,368,Junaid Siddique,0,0,0,0,0,0,0,0,36,13,49,36,13,49,220,221,0,1,1,2.16279,0.116279,20.0233,68.225,43,1
Bangladesh,160,218.438,7.70625,0.4,211.106,7.05,0.325,368,Mohammad Ashraful,0,0,0,0,0,0,0,0,36,13,49,36,13,49,220,221,0,1,1,2.17722,0.113924,19.4557,63.9085,79,1
Zimbabwe,142,212.077,7.5,0.380282,227.704,6.97887,0.316901,369,H Masakadza,0,0,0,0,0,0,0,0,16,3,19,16,3,19,0,196,0,0,1,3.11215,0.186916,26.972,70.0485,107,4
Zimbabwe,142,212.077,7.5,0.380282,227.704,6.97887,0.316901,369,BRM Taylor,0,0,0,0,0,0,0,0,16,3,19,16,3,19,0,196,0,0,1,3.3,0.26,33.56,76.3421,100,4
Bangladesh,160,218.438,7.70625,0.4,211.106,7.05,0.325,369,Tamim Iqbal,0,0,0,0,0,0,0,0,12,11,23,12,11,23,197,198,1,1,1,4.05344,0.274809,31.8015,76.8068,131,4
Bangladesh,160,218.438,7.70625,0.4,211.106,7.05,0.325,369,Junaid Siddique,0,0,0,0,0,0,0,0,12,11,23,12,11,23,197,198,1,1,1,2.16279,0.116279,20.0233,68.225,43,1
Bangladesh,160,218.438,7.70625,0.4,211.106,7.05,0.325,369,Mohammad Ashraful,0,0,0,0,0,0,0,0,12,11,23,12,11,23,197,198,1,1,1,2.17722,0.113924,19.4557,63.9085,79,1
Zimbabwe,142,212.077,7.5,0.380282,227.704,6.97887,0.316901,370,H Masakadza,0,0,0,0,0,0,0,0,8,3,11,8,3,11,0,221,0,0,1,3.11215,0.186916,26.972,70.0485,107,4
Zimbabwe,142,212.077,7.5,0.380282,227.704,6.97887,0.316901,370,MA Vermeulen,0,0,0,0,0,0,0,0,8,3,11,8,3,11,0,221,0,0,1,1.85714,0.142857,20.2857,68.2692,7,1
Bangladesh,160,218.438,7.70625,0.4,211.106,7.05,0.325,370,Tamim Iqbal,0,0,0,0,0,0,0,0,12,8,20,12,8,20,222,222,2,1,1,4.05344,0.274809,31.8015,76.8068,131,4
Bangladesh,160,218.438,7.70625,0.4,211.106,7.05,0.325,370,Junaid Siddique,0,0,0,0,0,0,0,0,12,8,20,12,8,20,222,222,2,1,1,2.16279,0.116279,20.0233,68.225,43,1
Bangladesh,160,218.438,7.70625,0.4,211.106,7.05,0.325,370,Mohammad Ashraful,0,0,0,0,0,0,0,0,12,8,20,12,8,20,222,222,2,1,1,2.17722,0.113924,19.4557,63.9085,79,1
Bangladesh,160,218.438,7.70625,0.4,211.106,7.05,0.325,370,Raqibul Hasan,0,0,0,0,0,0,0,0,12,8,20,12,8,20,222,222,2,1,1,1.85106,0.12766,23.2766,59.2312,47,1
New Zealand,184,233.745,7.39674,0.36413,227.951,7.30435,0.353261,371,BB McCullum,0,0,0,0,0,0,0,0,0,5,5,0,5,5,0,336,1,1,1,3.98611,0.201389,29.9028,98.4004,144,0
New Zealand,184,233.745,7.39674,0.36413,227.951,7.30435,0.353261,371,PJ Ingram,0,0,0,0,0,0,0,0,0,5,5,0,5,5,0,336,1,1,1,4.28571,0.142857,27.5714,80.7531,7,4
New Zealand,184,233.745,7.39674,0.36413,227.951,7.30435,0.353261,371,MJ Guptill,0,0,0,0,0,0,0,0,0,5,5,0,5,5,0,336,1,1,1,4.8087,0.313043,38.1217,82.7482,115,4
Bangladesh,160,218.438,7.70625,0.4,211.106,7.05,0.325,371,Tamim Iqbal,0,0,0,0,0,0,0,0,32,3,35,32,3,35,337,190,0,0,1,4.05344,0.274809,31.8015,76.8068,131,4
Bangladesh,160,218.438,7.70625,0.4,211.106,7.05,0.325,371,Imrul Kayes,0,0,0,0,0,0,0,0,32,3,35,32,3,35,337,190,0,0,1,3,0.207547,26.2642,63.6488,53,4
Bangladesh,160,218.438,7.70625,0.4,211.106,7.05,0.325,372,Tamim Iqbal,0,0,0,0,0,0,0,0,4,7,11,4,7,11,0,183,1,0,1,4.05344,0.274809,31.8015,76.8068,131,4
Bangladesh,160,218.438,7.70625,0.4,211.106,7.05,0.325,372,Imrul Kayes,0,0,0,0,0,0,0,0,4,7,11,4,7,11,0,183,1,0,1,3,0.207547,26.2642,63.6488,53,4
Bangladesh,160,218.438,7.70625,0.4,211.106,7.05,0.325,372,Mohammad Ashraful,0,0,0,0,0,0,0,0,4,7,11,4,7,11,0,183,1,0,1,2.17722,0.113924,19.4557,63.9085,79,1
Bangladesh,160,218.438,7.70625,0.4,211.106,7.05,0.325,372,Aftab Ahmed,0,0,0,0,0,0,0,0,4,7,11,4,7,11,0,183,1,0,1,2.44118,0.0882353,19.1471,73.8095,34,1
New Zealand,184,233.745,7.39674,0.36413,227.951,7.30435,0.353261,372,BB McCullum,0,0,0,0,0,0,0,0,22,13,35,22,13,35,184,185,1,1,1,3.98611,0.201389,29.9028,98.4004,144,0
New Zealand,184,233.745,7.39674,0.36413,227.951,7.30435,0.353261,372,PJ Ingram,0,0,0,0,0,0,0,0,22,13,35,22,13,35,184,185,1,1,1,4.28571,0.142857,27.5714,80.7531,7,4
New Zealand,184,233.745,7.39674,0.36413,227.951,7.30435,0.353261,372,MJ Guptill,0,0,0,0,0,0,0,0,22,13,35,22,13,35,184,185,1,1,1,4.8087,0.313043,38.1217,82.7482,115,4
Bangladesh,160,218.438,7.70625,0.4,211.106,7.05,0.325,373,Tamim Iqbal,0,0,0,0,0,0,0,0,20,7,27,20,7,27,0,241,6,0,1,4.05344,0.274809,31.8015,76.8068,131,4
Bangladesh,160,218.438,7.70625,0.4,211.106,7.05,0.325,373,Imrul Kayes,0,0,0,0,0,0,0,0,20,7,27,20,7,27,0,241,6,0,1,3,0.207547,26.2642,63.6488,53,4
Bangladesh,160,218.438,7.70625,0.4,211.106,7.05,0.325,373,Aftab Ahmed,0,0,0,0,0,0,0,0,20,7,27,20,7,27,0,241,6,0,1,2.44118,0.0882353,19.1471,73.8095,34,1
New Zealand,184,233.745,7.39674,0.36413,227.951,7.30435,0.353261,373,BB McCullum,0,0,0,0,0,0,0,0,24,9,33,24,9,33,242,244,4,1,1,3.98611,0.201389,29.9028,98.4004,144,0
New Zealand,184,233.745,7.39674,0.36413,227.951,7.30435,0.353261,373,PJ Ingram,0,0,0,0,0,0,0,0,24,9,33,24,9,33,242,244,4,1,1,4.28571,0.142857,27.5714,80.7531,7,4
Australia,228,239.627,7.69737,0.372807,232.079,7.23246,0.337719,374,SR Watson,0,0,0,0,0,0,0,0,28,11,39,28,11,39,0,275,0,0,1,4.71318,0.286822,37.7907,90.0943,129,4
Australia,228,239.627,7.69737,0.372807,232.079,7.23246,0.337719,374,BJ Haddin,0,0,0,0,0,0,0,0,28,11,39,28,11,39,0,275,0,0,1,3.14737,0.147368,26.7789,81.382,95,4
New Zealand,184,233.745,7.39674,0.36413,227.951,7.30435,0.353261,374,BB McCullum,0,0,0,0,0,0,0,0,24,6,30,24,6,30,276,281,2,1,1,3.98611,0.201389,29.9028,98.4004,144,0
New Zealand,184,233.745,7.39674,0.36413,227.951,7.30435,0.353261,374,PJ Ingram,0,0,0,0,0,0,0,0,24,6,30,24,6,30,276,281,2,1,1,4.28571,0.142857,27.5714,80.7531,7,4
Australia,228,239.627,7.69737,0.372807,232.079,7.23246,0.337719,375,SR Watson,0,0,0,0,0,0,0,0,4,9,13,4,9,13,0,273,1,0,1,4.71318,0.286822,37.7907,90.0943,129,4
Australia,228,239.627,7.69737,0.372807,232.079,7.23246,0.337719,375,BJ Haddin,0,0,0,0,0,0,0,0,4,9,13,4,9,13,0,273,1,0,1,3.14737,0.147368,26.7789,81.382,95,4
New Zealand,184,233.745,7.39674,0.36413,227.951,7.30435,0.353261,375,BB McCullum,0,0,0,0,0,0,0,0,24,2,26,24,2,26,274,253,1,1,1,3.98611,0.201389,29.9028,98.4004,144,0
New Zealand,184,233.745,7.39674,0.36413,227.951,7.30435,0.353261,375,PJ Ingram,0,0,0,0,0,0,0,0,24,2,26,24,2,26,274,253,1,1,1,4.28571,0.142857,27.5714,80.7531,7,4
New Zealand,184,233.745,7.39674,0.36413,227.951,7.30435,0.353261,375,MJ Guptill,0,0,0,0,0,0,0,0,24,2,26,24,2,26,274,253,1,1,1,4.8087,0.313043,38.1217,82.7482,115,4
New Zealand,184,233.745,7.39674,0.36413,227.951,7.30435,0.353261,376,BB McCullum,0,0,0,0,0,0,0,0,20,12,32,20,12,32,0,245,2,1,1,3.98611,0.201389,29.9028,98.4004,144,0
New Zealand,184,233.745,7.39674,0.36413,227.951,7.30435,0.353261,376,PJ Ingram,0,0,0,0,0,0,0,0,20,12,32,20,12,32,0,245,2,1,1,4.28571,0.142857,27.5714,80.7531,7,4
New Zealand,184,233.745,7.39674,0.36413,227.951,7.30435,0.353261,376,MJ Guptill,0,0,0,0,0,0,0,0,20,12,32,20,12,32,0,245,2,1,1,4.8087,0.313043,38.1217,82.7482,115,4
Australia,228,239.627,7.69737,0.372807,232.079,7.23246,0.337719,376,SR Watson,0,0,0,0,0,0,0,0,8,5,13,8,5,13,246,248,1,0,1,4.71318,0.286822,37.7907,90.0943,129,4
Australia,228,239.627,7.69737,0.372807,232.079,7.23246,0.337719,376,BJ Haddin,0,0,0,0,0,0,0,0,8,5,13,8,5,13,246,248,1,0,1,3.14737,0.147368,26.7789,81.382,95,4
New Zealand,184,233.745,7.39674,0.36413,227.951,7.30435,0.353261,377,BB McCullum,0,0,0,0,0,0,0,0,22,13,35,22,13,35,0,238,1,1,1,3.98611,0.201389,29.9028,98.4004,144,0
New Zealand,184,233.745,7.39674,0.36413,227.951,7.30435,0.353261,377,MJ Guptill,0,0,0,0,0,0,0,0,22,13,35,22,13,35,0,238,1,1,1,4.8087,0.313043,38.1217,82.7482,115,4
Australia,228,239.627,7.69737,0.372807,232.079,7.23246,0.337719,377,SR Watson,0,0,0,0,0,0,0,0,16,6,22,16,6,22,239,202,2,0,1,4.71318,0.286822,37.7907,90.0943,129,4
Australia,228,239.627,7.69737,0.372807,232.079,7.23246,0.337719,377,BJ Haddin,0,0,0,0,0,0,0,0,16,6,22,16,6,22,239,202,2,0,1,3.14737,0.147368,26.7789,81.382,95,4
Australia,228,239.627,7.69737,0.372807,232.079,7.23246,0.337719,377,RT Ponting,0,0,0,0,0,0,0,0,16,6,22,16,6,22,239,202,2,0,1,4.17431,0.33945,38.1009,80.8606,109,4
New Zealand,184,233.745,7.39674,0.36413,227.951,7.30435,0.353261,378,BB McCullum,0,0,0,0,0,0,0,0,6,5,11,6,5,11,0,241,14,1,1,3.98611,0.201389,29.9028,98.4004,144,0
New Zealand,184,233.745,7.39674,0.36413,227.951,7.30435,0.353261,378,MJ Guptill,0,0,0,0,0,0,0,0,6,5,11,6,5,11,0,241,14,1,1,4.8087,0.313043,38.1217,82.7482,115,4
New Zealand,184,233.745,7.39674,0.36413,227.951,7.30435,0.353261,378,LRPL Taylor,0,0,0,0,0,0,0,0,6,5,11,6,5,11,0,241,14,1,1,3.68382,0.301471,36.7206,79.3959,136,4
Australia,228,239.627,7.69737,0.372807,232.079,7.23246,0.337719,378,SR Watson,0,0,0,0,0,0,0,0,12,10,22,12,10,22,242,190,0,0,1,4.71318,0.286822,37.7907,90.0943,129,4
Australia,228,239.627,7.69737,0.372807,232.079,7.23246,0.337719,378,BJ Haddin,0,0,0,0,0,0,0,0,12,10,22,12,10,22,242,190,0,0,1,3.14737,0.147368,26.7789,81.382,95,4
Australia,228,239.627,7.69737,0.372807,232.079,7.23246,0.337719,379,SR Watson,0,0,0,0,0,0,0,0,12,10,22,12,10,22,0,267,0,0,1,4.71318,0.286822,37.7907,90.0943,129,4
Australia,228,239.627,7.69737,0.372807,232.079,7.23246,0.337719,379,TD Paine,0,0,0,0,0,0,0,0,12,10,22,12,10,22,0,267,0,0,1,3.3913,0.217391,27.6522,65.7704,23,4
England,221,237.176,7.17647,0.289593,230.633,7.45701,0.384615,379,AJ Strauss,0,0,0,0,0,0,0,0,16,5,21,16,5,21,268,268,2,1,1,3.93243,0.27027,33.9054,79.8028,74,4
England,221,237.176,7.17647,0.289593,230.633,7.45701,0.384615,379,C Kieswetter,0,0,0,0,0,0,0,0,16,5,21,16,5,21,268,268,2,1,1,3.43243,0.135135,26.4324,88.0288,37,4
England,221,237.176,7.17647,0.289593,230.633,7.45701,0.384615,379,KP Pietersen,0,0,0,0,0,0,0,0,16,5,21,16,5,21,268,268,2,1,1,3.69892,0.236559,33.4946,82.2117,93,4
Australia,228,239.627,7.69737,0.372807,232.079,7.23246,0.337719,380,SR Watson,0,0,0,0,0,0,0,0,28,6,34,28,6,34,0,239,0,0,1,4.71318,0.286822,37.7907,90.0943,129,4
Australia,228,239.627,7.69737,0.372807,232.079,7.23246,0.337719,380,TD Paine,0,0,0,0,0,0,0,0,28,6,34,28,6,34,0,239,0,0,1,3.3913,0.217391,27.6522,65.7704,23,4
England,221,237.176,7.17647,0.289593,230.633,7.45701,0.384615,380,AJ Strauss,0,0,0,0,0,0,0,0,22,7,29,22,7,29,240,243,4,1,1,3.93243,0.27027,33.9054,79.8028,74,4
England,221,237.176,7.17647,0.289593,230.633,7.45701,0.384615,380,C Kieswetter,0,0,0,0,0,0,0,0,22,7,29,22,7,29,240,243,4,1,1,3.43243,0.135135,26.4324,88.0288,37,4
England,221,237.176,7.17647,0.289593,230.633,7.45701,0.384615,380,KP Pietersen,0,0,0,0,0,0,0,0,22,7,29,22,7,29,240,243,4,1,1,3.69892,0.236559,33.4946,82.2117,93,4
Australia,228,239.627,7.69737,0.372807,232.079,7.23246,0.337719,381,SR Watson,0,0,0,0,0,0,0,0,12,3,15,12,3,15,0,212,1,0,1,4.71318,0.286822,37.7907,90.0943,129,4
Australia,228,239.627,7.69737,0.372807,232.079,7.23246,0.337719,381,TD Paine,0,0,0,0,0,0,0,0,12,3,15,12,3,15,0,212,1,0,1,3.3913,0.217391,27.6522,65.7704,23,4
England,221,237.176,7.17647,0.289593,230.633,7.45701,0.384615,381,AJ Strauss,0,0,0,0,0,0,0,0,4,7,11,4,7,11,213,214,1,1,1,3.93243,0.27027,33.9054,79.8028,74,4
England,221,237.176,7.17647,0.289593,230.633,7.45701,0.384615,381,C Kieswetter,0,0,0,0,0,0,0,0,4,7,11,4,7,11,213,214,1,1,1,3.43243,0.135135,26.4324,88.0288,37,4
England,221,237.176,7.17647,0.289593,230.633,7.45701,0.384615,381,KP Pietersen,0,0,0,0,0,0,0,0,4,7,11,4,7,11,213,214,1,1,1,3.69892,0.236559,33.4946,82.2117,93,4
Australia,228,239.627,7.69737,0.372807,232.079,7.23246,0.337719,382,SR Watson,0,0,0,0,0,0,0,0,12,8,20,12,8,20,0,290,1,0,1,4.71318,0.286822,37.7907,90.0943,129,4
Australia,228,239.627,7.69737,0.372807,232.079,7.23246,0.337719,382,TD Paine,0,0,0,0,0,0,0,0,12,8,20,12,8,20,0,290,1,0,1,3.3913,0.217391,27.6522,65.7704,23,4
England,221,237.176,7.17647,0.289593,230.633,7.45701,0.384615,382,AJ Strauss,0,0,0,0,0,0,0,0,12,6,18,12,6,18,291,212,3,1,1,3.93243,0.27027,33.9054,79.8028,74,4
England,221,237.176,7.17647,0.289593,230.633,7.45701,0.384615,382,C Kieswetter,0,0,0,0,0,0,0,0,12,6,18,12,6,18,291,212,3,1,1,3.43243,0.135135,26.4324,88.0288,37,4
Australia,228,239.627,7.69737,0.372807,232.079,7.23246,0.337719,383,SR Watson,0,0,0,0,0,0,0,0,8,6,14,8,6,14,0,277,1,0,1,4.71318,0.286822,37.7907,90.0943,129,4
Australia,228,239.627,7.69737,0.372807,232.079,7.23246,0.337719,383,TD Paine,0,0,0,0,0,0,0,0,8,6,14,8,6,14,0,277,1,0,1,3.3913,0.217391,27.6522,65.7704,23,4
England,221,237.176,7.17647,0.289593,230.633,7.45701,0.384615,383,AJ Strauss,0,0,0,0,0,0,0,0,4,10,14,4,10,14,278,235,8,1,1,3.93243,0.27027,33.9054,79.8028,74,4
England,221,237.176,7.17647,0.289593,230.633,7.45701,0.384615,383,C Kieswetter,0,0,0,0,0,0,0,0,4,10,14,4,10,14,278,235,8,1,1,3.43243,0.135135,26.4324,88.0288,37,4
England,221,237.176,7.17647,0.289593,230.633,7.45701,0.384615,383,MH Yardy,0,0,0,0,0,0,0,0,4,10,14,4,10,14,278,235,8,1,1,0.875,0.0833333,13.5833,66.5306,24,1
England,221,237.176,7.17647,0.289593,230.633,7.45701,0.384615,383,PD Collingwood,0,0,0,0,0,0,0,0,4,10,14,4,10,14,278,235,8,1,1,2.62366,0.193548,30.5161,76.8065,93,4
Bangladesh,160,218.438,7.70625,0.4,211.106,7.05,0.325,384,Tamim Iqbal,0,0,0,0,0,0,0,0,20,14,34,20,14,34,0,250,3,0,1,4.05344,0.274809,31.8015,76.8068,131,4
Bangladesh,160,218.438,7.70625,0.4,211.106,7.05,0.325,384,Imrul Kayes,0,0,0,0,0,0,0,0,20,14,34,20,14,34,0,250,3,0,1,3,0.207547,26.2642,63.6488,53,4
England,221,237.176,7.17647,0.289593,230.633,7.45701,0.384615,384,AJ Strauss,0,0,0,0,0,0,0,0,16,7,23,16,7,23,251,251,3,1,1,3.93243,0.27027,33.9054,79.8028,74,4
England,221,237.176,7.17647,0.289593,230.633,7.45701,0.384615,384,C Kieswetter,0,0,0,0,0,0,0,0,16,7,23,16,7,23,251,251,3,1,1,3.43243,0.135135,26.4324,88.0288,37,4
Bangladesh,160,218.438,7.70625,0.4,211.106,7.05,0.325,385,Tamim Iqbal,0,0,0,0,0,0,0,0,12,7,19,12,7,19,0,236,0,0,1,4.05344,0.274809,31.8015,76.8068,131,4
Bangladesh,160,218.438,7.70625,0.4,211.106,7.05,0.325,385,Imrul Kayes,0,0,0,0,0,0,0,0,12,7,19,12,7,19,0,236,0,0,1,3,0.207547,26.2642,63.6488,53,4
England,221,237.176,7.17647,0.289593,230.633,7.45701,0.384615,385,AJ Strauss,0,0,0,0,0,0,0,0,10,9,19,10,9,19,237,231,0,1,1,3.93243,0.27027,33.9054,79.8028,74,4
England,221,237.176,7.17647,0.289593,230.633,7.45701,0.384615,385,C Kieswetter,0,0,0,0,0,0,0,0,10,9,19,10,9,19,237,231,0,1,1,3.43243,0.135135,26.4324,88.0288,37,4
England,221,237.176,7.17647,0.289593,230.633,7.45701,0.384615,386,AJ Strauss,0,0,0,0,0,0,0,0,18,9,27,18,9,27,0,347,0,1,1,3.93243,0.27027,33.9054,79.8028,74,4
England,221,237.176,7.17647,0.289593,230.633,7.45701,0.384615,386,C Kieswetter,0,0,0,0,0,0,0,0,18,9,27,18,9,27,0,347,0,1,1,3.43243,0.135135,26.4324,88.0288,37,4
England,221,237.176,7.17647,0.289593,230.633,7.45701,0.384615,386,IJL Trott,0,0,0,0,0,0,0,0,18,9,27,18,9,27,0,347,0,1,1,3.3871,0.403226,43.7903,75.2494,62,4
Bangladesh,160,218.438,7.70625,0.4,211.106,7.05,0.325,386,Tamim Iqbal,0,0,0,0,0,0,0,0,20,4,24,20,4,24,348,203,0,0,1,4.05344,0.274809,31.8015,76.8068,131,4
Bangladesh,160,218.438,7.70625,0.4,211.106,7.05,0.325,386,Imrul Kayes,0,0,0,0,0,0,0,0,20,4,24,20,4,24,348,203,0,0,1,3,0.207547,26.2642,63.6488,53,4
Bangladesh,160,218.438,7.70625,0.4,211.106,7.05,0.325,386,Junaid Siddique,0,0,0,0,0,0,0,0,20,4,24,20,4,24,348,203,0,0,1,2.16279,0.116279,20.0233,68.225,43,1
Bangladesh,160,218.438,7.70625,0.4,211.106,7.05,0.325,387,Tamim Iqbal,0,0,0,0,0,0,0,0,22,4,26,22,4,26,0,228,1,1,1,4.05344,0.274809,31.8015,76.8068,131,4
Bangladesh,160,218.438,7.70625,0.4,211.106,7.05,0.325,387,Imrul Kayes,0,0,0,0,0,0,0,0,22,4,26,22,4,26,0,228,1,1,1,3,0.207547,26.2642,63.6488,53,4
England,221,237.176,7.17647,0.289593,230.633,7.45701,0.384615,387,AN Cook,0,0,0,0,0,0,0,0,20,14,34,20,14,34,229,229,0,0,1,4.17045,0.272727,35.75,75.5524,88,4
England,221,237.176,7.17647,0.289593,230.633,7.45701,0.384615,387,C Kieswetter,0,0,0,0,0,0,0,0,20,14,34,20,14,34,229,229,0,0,1,3.43243,0.135135,26.4324,88.0288,37,4
England,221,237.176,7.17647,0.289593,230.633,7.45701,0.384615,388,AN Cook,0,0,0,0,0,0,0,0,12,7,19,12,7,19,0,284,6,0,1,4.17045,0.272727,35.75,75.5524,88,4
England,221,237.176,7.17647,0.289593,230.633,7.45701,0.384615,388,C Kieswetter,0,0,0,0,0,0,0,0,12,7,19,12,7,19,0,284,6,0,1,3.43243,0.135135,26.4324,88.0288,37,4
Bangladesh,160,218.438,7.70625,0.4,211.106,7.05,0.325,388,Tamim Iqbal,0,0,0,0,0,0,0,0,8,6,14,8,6,14,285,239,1,1,1,4.05344,0.274809,31.8015,76.8068,131,4
Bangladesh,160,218.438,7.70625,0.4,211.106,7.05,0.325,388,Aftab Ahmed,0,0,0,0,0,0,0,0,8,6,14,8,6,14,285,239,1,1,1,2.44118,0.0882353,19.1471,73.8095,34,1
Bangladesh,160,218.438,7.70625,0.4,211.106,7.05,0.325,388,Imrul Kayes,0,0,0,0,0,0,0,0,8,6,14,8,6,14,285,239,1,1,1,3,0.207547,26.2642,63.6488,53,4
England,221,237.176,7.17647,0.289593,230.633,7.45701,0.384615,389,AJ Strauss,0,0,0,0,0,0,0,0,16,7,23,16,7,23,0,274,1,1,1,3.93243,0.27027,33.9054,79.8028,74,4
England,221,237.176,7.17647,0.289593,230.633,7.45701,0.384615,389,SM Davies,0,0,0,0,0,0,0,0,16,7,23,16,7,23,0,274,1,1,1,4.5,0.125,30.125,100.837,8,0
Pakistan,211,222.621,7.38389,0.393365,235.517,7.54976,0.336493,389,Kamran Akmal,0,0,0,0,0,0,0,0,8,8,16,8,8,16,275,250,1,0,1,3.01124,0.11236,23.0787,81.4433,89,4
Pakistan,211,222.621,7.38389,0.393365,235.517,7.54976,0.336493,389,Mohammad Hafeez,0,0,0,0,0,0,0,0,8,8,16,8,8,16,275,250,1,0,1,4.04511,0.255639,34.3534,78.0625,133,4
Pakistan,211,222.621,7.38389,0.393365,235.517,7.54976,0.336493,390,Kamran Akmal,0,0,0,0,0,0,0,0,24,4,28,24,4,28,0,294,3,0,1,3.01124,0.11236,23.0787,81.4433,89,4
Pakistan,211,222.621,7.38389,0.393365,235.517,7.54976,0.336493,390,Mohammad Hafeez,0,0,0,0,0,0,0,0,24,4,28,24,4,28,0,294,3,0,1,4.04511,0.255639,34.3534,78.0625,133,4
England,221,237.176,7.17647,0.289593,230.633,7.45701,0.384615,390,AJ Strauss,0,0,0,0,0,0,0,0,20,11,31,20,11,31,295,295,0,1,1,3.93243,0.27027,33.9054,79.8028,74,4
England,221,237.176,7.17647,0.289593,230.633,7.45701,0.384615,390,SM Davies,0,0,0,0,0,0,0,0,20,11,31,20,11,31,295,295,0,1,1,4.5,0.125,30.125,100.837,8,0
Pakistan,211,222.621,7.38389,0.393365,235.517,7.54976,0.336493,391,Kamran Akmal,0,0,0,0,0,0,0,0,4,7,11,4,7,11,0,241,2,0,1,3.01124,0.11236,23.0787,81.4433,89,4
Pakistan,211,222.621,7.38389,0.393365,235.517,7.54976,0.336493,391,Mohammad Hafeez,0,0,0,0,0,0,0,0,4,7,11,4,7,11,0,241,2,0,1,4.04511,0.255639,34.3534,78.0625,133,4
Pakistan,211,222.621,7.38389,0.393365,235.517,7.54976,0.336493,391,Mohammad Yousuf,0,0,0,0,0,0,0,0,4,7,11,4,7,11,0,241,2,0,1,3.27586,0.275862,36.7931,73.9176,58,4
Pakistan,211,222.621,7.38389,0.393365,235.517,7.54976,0.336493,391,Asad Shafiq,0,0,0,0,0,0,0,0,4,7,11,4,7,11,0,241,2,0,1,2.07843,0.176471,24.7843,67.1269,51,4
England,221,237.176,7.17647,0.289593,230.633,7.45701,0.384615,391,AJ Strauss,0,0,0,0,0,0,0,0,20,8,28,20,8,28,242,218,0,1,1,3.93243,0.27027,33.9054,79.8028,74,4
England,221,237.176,7.17647,0.289593,230.633,7.45701,0.384615,391,SM Davies,0,0,0,0,0,0,0,0,20,8,28,20,8,28,242,218,0,1,1,4.5,0.125,30.125,100.837,8,0
Pakistan,211,222.621,7.38389,0.393365,235.517,7.54976,0.336493,392,Kamran Akmal,0,0,0,0,0,0,0,0,12,5,17,12,5,17,0,265,1,0,1,3.01124,0.11236,23.0787,81.4433,89,4
Pakistan,211,222.621,7.38389,0.393365,235.517,7.54976,0.336493,392,Mohammad Hafeez,0,0,0,0,0,0,0,0,12,5,17,12,5,17,0,265,1,0,1,4.04511,0.255639,34.3534,78.0625,133,4
England,221,237.176,7.17647,0.289593,230.633,7.45701,0.384615,392,AJ Strauss,0,0,0,0,0,0,0,0,28,6,34,28,6,34,266,227,2,1,1,3.93243,0.27027,33.9054,79.8028,74,4
England,221,237.176,7.17647,0.289593,230.633,7.45701,0.384615,392,SM Davies,0,0,0,0,0,0,0,0,28,6,34,28,6,34,266,227,2,1,1,4.5,0.125,30.125,100.837,8,0
England,221,237.176,7.17647,0.289593,230.633,7.45701,0.384615,393,AJ Strauss,0,0,0,0,0,0,0,0,20,8,28,20,8,28,0,256,1,1,1,3.93243,0.27027,33.9054,79.8028,74,4
England,221,237.176,7.17647,0.289593,230.633,7.45701,0.384615,393,SM Davies,0,0,0,0,0,0,0,0,20,8,28,20,8,28,0,256,1,1,1,4.5,0.125,30.125,100.837,8,0
Pakistan,211,222.621,7.38389,0.393365,235.517,7.54976,0.336493,393,Kamran Akmal,0,0,0,0,0,0,0,0,16,8,24,16,8,24,257,135,1,0,1,3.01124,0.11236,23.0787,81.4433,89,4
Pakistan,211,222.621,7.38389,0.393365,235.517,7.54976,0.336493,393,Mohammad Hafeez,0,0,0,0,0,0,0,0,16,8,24,16,8,24,257,135,1,0,1,4.04511,0.255639,34.3534,78.0625,133,4
Pakistan,211,222.621,7.38389,0.393365,235.517,7.54976,0.336493,394,Salman Butt,0,0,0,0,0,0,0,0,4,9,13,4,9,13,0,287,2,0,1,5.4359,0.384615,42.3846,78.8645,39,4
Pakistan,211,222.621,7.38389,0.393365,235.517,7.54976,0.336493,394,Younis Khan,0,0,0,0,0,0,0,0,4,9,13,4,9,13,0,287,2,0,1,2.64655,0.215517,28.5,73.2713,116,4
Pakistan,211,222.621,7.38389,0.393365,235.517,7.54976,0.336493,394,Khalid Latif,0,0,0,0,0,0,0,0,4,9,13,4,9,13,0,287,2,0,1,2.6,0.2,29.4,63.0901,5,4
Pakistan,211,222.621,7.38389,0.393365,235.517,7.54976,0.336493,394,Mohammad Yousuf,0,0,0,0,0,0,0,0,4,9,13,4,9,13,0,287,2,0,1,3.27586,0.275862,36.7931,73.9176,58,4
New Zealand,184,233.745,7.39674,0.36413,227.951,7.30435,0.353261,394,BB McCullum,0,0,0,0,0,0,0,0,8,4,12,8,4,12,288,149,4,0,1,3.98611,0.201389,29.9028,98.4004,144,0
New Zealand,184,233.745,7.39674,0.36413,227.951,7.30435,0.353261,394,AJ Redmond,0,0,0,0,0,0,0,0,8,4,12,8,4,12,288,149,4,0,1,3.16667,0.166667,25.3333,57.1429,6,3
New Zealand,184,233.745,7.39674,0.36413,227.951,7.30435,0.353261,395,BB McCullum,0,0,0,0,0,0,0,0,12,9,21,12,9,21,0,303,4,0,1,3.98611,0.201389,29.9028,98.4004,144,0
New Zealand,184,233.745,7.39674,0.36413,227.951,7.30435,0.353261,395,AJ Redmond,0,0,0,0,0,0,0,0,12,9,21,12,9,21,0,303,4,0,1,3.16667,0.166667,25.3333,57.1429,6,3
New Zealand,184,233.745,7.39674,0.36413,227.951,7.30435,0.353261,395,MJ Guptill,0,0,0,0,0,0,0,0,12,9,21,12,9,21,0,303,4,0,1,4.8087,0.313043,38.1217,82.7482,115,4
Pakistan,211,222.621,7.38389,0.393365,235.517,7.54976,0.336493,395,Salman Butt,0,0,0,0,0,0,0,0,8,7,15,8,7,15,304,239,1,0,1,5.4359,0.384615,42.3846,78.8645,39,4
Pakistan,211,222.621,7.38389,0.393365,235.517,7.54976,0.336493,395,Khalid Latif,0,0,0,0,0,0,0,0,8,7,15,8,7,15,304,239,1,0,1,2.6,0.2,29.4,63.0901,5,4
New Zealand,184,233.745,7.39674,0.36413,227.951,7.30435,0.353261,396,BB McCullum,0,0,0,0,0,0,0,0,8,10,18,8,10,18,0,211,1,0,1,3.98611,0.201389,29.9028,98.4004,144,0
New Zealand,184,233.745,7.39674,0.36413,227.951,7.30435,0.353261,396,AJ Redmond,0,0,0,0,0,0,0,0,8,10,18,8,10,18,0,211,1,0,1,3.16667,0.166667,25.3333,57.1429,6,3
Pakistan,211,222.621,7.38389,0.393365,235.517,7.54976,0.336493,396,Salman Butt,0,0,0,0,0,0,0,0,20,8,28,20,8,28,212,204,3,0,1,5.4359,0.384615,42.3846,78.8645,39,4
Pakistan,211,222.621,7.38389,0.393365,235.517,7.54976,0.336493,396,Khalid Latif,0,0,0,0,0,0,0,0,20,8,28,20,8,28,212,204,3,0,1,2.6,0.2,29.4,63.0901,5,4
South Africa,190,234.274,7.4,0.373684,232.363,7.33158,0.342105,397,GC Smith,0,0,0,0,0,0,0,0,14,8,22,14,8,22,0,331,2,1,1,3.97,0.29,33.57,79.6819,100,4
South Africa,190,234.274,7.4,0.373684,232.363,7.33158,0.342105,397,JH Kallis,0,0,0,0,0,0,0,0,14,8,22,14,8,22,0,331,2,1,1,3.58621,0.356322,37.2644,76.4442,87,4
Zimbabwe,142,212.077,7.5,0.380282,227.704,6.97887,0.316901,397,H Masakadza,0,0,0,0,0,0,0,0,8,3,11,8,3,11,332,119,1,0,1,3.11215,0.186916,26.972,70.0485,107,4
Zimbabwe,142,212.077,7.5,0.380282,227.704,6.97887,0.316901,397,BRM Taylor,0,0,0,0,0,0,0,0,8,3,11,8,3,11,332,119,1,0,1,3.3,0.26,33.56,76.3421,100,4
Zimbabwe,142,212.077,7.5,0.380282,227.704,6.97887,0.316901,397,T Taibu,0,0,0,0,0,0,0,0,8,3,11,8,3,11,332,119,1,0,1,2.36364,0.254545,29.4,71.0145,55,4
Zimbabwe,142,212.077,7.5,0.380282,227.704,6.97887,0.316901,397,S Matsikenyeri,0,0,0,0,0,0,0,0,8,3,11,8,3,11,332,119,1,0,1,2,0.106383,19.9787,75.7869,47,1
India,259,242.378,7.15058,0.339768,244.568,7.12741,0.30888,398,V Sehwag,0,0,0,0,0,0,0,0,16,3,19,16,3,19,0,414,0,1,1,5.88636,0.238636,38.8295,108.649,88,0
India,259,242.378,7.15058,0.339768,244.568,7.12741,0.30888,398,SR Tendulkar,0,0,0,0,0,0,0,0,16,3,19,16,3,19,0,414,0,1,1,5.89773,0.363636,45.6023,84.5376,88,4
Sri Lanka,244,223.373,7.09016,0.344262,227.578,7.47541,0.385246,398,WU Tharanga,0,0,0,0,0,0,0,0,16,7,23,16,7,23,415,411,2,0,1,3.93985,0.263158,32.9699,71.6035,133,4
Sri Lanka,244,223.373,7.09016,0.344262,227.578,7.47541,0.385246,398,TM Dilshan,0,0,0,0,0,0,0,0,16,7,23,16,7,23,415,411,2,0,1,4.60199,0.273632,38.3632,86.0219,201,4
India,259,242.378,7.15058,0.339768,244.568,7.12741,0.30888,399,V Sehwag,0,0,0,0,0,0,0,0,8,12,20,8,12,20,0,301,1,1,1,5.88636,0.238636,38.8295,108.649,88,0
India,259,242.378,7.15058,0.339768,244.568,7.12741,0.30888,399,G Gambhir,0,0,0,0,0,0,0,0,8,12,20,8,12,20,0,301,1,1,1,3.99145,0.333333,37.4701,84.1944,117,4
India,259,242.378,7.15058,0.339768,244.568,7.12741,0.30888,399,SR Tendulkar,0,0,0,0,0,0,0,0,8,12,20,8,12,20,0,301,1,1,1,5.89773,0.363636,45.6023,84.5376,88,4
Sri Lanka,244,223.373,7.09016,0.344262,227.578,7.47541,0.385246,399,WU Tharanga,0,0,0,0,0,0,0,0,20,9,29,20,9,29,302,302,2,0,1,3.93985,0.263158,32.9699,71.6035,133,4
Sri Lanka,244,223.373,7.09016,0.344262,227.578,7.47541,0.385246,399,TM Dilshan,0,0,0,0,0,0,0,0,20,9,29,20,9,29,302,302,2,0,1,4.60199,0.273632,38.3632,86.0219,201,4
Sri Lanka,244,223.373,7.09016,0.344262,227.578,7.47541,0.385246,400,WU Tharanga,0,0,0,0,0,0,0,0,46,8,54,46,8,54,0,239,5,0,1,3.93985,0.263158,32.9699,71.6035,133,4
Sri Lanka,244,223.373,7.09016,0.344262,227.578,7.47541,0.385246,400,TM Dilshan,0,0,0,0,0,0,0,0,46,8,54,46,8,54,0,239,5,0,1,4.60199,0.273632,38.3632,86.0219,201,4
India,259,242.378,7.15058,0.339768,244.568,7.12741,0.30888,400,V Sehwag,0,0,0,0,0,0,0,0,20,7,27,20,7,27,240,243,0,1,1,5.88636,0.238636,38.8295,108.649,88,0
India,259,242.378,7.15058,0.339768,244.568,7.12741,0.30888,400,SR Tendulkar,0,0,0,0,0,0,0,0,20,7,27,20,7,27,240,243,0,1,1,5.89773,0.363636,45.6023,84.5376,88,4
Sri Lanka,244,223.373,7.09016,0.344262,227.578,7.47541,0.385246,401,WU Tharanga,0,0,0,0,0,0,0,0,0,7,7,0,7,7,0,315,2,0,1,3.93985,0.263158,32.9699,71.6035,133,4
Sri Lanka,244,223.373,7.09016,0.344262,227.578,7.47541,0.385246,401,TM Dilshan,0,0,0,0,0,0,0,0,0,7,7,0,7,7,0,315,2,0,1,4.60199,0.273632,38.3632,86.0219,201,4
India,259,242.378,7.15058,0.339768,244.568,7.12741,0.30888,401,V Sehwag,0,0,0,0,0,0,0,0,20,3,23,20,3,23,316,317,14,1,1,5.88636,0.238636,38.8295,108.649,88,0
India,259,242.378,7.15058,0.339768,244.568,7.12741,0.30888,401,SR Tendulkar,0,0,0,0,0,0,0,0,20,3,23,20,3,23,316,317,14,1,1,5.89773,0.363636,45.6023,84.5376,88,4
India,259,242.378,7.15058,0.339768,244.568,7.12741,0.30888,401,G Gambhir,0,0,0,0,0,0,0,0,20,3,23,20,3,23,316,317,14,1,1,3.99145,0.333333,37.4701,84.1944,117,4
India,259,242.378,7.15058,0.339768,244.568,7.12741,0.30888,401,V Kohli,0,0,0,0,0,0,0,0,20,3,23,20,3,23,316,317,14,1,1,4.66456,0.379747,44.9937,88.3325,158,4
India,259,242.378,7.15058,0.339768,244.568,7.12741,0.30888,402,V Sehwag,0,0,0,0,0,0,0,0,24,12,36,24,12,36,0,370,2,0,1,5.88636,0.238636,38.8295,108.649,88,0
India,259,242.378,7.15058,0.339768,244.568,7.12741,0.30888,402,SR Tendulkar,0,0,0,0,0,0,0,0,24,12,36,24,12,36,0,370,2,0,1,5.89773,0.363636,45.6023,84.5376,88,4
Bangladesh,160,218.438,7.70625,0.4,211.106,7.05,0.325,402,Tamim Iqbal,0,0,0,0,0,0,0,0,28,8,36,28,8,36,371,283,15,1,1,4.05344,0.274809,31.8015,76.8068,131,4
Bangladesh,160,218.438,7.70625,0.4,211.106,7.05,0.325,402,Imrul Kayes,0,0,0,0,0,0,0,0,28,8,36,28,8,36,371,283,15,1,1,3,0.207547,26.2642,63.6488,53,4
Australia,228,239.627,7.69737,0.372807,232.079,7.23246,0.337719,405,SR Watson,0,0,0,0,0,0,0,0,4,10,14,4,10,14,0,262,1,0,1,4.71318,0.286822,37.7907,90.0943,129,4
Australia,228,239.627,7.69737,0.372807,232.079,7.23246,0.337719,405,BJ Haddin,0,0,0,0,0,0,0,0,4,10,14,4,10,14,0,262,1,0,1,3.14737,0.147368,26.7789,81.382,95,4
Zimbabwe,142,212.077,7.5,0.380282,227.704,6.97887,0.316901,405,BRM Taylor,0,0,0,0,0,0,0,0,10,10,20,10,10,20,263,171,2,0,1,3.3,0.26,33.56,76.3421,100,4
Zimbabwe,142,212.077,7.5,0.380282,227.704,6.97887,0.316901,405,CK Coventry,0,0,0,0,0,0,0,0,10,10,20,10,10,20,263,171,2,0,1,3.33333,0.166667,29.3889,90.273,18,4
West Indies,176,217.33,7.15909,0.3125,225.278,7.57386,0.380682,407,CH Gayle,0,0,0,0,0,0,0,0,12,9,21,12,9,21,0,222,1,0,1,4.58621,0.206897,31.1293,89.4255,116,4
West Indies,176,217.33,7.15909,0.3125,225.278,7.57386,0.380682,407,DM Bravo,0,0,0,0,0,0,0,0,12,9,21,12,9,21,0,222,1,0,1,3,0.226667,28.52,67.4551,75,4
West Indies,176,217.33,7.15909,0.3125,225.278,7.57386,0.380682,407,DS Smith,0,0,0,0,0,0,0,0,12,9,21,12,9,21,0,222,1,0,1,2.61765,0.147059,23.5588,71.2,34,4
South Africa,190,234.274,7.4,0.373684,232.363,7.33158,0.342105,407,HM Amla,0,0,0,0,0,0,0,0,8,11,19,8,11,19,223,223,1,0,1,5.20168,0.403361,48.7899,86.9292,119,4
South Africa,190,234.274,7.4,0.373684,232.363,7.33158,0.342105,407,GC Smith,0,0,0,0,0,0,0,0,8,11,19,8,11,19,223,223,1,0,1,3.97,0.29,33.57,79.6819,100,4
South Africa,190,234.274,7.4,0.373684,232.363,7.33158,0.342105,407,JH Kallis,0,0,0,0,0,0,0,0,8,11,19,8,11,19,223,223,1,0,1,3.58621,0.356322,37.2644,76.4442,87,4
New Zealand,184,233.745,7.39674,0.36413,227.951,7.30435,0.353261,408,MJ Guptill,0,0,0,0,0,0,0,0,16,5,21,16,5,21,0,206,4,0,1,4.8087,0.313043,38.1217,82.7482,115,4
New Zealand,184,233.745,7.39674,0.36413,227.951,7.30435,0.353261,408,BB McCullum,0,0,0,0,0,0,0,0,16,5,21,16,5,21,0,206,4,0,1,3.98611,0.201389,29.9028,98.4004,144,0
New Zealand,184,233.745,7.39674,0.36413,227.951,7.30435,0.353261,408,JD Ryder,0,0,0,0,0,0,0,0,16,5,21,16,5,21,0,206,4,0,1,4.88571,0.257143,34.4,97.2536,35,0
Australia,228,239.627,7.69737,0.372807,232.079,7.23246,0.337719,408,SR Watson,0,0,0,0,0,0,0,0,16,16,32,16,16,32,207,207,2,0,1,4.71318,0.286822,37.7907,90.0943,129,4
Australia,228,239.627,7.69737,0.372807,232.079,7.23246,0.337719,408,BJ Haddin,0,0,0,0,0,0,0,0,16,16,32,16,16,32,207,207,2,0,1,3.14737,0.147368,26.7789,81.382,95,4
Bangladesh,160,218.438,7.70625,0.4,211.106,7.05,0.325,409,Tamim Iqbal,0,0,0,0,0,0,0,0,36,12,48,36,12,48,0,205,1,1,1,4.05344,0.274809,31.8015,76.8068,131,4
Bangladesh,160,218.438,7.70625,0.4,211.106,7.05,0.325,409,Imrul Kayes,0,0,0,0,0,0,0,0,36,12,48,36,12,48,0,205,1,1,1,3,0.207547,26.2642,63.6488,53,4
Ireland,55,219.527,7.65455,0.290909,202.727,7.56364,0.4,409,WTS Porterfield,0,0,0,0,0,0,0,0,4,14,18,4,14,18,206,178,1,0,1,2.6,0.142857,24.6857,56.2866,35,3
Ireland,55,219.527,7.65455,0.290909,202.727,7.56364,0.4,409,PR Stirling,0,0,0,0,0,0,0,0,4,14,18,4,14,18,206,178,1,0,1,3.47826,0.173913,24.2174,88.1329,23,0
Pakistan,211,222.621,7.38389,0.393365,235.517,7.54976,0.336493,410,Ahmed Shehzad,0,0,0,0,0,0,0,0,16,9,25,16,9,25,0,277,3,0,1,3.67143,0.242857,33.2714,70.8118,70,4
Pakistan,211,222.621,7.38389,0.393365,235.517,7.54976,0.336493,410,Mohammad Hafeez,0,0,0,0,0,0,0,0,16,9,25,16,9,25,0,277,3,0,1,4.04511,0.255639,34.3534,78.0625,133,4
Sri Lanka,244,223.373,7.09016,0.344262,227.578,7.47541,0.385246,410,WU Tharanga,0,0,0,0,0,0,0,0,8,7,15,8,7,15,278,266,1,1,1,3.93985,0.263158,32.9699,71.6035,133,4
Sri Lanka,244,223.373,7.09016,0.344262,227.578,7.47541,0.385246,410,TM Dilshan,0,0,0,0,0,0,0,0,8,7,15,8,7,15,278,266,1,1,1,4.60199,0.273632,38.3632,86.0219,201,4
India,259,242.378,7.15058,0.339768,244.568,7.12741,0.30888,411,V Sehwag,0,0,0,0,0,0,0,0,16,11,27,16,11,27,0,338,1,1,1,5.88636,0.238636,38.8295,108.649,88,0
India,259,242.378,7.15058,0.339768,244.568,7.12741,0.30888,411,SR Tendulkar,0,0,0,0,0,0,0,0,16,11,27,16,11,27,0,338,1,1,1,5.89773,0.363636,45.6023,84.5376,88,4
England,221,237.176,7.17647,0.289593,230.633,7.45701,0.384615,411,AJ Strauss,0,0,0,0,0,0,0,0,16,11,27,16,11,27,339,338,1,0,1,3.93243,0.27027,33.9054,79.8028,74,4
England,221,237.176,7.17647,0.289593,230.633,7.45701,0.384615,411,KP Pietersen,0,0,0,0,0,0,0,0,16,11,27,16,11,27,339,338,1,0,1,3.69892,0.236559,33.4946,82.2117,93,4
Bangladesh,160,218.438,7.70625,0.4,211.106,7.05,0.325,417,Tamim Iqbal,0,0,0,0,0,0,0,0,12,12,24,12,12,24,0,58,1,1,1,4.05344,0.274809,31.8015,76.8068,131,4
Bangladesh,160,218.438,7.70625,0.4,211.106,7.05,0.325,417,Junaid Siddique,0,0,0,0,0,0,0,0,12,12,24,12,12,24,0,58,1,1,1,2.16279,0.116279,20.0233,68.225,43,1
Bangladesh,160,218.438,7.70625,0.4,211.106,7.05,0.325,417,Imrul Kayes,0,0,0,0,0,0,0,0,12,12,24,12,12,24,0,58,1,1,1,3,0.207547,26.2642,63.6488,53,4
Bangladesh,160,218.438,7.70625,0.4,211.106,7.05,0.325,417,Mushfiqur Rahim,0,0,0,0,0,0,0,0,12,12,24,12,12,24,0,58,1,1,1,2.61111,0.18254,27.7778,75.2526,126,4
West Indies,176,217.33,7.15909,0.3125,225.278,7.57386,0.380682,417,DS Smith,0,0,0,0,0,0,0,0,16,11,27,16,11,27,59,59,2,0,1,2.61765,0.147059,23.5588,71.2,34,4
West Indies,176,217.33,7.15909,0.3125,225.278,7.57386,0.380682,417,CH Gayle,0,0,0,0,0,0,0,0,16,11,27,16,11,27,59,59,2,0,1,4.58621,0.206897,31.1293,89.4255,116,4
Zimbabwe,142,212.077,7.5,0.380282,227.704,6.97887,0.316901,418,BRM Taylor,0,0,0,0,0,0,0,0,8,7,15,8,7,15,0,162,2,0,1,3.3,0.26,33.56,76.3421,100,4
Zimbabwe,142,212.077,7.5,0.380282,227.704,6.97887,0.316901,418,CK Coventry,0,0,0,0,0,0,0,0,8,7,15,8,7,15,0,162,2,0,1,3.33333,0.166667,29.3889,90.273,18,4
Zimbabwe,142,212.077,7.5,0.380282,227.704,6.97887,0.316901,418,T Taibu,0,0,0,0,0,0,0,0,8,7,15,8,7,15,0,162,2,0,1,2.36364,0.254545,29.4,71.0145,55,4
New Zealand,184,233.745,7.39674,0.36413,227.951,7.30435,0.353261,418,MJ Guptill,0,0,0,0,0,0,0,0,20,9,29,20,9,29,163,166,0,0,1,4.8087,0.313043,38.1217,82.7482,115,4
New Zealand,184,233.745,7.39674,0.36413,227.951,7.30435,0.353261,418,BB McCullum,0,0,0,0,0,0,0,0,20,9,29,20,9,29,163,166,0,0,1,3.98611,0.201389,29.9028,98.4004,144,0
Ireland,55,219.527,7.65455,0.290909,202.727,7.56364,0.4,419,WTS Porterfield,0,0,0,0,0,0,0,0,8,1,9,8,1,9,0,207,2,0,1,2.6,0.142857,24.6857,56.2866,35,3
Ireland,55,219.527,7.65455,0.290909,202.727,7.56364,0.4,419,PR Stirling,0,0,0,0,0,0,0,0,8,1,9,8,1,9,0,207,2,0,1,3.47826,0.173913,24.2174,88.1329,23,0
Ireland,55,219.527,7.65455,0.290909,202.727,7.56364,0.4,419,EC Joyce,0,0,0,0,0,0,0,0,8,1,9,8,1,9,0,207,2,0,1,3.08571,0.2,28.3429,68.6505,35,4
Ireland,55,219.527,7.65455,0.290909,202.727,7.56364,0.4,419,NJ O'Brien,0,0,0,0,0,0,0,0,8,1,9,8,1,9,0,207,2,0,1,2.55882,0.176471,25.5882,69.378,34,4
India,259,242.378,7.15058,0.339768,244.568,7.12741,0.30888,419,V Sehwag,0,0,0,0,0,0,0,0,16,6,22,16,6,22,208,210,2,1,1,5.88636,0.238636,38.8295,108.649,88,0
India,259,242.378,7.15058,0.339768,244.568,7.12741,0.30888,419,SR Tendulkar,0,0,0,0,0,0,0,0,16,6,22,16,6,22,208,210,2,1,1,5.89773,0.363636,45.6023,84.5376,88,4
India,259,242.378,7.15058,0.339768,244.568,7.12741,0.30888,419,G Gambhir,0,0,0,0,0,0,0,0,16,6,22,16,6,22,208,210,2,1,1,3.99145,0.333333,37.4701,84.1944,117,4
England,221,237.176,7.17647,0.289593,230.633,7.45701,0.384615,420,AJ Strauss,0,0,0,0,0,0,0,0,4,8,12,4,8,12,0,171,3,0,1,3.93243,0.27027,33.9054,79.8028,74,4
England,221,237.176,7.17647,0.289593,230.633,7.45701,0.384615,420,KP Pietersen,0,0,0,0,0,0,0,0,4,8,12,4,8,12,0,171,3,0,1,3.69892,0.236559,33.4946,82.2117,93,4
England,221,237.176,7.17647,0.289593,230.633,7.45701,0.384615,420,IJL Trott,0,0,0,0,0,0,0,0,4,8,12,4,8,12,0,171,3,0,1,3.3871,0.403226,43.7903,75.2494,62,4
England,221,237.176,7.17647,0.289593,230.633,7.45701,0.384615,420,IR Bell,0,0,0,0,0,0,0,0,4,8,12,4,8,12,0,171,3,0,1,3.63433,0.246269,35.3806,75.6623,134,4
England,221,237.176,7.17647,0.289593,230.633,7.45701,0.384615,420,RS Bopara,0,0,0,0,0,0,0,0,4,8,12,4,8,12,0,171,3,0,1,2.22115,0.144231,25.1538,75.9361,104,4
South Africa,190,234.274,7.4,0.373684,232.363,7.33158,0.342105,420,HM Amla,0,0,0,0,0,0,0,0,12,15,27,12,15,27,172,165,0,0,1,5.20168,0.403361,48.7899,86.9292,119,4
South Africa,190,234.274,7.4,0.373684,232.363,7.33158,0.342105,420,GC Smith,0,0,0,0,0,0,0,0,12,15,27,12,15,27,172,165,0,0,1,3.97,0.29,33.57,79.6819,100,4
New Zealand,184,233.745,7.39674,0.36413,227.951,7.30435,0.353261,422,MJ Guptill,0,0,0,0,0,0,0,0,10,9,19,10,9,19,0,302,2,0,1,4.8087,0.313043,38.1217,82.7482,115,4
New Zealand,184,233.745,7.39674,0.36413,227.951,7.30435,0.353261,422,BB McCullum,0,0,0,0,0,0,0,0,10,9,19,10,9,19,0,302,2,0,1,3.98611,0.201389,29.9028,98.4004,144,0
New Zealand,184,233.745,7.39674,0.36413,227.951,7.30435,0.353261,422,JM How,0,0,0,0,0,0,0,0,10,9,19,10,9,19,0,302,2,0,1,3.34615,0.192308,29.9231,64.9416,26,4
Pakistan,211,222.621,7.38389,0.393365,235.517,7.54976,0.336493,422,Mohammad Hafeez,0,0,0,0,0,0,0,0,8,8,16,8,8,16,303,192,0,0,1,4.04511,0.255639,34.3534,78.0625,133,4
Pakistan,211,222.621,7.38389,0.393365,235.517,7.54976,0.336493,422,Ahmed Shehzad,0,0,0,0,0,0,0,0,8,8,16,8,8,16,303,192,0,0,1,3.67143,0.242857,33.2714,70.8118,70,4
Pakistan,211,222.621,7.38389,0.393365,235.517,7.54976,0.336493,422,Kamran Akmal,0,0,0,0,0,0,0,0,8,8,16,8,8,16,303,192,0,0,1,3.01124,0.11236,23.0787,81.4433,89,4
West Indies,176,217.33,7.15909,0.3125,225.278,7.57386,0.380682,424,DS Smith,0,0,0,0,0,0,0,0,8,3,11,8,3,11,0,275,0,0,1,2.61765,0.147059,23.5588,71.2,34,4
West Indies,176,217.33,7.15909,0.3125,225.278,7.57386,0.380682,424,S Chanderpaul,0,0,0,0,0,0,0,0,8,3,11,8,3,11,0,275,0,0,1,3.57143,0.396825,40.8254,68.0783,63,4
Ireland,55,219.527,7.65455,0.290909,202.727,7.56364,0.4,424,WTS Porterfield,0,0,0,0,0,0,0,0,28,6,34,28,6,34,276,231,1,0,1,2.6,0.142857,24.6857,56.2866,35,3
Ireland,55,219.527,7.65455,0.290909,202.727,7.56364,0.4,424,PR Stirling,0,0,0,0,0,0,0,0,28,6,34,28,6,34,276,231,1,0,1,3.47826,0.173913,24.2174,88.1329,23,0
Ireland,55,219.527,7.65455,0.290909,202.727,7.56364,0.4,424,EC Joyce,0,0,0,0,0,0,0,0,28,6,34,28,6,34,276,231,1,0,1,3.08571,0.2,28.3429,68.6505,35,4
England,221,237.176,7.17647,0.289593,230.633,7.45701,0.384615,425,AJ Strauss,0,0,0,0,0,0,0,0,12,12,24,12,12,24,0,225,1,0,1,3.93243,0.27027,33.9054,79.8028,74,4
England,221,237.176,7.17647,0.289593,230.633,7.45701,0.384615,425,MJ Prior,0,0,0,0,0,0,0,0,12,12,24,12,12,24,0,225,1,0,1,2.27083,0.0625,21.6875,76.4879,48,4
Bangladesh,160,218.438,7.70625,0.4,211.106,7.05,0.325,425,Tamim Iqbal,0,0,0,0,0,0,0,0,12,17,29,12,17,29,226,227,1,1,1,4.05344,0.274809,31.8015,76.8068,131,4
Bangladesh,160,218.438,7.70625,0.4,211.106,7.05,0.325,425,Imrul Kayes,0,0,0,0,0,0,0,0,12,17,29,12,17,29,226,227,1,1,1,3,0.207547,26.2642,63.6488,53,4
India,259,242.378,7.15058,0.339768,244.568,7.12741,0.30888,426,V Sehwag,0,0,0,0,0,0,0,0,16,11,27,16,11,27,0,296,6,1,1,5.88636,0.238636,38.8295,108.649,88,0
India,259,242.378,7.15058,0.339768,244.568,7.12741,0.30888,426,SR Tendulkar,0,0,0,0,0,0,0,0,16,11,27,16,11,27,0,296,6,1,1,5.89773,0.363636,45.6023,84.5376,88,4
South Africa,190,234.274,7.4,0.373684,232.363,7.33158,0.342105,426,HM Amla,0,0,0,0,0,0,0,0,8,9,17,8,9,17,297,300,0,0,1,5.20168,0.403361,48.7899,86.9292,119,4
South Africa,190,234.274,7.4,0.373684,232.363,7.33158,0.342105,426,GC Smith,0,0,0,0,0,0,0,0,8,9,17,8,9,17,297,300,0,0,1,3.97,0.29,33.57,79.6819,100,4
Zimbabwe,142,212.077,7.5,0.380282,227.704,6.97887,0.316901,429,BRM Taylor,0,0,0,0,0,0,0,0,8,4,12,8,4,12,0,151,1,0,1,3.3,0.26,33.56,76.3421,100,4
Zimbabwe,142,212.077,7.5,0.380282,227.704,6.97887,0.316901,429,T Taibu,0,0,0,0,0,0,0,0,8,4,12,8,4,12,0,151,1,0,1,2.36364,0.254545,29.4,71.0145,55,4
Zimbabwe,142,212.077,7.5,0.380282,227.704,6.97887,0.316901,429,RW Chakabva,0,0,0,0,0,0,0,0,8,4,12,8,4,12,0,151,1,0,1,0.846154,0,13.2692,51.3393,26,3
Zimbabwe,142,212.077,7.5,0.380282,227.704,6.97887,0.316901,429,V Sibanda,0,0,0,0,0,0,0,0,8,4,12,8,4,12,0,151,1,0,1,2.9697,0.181818,23.5152,63.5545,66,1
Pakistan,211,222.621,7.38389,0.393365,235.517,7.54976,0.336493,429,Mohammad Hafeez,0,0,0,0,0,0,0,0,24,2,26,24,2,26,152,164,4,0,1,4.04511,0.255639,34.3534,78.0625,133,4
Pakistan,211,222.621,7.38389,0.393365,235.517,7.54976,0.336493,429,Ahmed Shehzad,0,0,0,0,0,0,0,0,24,2,26,24,2,26,152,164,4,0,1,3.67143,0.242857,33.2714,70.8118,70,4
Pakistan,211,222.621,7.38389,0.393365,235.517,7.54976,0.336493,429,Asad Shafiq,0,0,0,0,0,0,0,0,24,2,26,24,2,26,152,164,4,0,1,2.07843,0.176471,24.7843,67.1269,51,4
South Africa,190,234.274,7.4,0.373684,232.363,7.33158,0.342105,431,HM Amla,0,0,0,0,0,0,0,0,10,12,22,10,12,22,0,272,2,0,1,5.20168,0.403361,48.7899,86.9292,119,4
South Africa,190,234.274,7.4,0.373684,232.363,7.33158,0.342105,431,GC Smith,0,0,0,0,0,0,0,0,10,12,22,10,12,22,0,272,2,0,1,3.97,0.29,33.57,79.6819,100,4
Ireland,55,219.527,7.65455,0.290909,202.727,7.56364,0.4,431,WTS Porterfield,0,0,0,0,0,0,0,0,16,8,24,16,8,24,273,141,1,0,1,2.6,0.142857,24.6857,56.2866,35,3
Ireland,55,219.527,7.65455,0.290909,202.727,7.56364,0.4,431,PR Stirling,0,0,0,0,0,0,0,0,16,8,24,16,8,24,273,141,1,0,1,3.47826,0.173913,24.2174,88.1329,23,0
Ireland,55,219.527,7.65455,0.290909,202.727,7.56364,0.4,431,EC Joyce,0,0,0,0,0,0,0,0,16,8,24,16,8,24,273,141,1,0,1,3.08571,0.2,28.3429,68.6505,35,4
Ireland,55,219.527,7.65455,0.290909,202.727,7.56364,0.4,431,NJ O'Brien,0,0,0,0,0,0,0,0,16,8,24,16,8,24,273,141,1,0,1,2.55882,0.176471,25.5882,69.378,34,4
Sri Lanka,244,223.373,7.09016,0.344262,227.578,7.47541,0.385246,433,WU Tharanga,0,0,0,0,0,0,0,0,8,7,15,8,7,15,0,265,8,0,1,3.93985,0.263158,32.9699,71.6035,133,4
Sri Lanka,244,223.373,7.09016,0.344262,227.578,7.47541,0.385246,433,TM Dilshan,0,0,0,0,0,0,0,0,8,7,15,8,7,15,0,265,8,0,1,4.60199,0.273632,38.3632,86.0219,201,4
Sri Lanka,244,223.373,7.09016,0.344262,227.578,7.47541,0.385246,433,KC Sangakkara,0,0,0,0,0,0,0,0,8,7,15,8,7,15,0,265,8,0,1,4.33659,0.360976,41.9854,80.6276,205,4
New Zealand,184,233.745,7.39674,0.36413,227.951,7.30435,0.353261,433,MJ Guptill,0,0,0,0,0,0,0,0,12,11,23,12,11,23,266,153,2,0,1,4.8087,0.313043,38.1217,82.7482,115,4
New Zealand,184,233.745,7.39674,0.36413,227.951,7.30435,0.353261,433,BB McCullum,0,0,0,0,0,0,0,0,12,11,23,12,11,23,266,153,2,0,1,3.98611,0.201389,29.9028,98.4004,144,0
Australia,228,239.627,7.69737,0.372807,232.079,7.23246,0.337719,435,SR Watson,0,0,0,0,0,0,0,0,4,7,11,4,7,11,0,176,1,0,1,4.71318,0.286822,37.7907,90.0943,129,4
Australia,228,239.627,7.69737,0.372807,232.079,7.23246,0.337719,435,BJ Haddin,0,0,0,0,0,0,0,0,4,7,11,4,7,11,0,176,1,0,1,3.14737,0.147368,26.7789,81.382,95,4
Australia,228,239.627,7.69737,0.372807,232.079,7.23246,0.337719,435,RT Ponting,0,0,0,0,0,0,0,0,4,7,11,4,7,11,0,176,1,0,1,4.17431,0.33945,38.1009,80.8606,109,4
Pakistan,211,222.621,7.38389,0.393365,235.517,7.54976,0.336493,435,Kamran Akmal,0,0,0,0,0,0,0,0,12,8,20,12,8,20,177,178,1,0,1,3.01124,0.11236,23.0787,81.4433,89,4
Pakistan,211,222.621,7.38389,0.393365,235.517,7.54976,0.336493,435,Mohammad Hafeez,0,0,0,0,0,0,0,0,12,8,20,12,8,20,177,178,1,0,1,4.04511,0.255639,34.3534,78.0625,133,4
Pakistan,211,222.621,7.38389,0.393365,235.517,7.54976,0.336493,435,Asad Shafiq,0,0,0,0,0,0,0,0,12,8,20,12,8,20,177,178,1,0,1,2.07843,0.176471,24.7843,67.1269,51,4
South Africa,190,234.274,7.4,0.373684,232.363,7.33158,0.342105,436,HM Amla,0,0,0,0,0,0,0,0,20,10,30,20,10,30,0,284,3,0,1,5.20168,0.403361,48.7899,86.9292,119,4
South Africa,190,234.274,7.4,0.373684,232.363,7.33158,0.342105,436,GC Smith,0,0,0,0,0,0,0,0,20,10,30,20,10,30,0,284,3,0,1,3.97,0.29,33.57,79.6819,100,4
Bangladesh,160,218.438,7.70625,0.4,211.106,7.05,0.325,436,Tamim Iqbal,0,0,0,0,0,0,0,0,8,1,9,8,1,9,285,78,5,1,1,4.05344,0.274809,31.8015,76.8068,131,4
Bangladesh,160,218.438,7.70625,0.4,211.106,7.05,0.325,436,Imrul Kayes,0,0,0,0,0,0,0,0,8,1,9,8,1,9,285,78,5,1,1,3,0.207547,26.2642,63.6488,53,4
Bangladesh,160,218.438,7.70625,0.4,211.106,7.05,0.325,436,Junaid Siddique,0,0,0,0,0,0,0,0,8,1,9,8,1,9,285,78,5,1,1,2.16279,0.116279,20.0233,68.225,43,1
India,259,242.378,7.15058,0.339768,244.568,7.12741,0.30888,438,G Gambhir,0,0,0,0,0,0,0,0,12,11,23,12,11,23,0,268,5,1,1,3.99145,0.333333,37.4701,84.1944,117,4
India,259,242.378,7.15058,0.339768,244.568,7.12741,0.30888,438,SR Tendulkar,0,0,0,0,0,0,0,0,12,11,23,12,11,23,0,268,5,1,1,5.89773,0.363636,45.6023,84.5376,88,4
India,259,242.378,7.15058,0.339768,244.568,7.12741,0.30888,438,V Kohli,0,0,0,0,0,0,0,0,12,11,23,12,11,23,0,268,5,1,1,4.66456,0.379747,44.9937,88.3325,158,4
West Indies,176,217.33,7.15909,0.3125,225.278,7.57386,0.380682,438,DS Smith,0,0,0,0,0,0,0,0,12,10,22,12,10,22,269,188,2,0,1,2.61765,0.147059,23.5588,71.2,34,4
West Indies,176,217.33,7.15909,0.3125,225.278,7.57386,0.380682,438,KA Edwards,0,0,0,0,0,0,0,0,12,10,22,12,10,22,269,188,2,0,1,1.875,0.0625,20.6875,64.902,16,1
West Indies,176,217.33,7.15909,0.3125,225.278,7.57386,0.380682,439,DS Smith,0,0,0,0,0,0,0,0,12,3,15,12,3,15,0,112,1,0,1,2.61765,0.147059,23.5588,71.2,34,4
West Indies,176,217.33,7.15909,0.3125,225.278,7.57386,0.380682,439,CH Gayle,0,0,0,0,0,0,0,0,12,3,15,12,3,15,0,112,1,0,1,4.58621,0.206897,31.1293,89.4255,116,4
West Indies,176,217.33,7.15909,0.3125,225.278,7.57386,0.380682,439,RR Sarwan,0,0,0,0,0,0,0,0,12,3,15,12,3,15,0,112,1,0,1,2.8254,0.222222,29.1429,69.1005,63,4
Pakistan,211,222.621,7.38389,0.393365,235.517,7.54976,0.336493,439,Kamran Akmal,0,0,0,0,0,0,0,0,24,14,38,24,14,38,113,113,5,0,1,3.01124,0.11236,23.0787,81.4433,89,4
Pakistan,211,222.621,7.38389,0.393365,235.517,7.54976,0.336493,439,Mohammad Hafeez,0,0,0,0,0,0,0,0,24,14,38,24,14,38,113,113,5,0,1,4.04511,0.255639,34.3534,78.0625,133,4
Australia,228,239.627,7.69737,0.372807,232.079,7.23246,0.337719,440,SR Watson,0,0,0,0,0,0,0,0,12,6,18,12,6,18,0,260,1,0,1,4.71318,0.286822,37.7907,90.0943,129,4
Australia,228,239.627,7.69737,0.372807,232.079,7.23246,0.337719,440,BJ Haddin,0,0,0,0,0,0,0,0,12,6,18,12,6,18,0,260,1,0,1,3.14737,0.147368,26.7789,81.382,95,4
India,259,242.378,7.15058,0.339768,244.568,7.12741,0.30888,440,V Sehwag,0,0,0,0,0,0,0,0,16,9,25,16,9,25,261,261,5,1,1,5.88636,0.238636,38.8295,108.649,88,0
India,259,242.378,7.15058,0.339768,244.568,7.12741,0.30888,440,SR Tendulkar,0,0,0,0,0,0,0,0,16,9,25,16,9,25,261,261,5,1,1,5.89773,0.363636,45.6023,84.5376,88,4
New Zealand,184,233.745,7.39674,0.36413,227.951,7.30435,0.353261,441,MJ Guptill,0,0,0,0,0,0,0,0,4,10,14,4,10,14,0,221,1,0,1,4.8087,0.313043,38.1217,82.7482,115,4
New Zealand,184,233.745,7.39674,0.36413,227.951,7.30435,0.353261,441,BB McCullum,0,0,0,0,0,0,0,0,4,10,14,4,10,14,0,221,1,0,1,3.98611,0.201389,29.9028,98.4004,144,0
New Zealand,184,233.745,7.39674,0.36413,227.951,7.30435,0.353261,441,JD Ryder,0,0,0,0,0,0,0,0,4,10,14,4,10,14,0,221,1,0,1,4.88571,0.257143,34.4,97.2536,35,0
South Africa,190,234.274,7.4,0.373684,232.363,7.33158,0.342105,441,HM Amla,0,0,0,0,0,0,0,0,4,16,20,4,16,20,222,172,0,0,1,5.20168,0.403361,48.7899,86.9292,119,4
South Africa,190,234.274,7.4,0.373684,232.363,7.33158,0.342105,441,GC Smith,0,0,0,0,0,0,0,0,4,16,20,4,16,20,222,172,0,0,1,3.97,0.29,33.57,79.6819,100,4
South Africa,190,234.274,7.4,0.373684,232.363,7.33158,0.342105,441,JH Kallis,0,0,0,0,0,0,0,0,4,16,20,4,16,20,222,172,0,0,1,3.58621,0.356322,37.2644,76.4442,87,4
New Zealand,184,233.745,7.39674,0.36413,227.951,7.30435,0.353261,442,MJ Guptill,0,0,0,0,0,0,0,0,16,4,20,16,4,20,0,217,0,0,1,4.8087,0.313043,38.1217,82.7482,115,4
New Zealand,184,233.745,7.39674,0.36413,227.951,7.30435,0.353261,442,BB McCullum,0,0,0,0,0,0,0,0,16,4,20,16,4,20,0,217,0,0,1,3.98611,0.201389,29.9028,98.4004,144,0
Sri Lanka,244,223.373,7.09016,0.344262,227.578,7.47541,0.385246,442,WU Tharanga,0,0,0,0,0,0,0,0,18,8,26,18,8,26,218,220,3,1,1,3.93985,0.263158,32.9699,71.6035,133,4
Sri Lanka,244,223.373,7.09016,0.344262,227.578,7.47541,0.385246,442,TM Dilshan,0,0,0,0,0,0,0,0,18,8,26,18,8,26,218,220,3,1,1,4.60199,0.273632,38.3632,86.0219,201,4
India,259,242.378,7.15058,0.339768,244.568,7.12741,0.30888,443,V Sehwag,0,0,0,0,0,0,0,0,40,6,46,40,6,46,0,260,1,1,1,5.88636,0.238636,38.8295,108.649,88,0
India,259,242.378,7.15058,0.339768,244.568,7.12741,0.30888,443,SR Tendulkar,0,0,0,0,0,0,0,0,40,6,46,40,6,46,0,260,1,1,1,5.89773,0.363636,45.6023,84.5376,88,4
Pakistan,211,222.621,7.38389,0.393365,235.517,7.54976,0.336493,443,Kamran Akmal,0,0,0,0,0,0,0,0,16,12,28,16,12,28,261,231,0,0,1,3.01124,0.11236,23.0787,81.4433,89,4
Pakistan,211,222.621,7.38389,0.393365,235.517,7.54976,0.336493,443,Mohammad Hafeez,0,0,0,0,0,0,0,0,16,12,28,16,12,28,261,231,0,0,1,4.04511,0.255639,34.3534,78.0625,133,4
Sri Lanka,244,223.373,7.09016,0.344262,227.578,7.47541,0.385246,444,WU Tharanga,0,0,0,0,0,0,0,0,0,6,6,0,6,6,0,274,3,0,1,3.93985,0.263158,32.9699,71.6035,133,4
Sri Lanka,244,223.373,7.09016,0.344262,227.578,7.47541,0.385246,444,TM Dilshan,0,0,0,0,0,0,0,0,0,6,6,0,6,6,0,274,3,0,1,4.60199,0.273632,38.3632,86.0219,201,4
India,259,242.378,7.15058,0.339768,244.568,7.12741,0.30888,444,V Sehwag,0,0,0,0,0,0,0,0,12,14,26,12,14,26,275,277,1,1,1,5.88636,0.238636,38.8295,108.649,88,0
India,259,242.378,7.15058,0.339768,244.568,7.12741,0.30888,444,G Gambhir,0,0,0,0,0,0,0,0,12,14,26,12,14,26,275,277,1,1,1,3.99145,0.333333,37.4701,84.1944,117,4
India,259,242.378,7.15058,0.339768,244.568,7.12741,0.30888,444,SR Tendulkar,0,0,0,0,0,0,0,0,12,14,26,12,14,26,275,277,1,1,1,5.89773,0.363636,45.6023,84.5376,88,4
Bangladesh,160,218.438,7.70625,0.4,211.106,7.05,0.325,445,Tamim Iqbal,0,0,0,0,0,0,0,0,8,12,20,8,12,20,0,260,1,1,1,4.05344,0.274809,31.8015,76.8068,131,4
Bangladesh,160,218.438,7.70625,0.4,211.106,7.05,0.325,445,Imrul Kayes,0,0,0,0,0,0,0,0,8,12,20,8,12,20,0,260,1,1,1,3,0.207547,26.2642,63.6488,53,4
Sri Lanka,244,223.373,7.09016,0.344262,227.578,7.47541,0.385246,445,WU Tharanga,0,0,0,0,0,0,0,0,24,5,29,24,5,29,261,261,10,0,1,3.93985,0.263158,32.9699,71.6035,133,4
Sri Lanka,244,223.373,7.09016,0.344262,227.578,7.47541,0.385246,445,TM Dilshan,0,0,0,0,0,0,0,0,24,5,29,24,5,29,261,261,10,0,1,4.60199,0.273632,38.3632,86.0219,201,4
Sri Lanka,244,223.373,7.09016,0.344262,227.578,7.47541,0.385246,445,KC Sangakkara,0,0,0,0,0,0,0,0,24,5,29,24,5,29,261,261,10,0,1,4.33659,0.360976,41.9854,80.6276,205,4
India,259,242.378,7.15058,0.339768,244.568,7.12741,0.30888,446,G Gambhir,0,0,0,0,0,0,0,0,16,13,29,16,13,29,0,279,3,0,1,3.99145,0.333333,37.4701,84.1944,117,4
India,259,242.378,7.15058,0.339768,244.568,7.12741,0.30888,446,V Sehwag,0,0,0,0,0,0,0,0,16,13,29,16,13,29,0,279,3,0,1,5.88636,0.238636,38.8295,108.649,88,0
India,259,242.378,7.15058,0.339768,244.568,7.12741,0.30888,446,V Kohli,0,0,0,0,0,0,0,0,16,13,29,16,13,29,0,279,3,0,1,4.66456,0.379747,44.9937,88.3325,158,4
Sri Lanka,244,223.373,7.09016,0.344262,227.578,7.47541,0.385246,446,WU Tharanga,0,0,0,0,0,0,0,0,16,9,25,16,9,25,280,283,7,0,1,3.93985,0.263158,32.9699,71.6035,133,4
Sri Lanka,244,223.373,7.09016,0.344262,227.578,7.47541,0.385246,446,HDRL Thirimanne,0,0,0,0,0,0,0,0,16,9,25,16,9,25,280,283,7,0,1,2.77778,0.246914,31.5802,71.4725,81,4
Bangladesh,160,218.438,7.70625,0.4,211.106,7.05,0.325,447,Tamim Iqbal,0,0,0,0,0,0,0,0,18,9,27,18,9,27,0,296,1,1,1,4.05344,0.274809,31.8015,76.8068,131,4
Bangladesh,160,218.438,7.70625,0.4,211.106,7.05,0.325,447,Imrul Kayes,0,0,0,0,0,0,0,0,18,9,27,18,9,27,0,296,1,1,1,3,0.207547,26.2642,63.6488,53,4
India,259,242.378,7.15058,0.339768,244.568,7.12741,0.30888,447,G Gambhir,0,0,0,0,0,0,0,0,12,14,26,12,14,26,297,297,5,0,1,3.99145,0.333333,37.4701,84.1944,117,4
India,259,242.378,7.15058,0.339768,244.568,7.12741,0.30888,447,V Sehwag,0,0,0,0,0,0,0,0,12,14,26,12,14,26,297,297,5,0,1,5.88636,0.238636,38.8295,108.649,88,0
India,259,242.378,7.15058,0.339768,244.568,7.12741,0.30888,447,V Kohli,0,0,0,0,0,0,0,0,12,14,26,12,14,26,297,297,5,0,1,4.66456,0.379747,44.9937,88.3325,158,4
Bangladesh,160,218.438,7.70625,0.4,211.106,7.05,0.325,448,Tamim Iqbal,0,0,0,0,0,0,0,0,18,9,27,18,9,27,0,249,0,1,1,4.05344,0.274809,31.8015,76.8068,131,4
Bangladesh,160,218.438,7.70625,0.4,211.106,7.05,0.325,448,Imrul Kayes,0,0,0,0,0,0,0,0,18,9,27,18,9,27,0,249,0,1,1,3,0.207547,26.2642,63.6488,53,4
Sri Lanka,244,223.373,7.09016,0.344262,227.578,7.47541,0.385246,448,WU Tharanga,0,0,0,0,0,0,0,0,28,8,36,28,8,36,250,252,0,0,1,3.93985,0.263158,32.9699,71.6035,133,4
Sri Lanka,244,223.373,7.09016,0.344262,227.578,7.47541,0.385246,448,DPMD Jayawardene,0,0,0,0,0,0,0,0,28,8,36,28,8,36,250,252,0,0,1,3.20833,0.244792,31.6979,79.1109,192,4
Sri Lanka,244,223.373,7.09016,0.344262,227.578,7.47541,0.385246,449,WU Tharanga,0,0,0,0,0,0,0,0,36,2,38,36,2,38,0,213,0,0,1,3.93985,0.263158,32.9699,71.6035,133,4
Sri Lanka,244,223.373,7.09016,0.344262,227.578,7.47541,0.385246,449,KC Sangakkara,0,0,0,0,0,0,0,0,36,2,38,36,2,38,0,213,0,0,1,4.33659,0.360976,41.9854,80.6276,205,4
Sri Lanka,244,223.373,7.09016,0.344262,227.578,7.47541,0.385246,449,TM Dilshan,0,0,0,0,0,0,0,0,36,2,38,36,2,38,0,213,0,0,1,4.60199,0.273632,38.3632,86.0219,201,4
India,259,242.378,7.15058,0.339768,244.568,7.12741,0.30888,449,KD Karthik,0,0,0,0,0,0,0,0,24,8,32,24,8,32,214,214,2,0,1,2.46429,0.107143,21.6786,71.8769,56,1
India,259,242.378,7.15058,0.339768,244.568,7.12741,0.30888,449,G Gambhir,0,0,0,0,0,0,0,0,24,8,32,24,8,32,214,214,2,0,1,3.99145,0.333333,37.4701,84.1944,117,4
Bangladesh,160,218.438,7.70625,0.4,211.106,7.05,0.325,450,Tamim Iqbal,0,0,0,0,0,0,0,0,12,4,16,12,4,16,0,247,1,1,1,4.05344,0.274809,31.8015,76.8068,131,4
Bangladesh,160,218.438,7.70625,0.4,211.106,7.05,0.325,450,Imrul Kayes,0,0,0,0,0,0,0,0,12,4,16,12,4,16,0,247,1,1,1,3,0.207547,26.2642,63.6488,53,4
Bangladesh,160,218.438,7.70625,0.4,211.106,7.05,0.325,450,Mohammad Ashraful,0,0,0,0,0,0,0,0,12,4,16,12,4,16,0,247,1,1,1,2.17722,0.113924,19.4557,63.9085,79,1
Bangladesh,160,218.438,7.70625,0.4,211.106,7.05,0.325,450,Raqibul Hasan,0,0,0,0,0,0,0,0,12,4,16,12,4,16,0,247,1,1,1,1.85106,0.12766,23.2766,59.2312,47,1
India,259,242.378,7.15058,0.339768,244.568,7.12741,0.30888,450,KD Karthik,0,0,0,0,0,0,0,0,12,19,31,12,19,31,248,249,5,0,1,2.46429,0.107143,21.6786,71.8769,56,1
India,259,242.378,7.15058,0.339768,244.568,7.12741,0.30888,450,G Gambhir,0,0,0,0,0,0,0,0,12,19,31,12,19,31,248,249,5,0,1,3.99145,0.333333,37.4701,84.1944,117,4
Zimbabwe,142,212.077,7.5,0.380282,227.704,6.97887,0.316901,451,H Masakadza,0,0,0,0,0,0,0,0,8,8,16,8,8,16,0,254,0,0,1,3.11215,0.186916,26.972,70.0485,107,4
Zimbabwe,142,212.077,7.5,0.380282,227.704,6.97887,0.316901,451,V Sibanda,0,0,0,0,0,0,0,0,8,8,16,8,8,16,0,254,0,0,1,2.9697,0.181818,23.5152,63.5545,66,1
West Indies,176,217.33,7.15909,0.3125,225.278,7.57386,0.380682,451,CH Gayle,0,0,0,0,0,0,0,0,10,3,13,10,3,13,255,252,0,1,1,4.58621,0.206897,31.1293,89.4255,116,4
West Indies,176,217.33,7.15909,0.3125,225.278,7.57386,0.380682,451,AB Barath,0,0,0,0,0,0,0,0,10,3,13,10,3,13,255,252,0,1,1,2.76923,0.0769231,21.6154,56.4257,13,3
Zimbabwe,142,212.077,7.5,0.380282,227.704,6.97887,0.316901,452,H Masakadza,0,0,0,0,0,0,0,0,10,3,13,10,3,13,0,206,6,0,1,3.11215,0.186916,26.972,70.0485,107,4
Zimbabwe,142,212.077,7.5,0.380282,227.704,6.97887,0.316901,452,V Sibanda,0,0,0,0,0,0,0,0,10,3,13,10,3,13,0,206,6,0,1,2.9697,0.181818,23.5152,63.5545,66,1
Zimbabwe,142,212.077,7.5,0.380282,227.704,6.97887,0.316901,452,BRM Taylor,0,0,0,0,0,0,0,0,10,3,13,10,3,13,0,206,6,0,1,3.3,0.26,33.56,76.3421,100,4
West Indies,176,217.33,7.15909,0.3125,225.278,7.57386,0.380682,452,CH Gayle,0,0,0,0,0,0,0,0,18,9,27,18,9,27,207,208,0,1,1,4.58621,0.206897,31.1293,89.4255,116,4
West Indies,176,217.33,7.15909,0.3125,225.278,7.57386,0.380682,452,AB Barath,0,0,0,0,0,0,0,0,18,9,27,18,9,27,207,208,0,1,1,2.76923,0.0769231,21.6154,56.4257,13,3
West Indies,176,217.33,7.15909,0.3125,225.278,7.57386,0.380682,453,CH Gayle,0,0,0,0,0,0,0,0,0,11,11,0,11,11,0,245,0,1,1,4.58621,0.206897,31.1293,89.4255,116,4
West Indies,176,217.33,7.15909,0.3125,225.278,7.57386,0.380682,453,AB Barath,0,0,0,0,0,0,0,0,0,11,11,0,11,11,0,245,0,1,1,2.76923,0.0769231,21.6154,56.4257,13,3
Zimbabwe,142,212.077,7.5,0.380282,227.704,6.97887,0.316901,453,V Sibanda,0,0,0,0,0,0,0,0,12,6,18,12,6,18,246,104,1,0,1,2.9697,0.181818,23.5152,63.5545,66,1
Zimbabwe,142,212.077,7.5,0.380282,227.704,6.97887,0.316901,453,BRM Taylor,0,0,0,0,0,0,0,0,12,6,18,12,6,18,246,104,1,0,1,3.3,0.26,33.56,76.3421,100,4
Zimbabwe,142,212.077,7.5,0.380282,227.704,6.97887,0.316901,453,H Masakadza,0,0,0,0,0,0,0,0,12,6,18,12,6,18,246,104,1,0,1,3.11215,0.186916,26.972,70.0485,107,4
Zimbabwe,142,212.077,7.5,0.380282,227.704,6.97887,0.316901,454,H Masakadza,0,0,0,0,0,0,0,0,4,2,6,4,2,6,0,141,17,0,1,3.11215,0.186916,26.972,70.0485,107,4
Zimbabwe,142,212.077,7.5,0.380282,227.704,6.97887,0.316901,454,V Sibanda,0,0,0,0,0,0,0,0,4,2,6,4,2,6,0,141,17,0,1,2.9697,0.181818,23.5152,63.5545,66,1
Zimbabwe,142,212.077,7.5,0.380282,227.704,6.97887,0.316901,454,T Maruma,0,0,0,0,0,0,0,0,4,2,6,4,2,6,0,141,17,0,1,0.5,0,5.5,38.3721,12,3
West Indies,176,217.33,7.15909,0.3125,225.278,7.57386,0.380682,454,AB Barath,0,0,0,0,0,0,0,0,28,9,37,28,9,37,142,142,3,1,1,2.76923,0.0769231,21.6154,56.4257,13,3
West Indies,176,217.33,7.15909,0.3125,225.278,7.57386,0.380682,454,CH Gayle,0,0,0,0,0,0,0,0,28,9,37,28,9,37,142,142,3,1,1,4.58621,0.206897,31.1293,89.4255,116,4
Zimbabwe,142,212.077,7.5,0.380282,227.704,6.97887,0.316901,455,V Sibanda,0,0,0,0,0,0,0,0,0,6,6,0,6,6,0,161,5,0,1,2.9697,0.181818,23.5152,63.5545,66,1
Zimbabwe,142,212.077,7.5,0.380282,227.704,6.97887,0.316901,455,H Masakadza,0,0,0,0,0,0,0,0,0,6,6,0,6,6,0,161,5,0,1,3.11215,0.186916,26.972,70.0485,107,4
Zimbabwe,142,212.077,7.5,0.380282,227.704,6.97887,0.316901,455,T Maruma,0,0,0,0,0,0,0,0,0,6,6,0,6,6,0,161,5,0,1,0.5,0,5.5,38.3721,12,3
West Indies,176,217.33,7.15909,0.3125,225.278,7.57386,0.380682,455,AB Barath,0,0,0,0,0,0,0,0,12,9,21,12,9,21,162,165,2,1,1,2.76923,0.0769231,21.6154,56.4257,13,3
West Indies,176,217.33,7.15909,0.3125,225.278,7.57386,0.380682,455,CH Gayle,0,0,0,0,0,0,0,0,12,9,21,12,9,21,162,165,2,1,1,4.58621,0.206897,31.1293,89.4255,116,4
West Indies,176,217.33,7.15909,0.3125,225.278,7.57386,0.380682,455,DM Bravo,0,0,0,0,0,0,0,0,12,9,21,12,9,21,162,165,2,1,1,3,0.226667,28.52,67.4551,75,4
South Africa,190,234.274,7.4,0.373684,232.363,7.33158,0.342105,456,HM Amla,0,0,0,0,0,0,0,0,22,15,37,22,15,37,0,280,2,0,1,5.20168,0.403361,48.7899,86.9292,119,4
South Africa,190,234.274,7.4,0.373684,232.363,7.33158,0.342105,456,GC Smith,0,0,0,0,0,0,0,0,22,15,37,22,15,37,0,280,2,0,1,3.97,0.29,33.57,79.6819,100,4
West Indies,176,217.33,7.15909,0.3125,225.278,7.57386,0.380682,456,ADS Fletcher,0,0,0,0,0,0,0,0,8,10,18,8,10,18,281,215,1,1,1,1.8125,0.125,13.5,62.6087,16,1
West Indies,176,217.33,7.15909,0.3125,225.278,7.57386,0.380682,456,CH Gayle,0,0,0,0,0,0,0,0,8,10,18,8,10,18,281,215,1,1,1,4.58621,0.206897,31.1293,89.4255,116,4
West Indies,176,217.33,7.15909,0.3125,225.278,7.57386,0.380682,456,DJ Bravo,0,0,0,0,0,0,0,0,8,10,18,8,10,18,281,215,1,1,1,2.35514,0.11215,23.1589,80.9011,107,4
South Africa,190,234.274,7.4,0.373684,232.363,7.33158,0.342105,457,GC Smith,0,0,0,0,0,0,0,0,4,13,17,4,13,17,0,300,1,0,1,3.97,0.29,33.57,79.6819,100,4
South Africa,190,234.274,7.4,0.373684,232.363,7.33158,0.342105,457,HM Amla,0,0,0,0,0,0,0,0,4,13,17,4,13,17,0,300,1,0,1,5.20168,0.403361,48.7899,86.9292,119,4
West Indies,176,217.33,7.15909,0.3125,225.278,7.57386,0.380682,457,CH Gayle,0,0,0,0,0,0,0,0,12,7,19,12,7,19,301,283,0,1,1,4.58621,0.206897,31.1293,89.4255,116,4
West Indies,176,217.33,7.15909,0.3125,225.278,7.57386,0.380682,457,DM Richards,0,0,0,0,0,0,0,0,12,7,19,12,7,19,301,283,0,1,1,3.42857,0.285714,25.5714,68.8462,7,4
South Africa,190,234.274,7.4,0.373684,232.363,7.33158,0.342105,458,HM Amla,0,0,0,0,0,0,0,0,8,17,25,8,17,25,0,224,0,0,1,5.20168,0.403361,48.7899,86.9292,119,4
South Africa,190,234.274,7.4,0.373684,232.363,7.33158,0.342105,458,GC Smith,0,0,0,0,0,0,0,0,8,17,25,8,17,25,0,224,0,0,1,3.97,0.29,33.57,79.6819,100,4
West Indies,176,217.33,7.15909,0.3125,225.278,7.57386,0.380682,458,CH Gayle,0,0,0,0,0,0,0,0,8,11,19,8,11,19,225,157,4,1,1,4.58621,0.206897,31.1293,89.4255,116,4
West Indies,176,217.33,7.15909,0.3125,225.278,7.57386,0.380682,458,DM Richards,0,0,0,0,0,0,0,0,8,11,19,8,11,19,225,157,4,1,1,3.42857,0.285714,25.5714,68.8462,7,4
West Indies,176,217.33,7.15909,0.3125,225.278,7.57386,0.380682,459,DM Richards,0,0,0,0,0,0,0,0,18,9,27,18,9,27,0,303,1,1,1,3.42857,0.285714,25.5714,68.8462,7,4
West Indies,176,217.33,7.15909,0.3125,225.278,7.57386,0.380682,459,CH Gayle,0,0,0,0,0,0,0,0,18,9,27,18,9,27,0,303,1,1,1,4.58621,0.206897,31.1293,89.4255,116,4
South Africa,190,234.274,7.4,0.373684,232.363,7.33158,0.342105,459,GC Smith,0,0,0,0,0,0,0,0,4,16,20,4,16,20,304,304,3,0,1,3.97,0.29,33.57,79.6819,100,4
South Africa,190,234.274,7.4,0.373684,232.363,7.33158,0.342105,459,HM Amla,0,0,0,0,0,0,0,0,4,16,20,4,16,20,304,304,3,0,1,5.20168,0.403361,48.7899,86.9292,119,4
India,259,242.378,7.15058,0.339768,244.568,7.12741,0.30888,460,V Sehwag,0,0,0,0,0,0,0,0,18,5,23,18,5,23,0,298,3,1,1,5.88636,0.238636,38.8295,108.649,88,0
India,259,242.378,7.15058,0.339768,244.568,7.12741,0.30888,460,SR Tendulkar,0,0,0,0,0,0,0,0,18,5,23,18,5,23,0,298,3,1,1,5.89773,0.363636,45.6023,84.5376,88,4
India,259,242.378,7.15058,0.339768,244.568,7.12741,0.30888,460,KD Karthik,0,0,0,0,0,0,0,0,18,5,23,18,5,23,0,298,3,1,1,2.46429,0.107143,21.6786,71.8769,56,1
South Africa,190,234.274,7.4,0.373684,232.363,7.33158,0.342105,460,LE Bosman,0,0,0,0,0,0,0,0,8,10,18,8,10,18,299,297,3,0,1,4.18182,0.181818,27.1818,97.7124,11,0
South Africa,190,234.274,7.4,0.373684,232.363,7.33158,0.342105,460,HH Gibbs,0,0,0,0,0,0,0,0,8,10,18,8,10,18,299,297,3,0,1,4.61538,0.307692,35.6923,83.4157,52,4
India,259,242.378,7.15058,0.339768,244.568,7.12741,0.30888,461,V Sehwag,0,0,0,0,0,0,0,0,20,11,31,20,11,31,0,401,0,1,1,5.88636,0.238636,38.8295,108.649,88,0
India,259,242.378,7.15058,0.339768,244.568,7.12741,0.30888,461,SR Tendulkar,0,0,0,0,0,0,0,0,20,11,31,20,11,31,0,401,0,1,1,5.89773,0.363636,45.6023,84.5376,88,4
India,259,242.378,7.15058,0.339768,244.568,7.12741,0.30888,461,KD Karthik,0,0,0,0,0,0,0,0,20,11,31,20,11,31,0,401,0,1,1,2.46429,0.107143,21.6786,71.8769,56,1
South Africa,190,234.274,7.4,0.373684,232.363,7.33158,0.342105,461,HM Amla,0,0,0,0,0,0,0,0,34,8,42,34,8,42,402,248,1,0,1,5.20168,0.403361,48.7899,86.9292,119,4
South Africa,190,234.274,7.4,0.373684,232.363,7.33158,0.342105,461,HH Gibbs,0,0,0,0,0,0,0,0,34,8,42,34,8,42,402,248,1,0,1,4.61538,0.307692,35.6923,83.4157,52,4
South Africa,190,234.274,7.4,0.373684,232.363,7.33158,0.342105,461,RE van der Merwe,0,0,0,0,0,0,0,0,34,8,42,34,8,42,402,248,1,0,1,0.714286,0,5.57143,95.122,7,0
South Africa,190,234.274,7.4,0.373684,232.363,7.33158,0.342105,462,LE Bosman,0,0,0,0,0,0,0,0,12,9,21,12,9,21,0,365,1,0,1,4.18182,0.181818,27.1818,97.7124,11,0
South Africa,190,234.274,7.4,0.373684,232.363,7.33158,0.342105,462,HM Amla,0,0,0,0,0,0,0,0,12,9,21,12,9,21,0,365,1,0,1,5.20168,0.403361,48.7899,86.9292,119,4
India,259,242.378,7.15058,0.339768,244.568,7.12741,0.30888,462,KD Karthik,0,0,0,0,0,0,0,0,24,9,33,24,9,33,366,275,3,1,1,2.46429,0.107143,21.6786,71.8769,56,1
India,259,242.378,7.15058,0.339768,244.568,7.12741,0.30888,462,M Vijay,0,0,0,0,0,0,0,0,24,9,33,24,9,33,366,275,3,1,1,2.25,0.0625,21.1875,65.6977,16,1
India,259,242.378,7.15058,0.339768,244.568,7.12741,0.30888,462,V Kohli,0,0,0,0,0,0,0,0,24,9,33,24,9,33,366,275,3,1,1,4.66456,0.379747,44.9937,88.3325,158,4
Australia,228,239.627,7.69737,0.372807,232.079,7.23246,0.337719,463,SR Watson,0,0,0,0,0,0,0,0,8,11,19,8,11,19,0,239,0,1,1,4.71318,0.286822,37.7907,90.0943,129,4
Australia,228,239.627,7.69737,0.372807,232.079,7.23246,0.337719,463,BJ Haddin,0,0,0,0,0,0,0,0,8,11,19,8,11,19,0,239,0,1,1,3.14737,0.147368,26.7789,81.382,95,4
Sri Lanka,244,223.373,7.09016,0.344262,227.578,7.47541,0.385246,463,WU Tharanga,0,0,0,0,0,0,0,0,8,11,19,8,11,19,240,243,0,0,1,3.93985,0.263158,32.9699,71.6035,133,4
Sri Lanka,244,223.373,7.09016,0.344262,227.578,7.47541,0.385246,463,TM Dilshan,0,0,0,0,0,0,0,0,8,11,19,8,11,19,240,243,0,0,1,4.60199,0.273632,38.3632,86.0219,201,4
Sri Lanka,244,223.373,7.09016,0.344262,227.578,7.47541,0.385246,463,KC Sangakkara,0,0,0,0,0,0,0,0,8,11,19,8,11,19,240,243,0,0,1,4.33659,0.360976,41.9854,80.6276,205,4
Sri Lanka,244,223.373,7.09016,0.344262,227.578,7.47541,0.385246,464,WU Tharanga,0,0,0,0,0,0,0,0,12,6,18,12,6,18,0,213,0,0,1,3.93985,0.263158,32.9699,71.6035,133,4
Sri Lanka,244,223.373,7.09016,0.344262,227.578,7.47541,0.385246,464,TM Dilshan,0,0,0,0,0,0,0,0,12,6,18,12,6,18,0,213,0,0,1,4.60199,0.273632,38.3632,86.0219,201,4
Australia,228,239.627,7.69737,0.372807,232.079,7.23246,0.337719,464,SR Watson,0,0,0,0,0,0,0,0,12,13,25,12,13,25,214,210,3,1,1,4.71318,0.286822,37.7907,90.0943,129,4
Australia,228,239.627,7.69737,0.372807,232.079,7.23246,0.337719,464,BJ Haddin,0,0,0,0,0,0,0,0,12,13,25,12,13,25,214,210,3,1,1,3.14737,0.147368,26.7789,81.382,95,4
Australia,228,239.627,7.69737,0.372807,232.079,7.23246,0.337719,464,RT Ponting,0,0,0,0,0,0,0,0,12,13,25,12,13,25,214,210,3,1,1,4.17431,0.33945,38.1009,80.8606,109,4
Sri Lanka,244,223.373,7.09016,0.344262,227.578,7.47541,0.385246,465,WU Tharanga,0,0,0,0,0,0,0,0,8,5,13,8,5,13,0,115,6,0,1,3.93985,0.263158,32.9699,71.6035,133,4
Sri Lanka,244,223.373,7.09016,0.344262,227.578,7.47541,0.385246,465,TM Dilshan,0,0,0,0,0,0,0,0,8,5,13,8,5,13,0,115,6,0,1,4.60199,0.273632,38.3632,86.0219,201,4
Sri Lanka,244,223.373,7.09016,0.344262,227.578,7.47541,0.385246,465,KC Sangakkara,0,0,0,0,0,0,0,0,8,5,13,8,5,13,0,115,6,0,1,4.33659,0.360976,41.9854,80.6276,205,4
Sri Lanka,244,223.373,7.09016,0.344262,227.578,7.47541,0.385246,465,DPMD Jayawardene,0,0,0,0,0,0,0,0,8,5,13,8,5,13,0,115,6,0,1,3.20833,0.244792,31.6979,79.1109,192,4
Sri Lanka,244,223.373,7.09016,0.344262,227.578,7.47541,0.385246,465,LPC Silva,0,0,0,0,0,0,0,0,8,5,13,8,5,13,0,115,6,0,1,2.55556,0.244444,26.0222,69.4543,45,4
Australia,228,239.627,7.69737,0.372807,232.079,7.23246,0.337719,465,SR Watson,0,0,0,0,0,0,0,0,8,20,28,8,20,28,116,119,6,1,1,4.71318,0.286822,37.7907,90.0943,129,4
Australia,228,239.627,7.69737,0.372807,232.079,7.23246,0.337719,465,BJ Haddin,0,0,0,0,0,0,0,0,8,20,28,8,20,28,116,119,6,1,1,3.14737,0.147368,26.7789,81.382,95,4
England,221,237.176,7.17647,0.289593,230.633,7.45701,0.384615,466,AJ Strauss,0,0,0,0,0,0,0,0,12,14,26,12,14,26,0,294,3,0,1,3.93243,0.27027,33.9054,79.8028,74,4
England,221,237.176,7.17647,0.289593,230.633,7.45701,0.384615,466,SM Davies,0,0,0,0,0,0,0,0,12,14,26,12,14,26,0,294,3,0,1,4.5,0.125,30.125,100.837,8,0
Australia,228,239.627,7.69737,0.372807,232.079,7.23246,0.337719,466,SR Watson,0,0,0,0,0,0,0,0,20,12,32,20,12,32,295,297,0,1,1,4.71318,0.286822,37.7907,90.0943,129,4
Australia,228,239.627,7.69737,0.372807,232.079,7.23246,0.337719,466,BJ Haddin,0,0,0,0,0,0,0,0,20,12,32,20,12,32,295,297,0,1,1,3.14737,0.147368,26.7789,81.382,95,4
Australia,228,239.627,7.69737,0.372807,232.079,7.23246,0.337719,467,SR Watson,0,0,0,0,0,0,0,0,4,6,10,4,6,10,0,230,1,1,1,4.71318,0.286822,37.7907,90.0943,129,4
Australia,228,239.627,7.69737,0.372807,232.079,7.23246,0.337719,467,BJ Haddin,0,0,0,0,0,0,0,0,4,6,10,4,6,10,0,230,1,1,1,3.14737,0.147368,26.7789,81.382,95,4
Australia,228,239.627,7.69737,0.372807,232.079,7.23246,0.337719,467,MJ Clarke,0,0,0,0,0,0,0,0,4,6,10,4,6,10,0,230,1,1,1,3.10294,0.301471,35.9265,74.0303,136,4
England,221,237.176,7.17647,0.289593,230.633,7.45701,0.384615,467,AJ Strauss,0,0,0,0,0,0,0,0,12,10,22,12,10,22,231,184,4,0,1,3.93243,0.27027,33.9054,79.8028,74,4
England,221,237.176,7.17647,0.289593,230.633,7.45701,0.384615,467,MJ Prior,0,0,0,0,0,0,0,0,12,10,22,12,10,22,231,184,4,0,1,2.27083,0.0625,21.6875,76.4879,48,4
England,221,237.176,7.17647,0.289593,230.633,7.45701,0.384615,467,IJL Trott,0,0,0,0,0,0,0,0,12,10,22,12,10,22,231,184,4,0,1,3.3871,0.403226,43.7903,75.2494,62,4
England,221,237.176,7.17647,0.289593,230.633,7.45701,0.384615,468,AJ Strauss,0,0,0,0,0,0,0,0,4,13,17,4,13,17,0,214,1,0,1,3.93243,0.27027,33.9054,79.8028,74,4
England,221,237.176,7.17647,0.289593,230.633,7.45701,0.384615,468,MJ Prior,0,0,0,0,0,0,0,0,4,13,17,4,13,17,0,214,1,0,1,2.27083,0.0625,21.6875,76.4879,48,4
England,221,237.176,7.17647,0.289593,230.633,7.45701,0.384615,468,IJL Trott,0,0,0,0,0,0,0,0,4,13,17,4,13,17,0,214,1,0,1,3.3871,0.403226,43.7903,75.2494,62,4
Australia,228,239.627,7.69737,0.372807,232.079,7.23246,0.337719,468,SR Watson,0,0,0,0,0,0,0,0,20,6,26,20,6,26,215,215,3,1,1,4.71318,0.286822,37.7907,90.0943,129,4
Australia,228,239.627,7.69737,0.372807,232.079,7.23246,0.337719,468,BJ Haddin,0,0,0,0,0,0,0,0,20,6,26,20,6,26,215,215,3,1,1,3.14737,0.147368,26.7789,81.382,95,4
Australia,228,239.627,7.69737,0.372807,232.079,7.23246,0.337719,468,SE Marsh,0,0,0,0,0,0,0,0,20,6,26,20,6,26,215,215,3,1,1,3.66667,0.291667,35.5417,74.7918,48,4
Australia,228,239.627,7.69737,0.372807,232.079,7.23246,0.337719,468,MJ Clarke,0,0,0,0,0,0,0,0,20,6,26,20,6,26,215,215,3,1,1,3.10294,0.301471,35.9265,74.0303,136,4
Australia,228,239.627,7.69737,0.372807,232.079,7.23246,0.337719,469,SR Watson,0,0,0,0,0,0,0,0,12,9,21,12,9,21,0,249,4,1,1,4.71318,0.286822,37.7907,90.0943,129,4
Australia,228,239.627,7.69737,0.372807,232.079,7.23246,0.337719,469,BJ Haddin,0,0,0,0,0,0,0,0,12,9,21,12,9,21,0,249,4,1,1,3.14737,0.147368,26.7789,81.382,95,4
England,221,237.176,7.17647,0.289593,230.633,7.45701,0.384615,469,AJ Strauss,0,0,0,0,0,0,0,0,12,5,17,12,5,17,250,198,3,0,1,3.93243,0.27027,33.9054,79.8028,74,4
England,221,237.176,7.17647,0.289593,230.633,7.45701,0.384615,469,MJ Prior,0,0,0,0,0,0,0,0,12,5,17,12,5,17,250,198,3,0,1,2.27083,0.0625,21.6875,76.4879,48,4
England,221,237.176,7.17647,0.289593,230.633,7.45701,0.384615,470,AJ Strauss,0,0,0,0,0,0,0,0,8,13,21,8,13,21,0,333,1,0,1,3.93243,0.27027,33.9054,79.8028,74,4
England,221,237.176,7.17647,0.289593,230.633,7.45701,0.384615,470,MJ Prior,0,0,0,0,0,0,0,0,8,13,21,8,13,21,0,333,1,0,1,2.27083,0.0625,21.6875,76.4879,48,4
Australia,228,239.627,7.69737,0.372807,232.079,7.23246,0.337719,470,SR Watson,0,0,0,0,0,0,0,0,16,15,31,16,15,31,334,334,5,1,1,4.71318,0.286822,37.7907,90.0943,129,4
Australia,228,239.627,7.69737,0.372807,232.079,7.23246,0.337719,470,BJ Haddin,0,0,0,0,0,0,0,0,16,15,31,16,15,31,334,334,5,1,1,3.14737,0.147368,26.7789,81.382,95,4
Australia,228,239.627,7.69737,0.372807,232.079,7.23246,0.337719,471,TD Paine,0,0,0,0,0,0,0,0,4,10,14,4,10,14,0,279,4,1,1,3.3913,0.217391,27.6522,65.7704,23,4
Australia,228,239.627,7.69737,0.372807,232.079,7.23246,0.337719,471,BJ Haddin,0,0,0,0,0,0,0,0,4,10,14,4,10,14,0,279,4,1,1,3.14737,0.147368,26.7789,81.382,95,4
Australia,228,239.627,7.69737,0.372807,232.079,7.23246,0.337719,471,CJ Ferguson,0,0,0,0,0,0,0,0,4,10,14,4,10,14,0,279,4,1,1,2.47826,0.173913,26.3478,80.4781,23,4
England,221,237.176,7.17647,0.289593,230.633,7.45701,0.384615,471,AJ Strauss,0,0,0,0,0,0,0,0,8,11,19,8,11,19,280,222,10,0,1,3.93243,0.27027,33.9054,79.8028,74,4
England,221,237.176,7.17647,0.289593,230.633,7.45701,0.384615,471,IJL Trott,0,0,0,0,0,0,0,0,8,11,19,8,11,19,280,222,10,0,1,3.3871,0.403226,43.7903,75.2494,62,4
England,221,237.176,7.17647,0.289593,230.633,7.45701,0.384615,471,SM Davies,0,0,0,0,0,0,0,0,8,11,19,8,11,19,280,222,10,0,1,4.5,0.125,30.125,100.837,8,0
England,221,237.176,7.17647,0.289593,230.633,7.45701,0.384615,471,KP Pietersen,0,0,0,0,0,0,0,0,8,11,19,8,11,19,280,222,10,0,1,3.69892,0.236559,33.4946,82.2117,93,4
Ireland,55,219.527,7.65455,0.290909,202.727,7.56364,0.4,472,WTS Porterfield,0,0,0,0,0,0,0,0,4,8,12,4,8,12,0,189,1,1,1,2.6,0.142857,24.6857,56.2866,35,3
Ireland,55,219.527,7.65455,0.290909,202.727,7.56364,0.4,472,PR Stirling,0,0,0,0,0,0,0,0,4,8,12,4,8,12,0,189,1,1,1,3.47826,0.173913,24.2174,88.1329,23,0
Ireland,55,219.527,7.65455,0.290909,202.727,7.56364,0.4,472,AR Cusack,0,0,0,0,0,0,0,0,4,8,12,4,8,12,0,189,1,1,1,1.2,0,12.0667,65.1079,15,1
Bangladesh,160,218.438,7.70625,0.4,211.106,7.05,0.325,472,Tamim Iqbal,0,0,0,0,0,0,0,0,4,6,10,4,6,10,190,191,0,0,1,4.05344,0.274809,31.8015,76.8068,131,4
Bangladesh,160,218.438,7.70625,0.4,211.106,7.05,0.325,472,Imrul Kayes,0,0,0,0,0,0,0,0,4,6,10,4,6,10,190,191,0,0,1,3,0.207547,26.2642,63.6488,53,4
India,259,242.378,7.15058,0.339768,244.568,7.12741,0.30888,476,KD Karthik,0,0,0,0,0,0,0,0,12,8,20,12,8,20,0,285,22,0,1,2.46429,0.107143,21.6786,71.8769,56,1
India,259,242.378,7.15058,0.339768,244.568,7.12741,0.30888,476,M Vijay,0,0,0,0,0,0,0,0,12,8,20,12,8,20,0,285,22,0,1,2.25,0.0625,21.1875,65.6977,16,1
Zimbabwe,142,212.077,7.5,0.380282,227.704,6.97887,0.316901,476,H Masakadza,0,0,0,0,0,0,0,0,12,12,24,12,12,24,286,289,0,1,1,3.11215,0.186916,26.972,70.0485,107,4
Zimbabwe,142,212.077,7.5,0.380282,227.704,6.97887,0.316901,476,BRM Taylor,0,0,0,0,0,0,0,0,12,12,24,12,12,24,286,289,0,1,1,3.3,0.26,33.56,76.3421,100,4
Sri Lanka,244,223.373,7.09016,0.344262,227.578,7.47541,0.385246,477,WU Tharanga,0,0,0,0,0,0,0,0,0,10,10,0,10,10,0,242,0,0,1,3.93985,0.263158,32.9699,71.6035,133,4
Sri Lanka,244,223.373,7.09016,0.344262,227.578,7.47541,0.385246,477,TM Dilshan,0,0,0,0,0,0,0,0,0,10,10,0,10,10,0,242,0,0,1,4.60199,0.273632,38.3632,86.0219,201,4
Sri Lanka,244,223.373,7.09016,0.344262,227.578,7.47541,0.385246,477,TT Samaraweera,0,0,0,0,0,0,0,0,0,10,10,0,10,10,0,242,0,0,1,2.19231,0.0769231,23.4231,73.8182,26,4
India,259,242.378,7.15058,0.339768,244.568,7.12741,0.30888,477,KD Karthik,0,0,0,0,0,0,0,0,8,10,18,8,10,18,243,243,2,0,1,2.46429,0.107143,21.6786,71.8769,56,1
India,259,242.378,7.15058,0.339768,244.568,7.12741,0.30888,477,M Vijay,0,0,0,0,0,0,0,0,8,10,18,8,10,18,243,243,2,0,1,2.25,0.0625,21.1875,65.6977,16,1
India,259,242.378,7.15058,0.339768,244.568,7.12741,0.30888,478,KD Karthik,0,0,0,0,0,0,0,0,4,5,9,4,5,9,0,194,4,0,1,2.46429,0.107143,21.6786,71.8769,56,1
India,259,242.378,7.15058,0.339768,244.568,7.12741,0.30888,478,M Vijay,0,0,0,0,0,0,0,0,4,5,9,4,5,9,0,194,4,0,1,2.25,0.0625,21.1875,65.6977,16,1
Zimbabwe,142,212.077,7.5,0.380282,227.704,6.97887,0.316901,478,H Masakadza,0,0,0,0,0,0,0,0,4,6,10,4,6,10,195,197,1,1,1,3.11215,0.186916,26.972,70.0485,107,4
Zimbabwe,142,212.077,7.5,0.380282,227.704,6.97887,0.316901,478,BRM Taylor,0,0,0,0,0,0,0,0,4,6,10,4,6,10,195,197,1,1,1,3.3,0.26,33.56,76.3421,100,4
India,259,242.378,7.15058,0.339768,244.568,7.12741,0.30888,479,KD Karthik,0,0,0,0,0,0,0,0,12,7,19,12,7,19,0,268,3,0,1,2.46429,0.107143,21.6786,71.8769,56,1
India,259,242.378,7.15058,0.339768,244.568,7.12741,0.30888,479,V Kohli,0,0,0,0,0,0,0,0,12,7,19,12,7,19,0,268,3,0,1,4.66456,0.379747,44.9937,88.3325,158,4
Sri Lanka,244,223.373,7.09016,0.344262,227.578,7.47541,0.385246,479,WU Tharanga,0,0,0,0,0,0,0,0,16,7,23,16,7,23,269,270,2,0,1,3.93985,0.263158,32.9699,71.6035,133,4
Sri Lanka,244,223.373,7.09016,0.344262,227.578,7.47541,0.385246,479,TM Dilshan,0,0,0,0,0,0,0,0,16,7,23,16,7,23,269,270,2,0,1,4.60199,0.273632,38.3632,86.0219,201,4
Sri Lanka,244,223.373,7.09016,0.344262,227.578,7.47541,0.385246,480,WU Tharanga,0,0,0,0,0,0,0,0,16,11,27,16,11,27,0,236,1,0,1,3.93985,0.263158,32.9699,71.6035,133,4
Sri Lanka,244,223.373,7.09016,0.344262,227.578,7.47541,0.385246,480,TM Dilshan,0,0,0,0,0,0,0,0,16,11,27,16,11,27,0,236,1,0,1,4.60199,0.273632,38.3632,86.0219,201,4
Zimbabwe,142,212.077,7.5,0.380282,227.704,6.97887,0.316901,480,H Masakadza,0,0,0,0,0,0,0,0,4,6,10,4,6,10,237,240,4,1,1,3.11215,0.186916,26.972,70.0485,107,4
Zimbabwe,142,212.077,7.5,0.380282,227.704,6.97887,0.316901,480,BRM Taylor,0,0,0,0,0,0,0,0,4,6,10,4,6,10,237,240,4,1,1,3.3,0.26,33.56,76.3421,100,4
Zimbabwe,142,212.077,7.5,0.380282,227.704,6.97887,0.316901,480,CJ Chibhabha,0,0,0,0,0,0,0,0,4,6,10,4,6,10,237,240,4,1,1,2.56716,0.149254,23.5373,64.7373,67,1
Zimbabwe,142,212.077,7.5,0.380282,227.704,6.97887,0.316901,481,H Masakadza,0,0,0,0,0,0,0,0,0,8,8,0,8,8,0,199,3,1,1,3.11215,0.186916,26.972,70.0485,107,4
Zimbabwe,142,212.077,7.5,0.380282,227.704,6.97887,0.316901,481,BRM Taylor,0,0,0,0,0,0,0,0,0,8,8,0,8,8,0,199,3,1,1,3.3,0.26,33.56,76.3421,100,4
Zimbabwe,142,212.077,7.5,0.380282,227.704,6.97887,0.316901,481,T Taibu,0,0,0,0,0,0,0,0,0,8,8,0,8,8,0,199,3,1,1,2.36364,0.254545,29.4,71.0145,55,4
Sri Lanka,244,223.373,7.09016,0.344262,227.578,7.47541,0.385246,481,WU Tharanga,0,0,0,0,0,0,0,0,24,7,31,24,7,31,200,203,3,0,1,3.93985,0.263158,32.9699,71.6035,133,4
Sri Lanka,244,223.373,7.09016,0.344262,227.578,7.47541,0.385246,481,TM Dilshan,0,0,0,0,0,0,0,0,24,7,31,24,7,31,200,203,3,0,1,4.60199,0.273632,38.3632,86.0219,201,4
Sri Lanka,244,223.373,7.09016,0.344262,227.578,7.47541,0.385246,482,WU Tharanga,0,0,0,0,0,0,0,0,20,8,28,20,8,28,0,242,3,1,1,3.93985,0.263158,32.9699,71.6035,133,4
Sri Lanka,244,223.373,7.09016,0.344262,227.578,7.47541,0.385246,482,TM Dilshan,0,0,0,0,0,0,0,0,20,8,28,20,8,28,0,242,3,1,1,4.60199,0.273632,38.3632,86.0219,201,4
Pakistan,211,222.621,7.38389,0.393365,235.517,7.54976,0.336493,482,Shahzaib Hasan,0,0,0,0,0,0,0,0,0,5,5,0,5,5,243,226,2,0,1,5,0.333333,33.3333,84.7458,3,4
Pakistan,211,222.621,7.38389,0.393365,235.517,7.54976,0.336493,482,Salman Butt,0,0,0,0,0,0,0,0,0,5,5,0,5,5,243,226,2,0,1,5.4359,0.384615,42.3846,78.8645,39,4
Pakistan,211,222.621,7.38389,0.393365,235.517,7.54976,0.336493,482,Umar Amin,0,0,0,0,0,0,0,0,0,5,5,0,5,5,243,226,2,0,1,2.14286,0.0714286,18.8571,67.3469,14,1
Bangladesh,160,218.438,7.70625,0.4,211.106,7.05,0.325,483,Tamim Iqbal,0,0,0,0,0,0,0,0,26,8,34,26,8,34,0,167,2,0,1,4.05344,0.274809,31.8015,76.8068,131,4
Bangladesh,160,218.438,7.70625,0.4,211.106,7.05,0.325,483,Imrul Kayes,0,0,0,0,0,0,0,0,26,8,34,26,8,34,0,167,2,0,1,3,0.207547,26.2642,63.6488,53,4
Bangladesh,160,218.438,7.70625,0.4,211.106,7.05,0.325,483,Mohammad Ashraful,0,0,0,0,0,0,0,0,26,8,34,26,8,34,0,167,2,0,1,2.17722,0.113924,19.4557,63.9085,79,1
India,259,242.378,7.15058,0.339768,244.568,7.12741,0.30888,483,G Gambhir,0,0,0,0,0,0,0,0,16,9,25,16,9,25,168,168,10,0,1,3.99145,0.333333,37.4701,84.1944,117,4
India,259,242.378,7.15058,0.339768,244.568,7.12741,0.30888,483,V Sehwag,0,0,0,0,0,0,0,0,16,9,25,16,9,25,168,168,10,0,1,5.88636,0.238636,38.8295,108.649,88,0
Sri Lanka,244,223.373,7.09016,0.344262,227.578,7.47541,0.385246,484,WU Tharanga,0,0,0,0,0,0,0,0,34,14,48,34,14,48,0,312,1,1,1,3.93985,0.263158,32.9699,71.6035,133,4
Sri Lanka,244,223.373,7.09016,0.344262,227.578,7.47541,0.385246,484,TM Dilshan,0,0,0,0,0,0,0,0,34,14,48,34,14,48,0,312,1,1,1,4.60199,0.273632,38.3632,86.0219,201,4
Bangladesh,160,218.438,7.70625,0.4,211.106,7.05,0.325,484,Tamim Iqbal,0,0,0,0,0,0,0,0,24,13,37,24,13,37,313,186,1,0,1,4.05344,0.274809,31.8015,76.8068,131,4
Bangladesh,160,218.438,7.70625,0.4,211.106,7.05,0.325,484,Imrul Kayes,0,0,0,0,0,0,0,0,24,13,37,24,13,37,313,186,1,0,1,3,0.207547,26.2642,63.6488,53,4
Bangladesh,160,218.438,7.70625,0.4,211.106,7.05,0.325,484,Junaid Siddique,0,0,0,0,0,0,0,0,24,13,37,24,13,37,313,186,1,0,1,2.16279,0.116279,20.0233,68.225,43,1
Pakistan,211,222.621,7.38389,0.393365,235.517,7.54976,0.336493,485,Salman Butt,0,0,0,0,0,0,0,0,16,3,19,16,3,19,0,267,2,0,1,5.4359,0.384615,42.3846,78.8645,39,4
Pakistan,211,222.621,7.38389,0.393365,235.517,7.54976,0.336493,485,Imran Farhat,0,0,0,0,0,0,0,0,16,3,19,16,3,19,0,267,2,0,1,3.03333,0.266667,27.0333,62.9658,30,4
India,259,242.378,7.15058,0.339768,244.568,7.12741,0.30888,485,G Gambhir,0,0,0,0,0,0,0,0,4,6,10,4,6,10,268,271,4,0,1,3.99145,0.333333,37.4701,84.1944,117,4
India,259,242.378,7.15058,0.339768,244.568,7.12741,0.30888,485,V Sehwag,0,0,0,0,0,0,0,0,4,6,10,4,6,10,268,271,4,0,1,5.88636,0.238636,38.8295,108.649,88,0
Pakistan,211,222.621,7.38389,0.393365,235.517,7.54976,0.336493,486,Imran Farhat,0,0,0,0,0,0,0,0,28,7,35,28,7,35,0,385,4,0,1,3.03333,0.266667,27.0333,62.9658,30,4
Pakistan,211,222.621,7.38389,0.393365,235.517,7.54976,0.336493,486,Shahzaib Hasan,0,0,0,0,0,0,0,0,28,7,35,28,7,35,0,385,4,0,1,5,0.333333,33.3333,84.7458,3,4
Bangladesh,160,218.438,7.70625,0.4,211.106,7.05,0.325,486,Tamim Iqbal,0,0,0,0,0,0,0,0,12,4,16,12,4,16,386,246,1,0,1,4.05344,0.274809,31.8015,76.8068,131,4
Bangladesh,160,218.438,7.70625,0.4,211.106,7.05,0.325,486,Imrul Kayes,0,0,0,0,0,0,0,0,12,4,16,12,4,16,386,246,1,0,1,3,0.207547,26.2642,63.6488,53,4
India,259,242.378,7.15058,0.339768,244.568,7.12741,0.30888,487,G Gambhir,0,0,0,0,0,0,0,0,20,9,29,20,9,29,0,268,0,0,1,3.99145,0.333333,37.4701,84.1944,117,4
India,259,242.378,7.15058,0.339768,244.568,7.12741,0.30888,487,KD Karthik,0,0,0,0,0,0,0,0,20,9,29,20,9,29,0,268,0,0,1,2.46429,0.107143,21.6786,71.8769,56,1
Sri Lanka,244,223.373,7.09016,0.344262,227.578,7.47541,0.385246,487,WU Tharanga,0,0,0,0,0,0,0,0,4,12,16,4,12,16,269,187,1,1,1,3.93985,0.263158,32.9699,71.6035,133,4
Sri Lanka,244,223.373,7.09016,0.344262,227.578,7.47541,0.385246,487,TM Dilshan,0,0,0,0,0,0,0,0,4,12,16,4,12,16,269,187,1,1,1,4.60199,0.273632,38.3632,86.0219,201,4
Sri Lanka,244,223.373,7.09016,0.344262,227.578,7.47541,0.385246,487,KC Sangakkara,0,0,0,0,0,0,0,0,4,12,16,4,12,16,269,187,1,1,1,4.33659,0.360976,41.9854,80.6276,205,4
New Zealand,184,233.745,7.39674,0.36413,227.951,7.30435,0.353261,488,PJ Ingram,0,0,0,0,0,0,0,0,16,10,26,16,10,26,0,288,1,0,1,4.28571,0.142857,27.5714,80.7531,7,4
New Zealand,184,233.745,7.39674,0.36413,227.951,7.30435,0.353261,488,MJ Guptill,0,0,0,0,0,0,0,0,16,10,26,16,10,26,0,288,1,0,1,4.8087,0.313043,38.1217,82.7482,115,4
New Zealand,184,233.745,7.39674,0.36413,227.951,7.30435,0.353261,488,LRPL Taylor,0,0,0,0,0,0,0,0,16,10,26,16,10,26,0,288,1,0,1,3.68382,0.301471,36.7206,79.3959,136,4
India,259,242.378,7.15058,0.339768,244.568,7.12741,0.30888,488,KD Karthik,0,0,0,0,0,0,0,0,12,9,21,12,9,21,289,88,1,0,1,2.46429,0.107143,21.6786,71.8769,56,1
India,259,242.378,7.15058,0.339768,244.568,7.12741,0.30888,488,V Sehwag,0,0,0,0,0,0,0,0,12,9,21,12,9,21,289,88,1,0,1,5.88636,0.238636,38.8295,108.649,88,0
Sri Lanka,244,223.373,7.09016,0.344262,227.578,7.47541,0.385246,489,WU Tharanga,0,0,0,0,0,0,0,0,8,10,18,8,10,18,0,170,2,1,1,3.93985,0.263158,32.9699,71.6035,133,4
Sri Lanka,244,223.373,7.09016,0.344262,227.578,7.47541,0.385246,489,KC Sangakkara,0,0,0,0,0,0,0,0,8,10,18,8,10,18,0,170,2,1,1,4.33659,0.360976,41.9854,80.6276,205,4
Sri Lanka,244,223.373,7.09016,0.344262,227.578,7.47541,0.385246,489,TM Dilshan,0,0,0,0,0,0,0,0,8,10,18,8,10,18,0,170,2,1,1,4.60199,0.273632,38.3632,86.0219,201,4
Sri Lanka,244,223.373,7.09016,0.344262,227.578,7.47541,0.385246,489,DPMD Jayawardene,0,0,0,0,0,0,0,0,8,10,18,8,10,18,0,170,2,1,1,3.20833,0.244792,31.6979,79.1109,192,4
India,259,242.378,7.15058,0.339768,244.568,7.12741,0.30888,489,KD Karthik,0,0,0,0,0,0,0,0,0,9,9,0,9,9,171,171,7,0,1,2.46429,0.107143,21.6786,71.8769,56,1
India,259,242.378,7.15058,0.339768,244.568,7.12741,0.30888,489,V Sehwag,0,0,0,0,0,0,0,0,0,9,9,0,9,9,171,171,7,0,1,5.88636,0.238636,38.8295,108.649,88,0
New Zealand,184,233.745,7.39674,0.36413,227.951,7.30435,0.353261,490,BJ Watling,0,0,0,0,0,0,0,0,4,8,12,4,8,12,0,192,3,0,1,3,0.263158,27.7895,66.9202,19,4
New Zealand,184,233.745,7.39674,0.36413,227.951,7.30435,0.353261,490,MJ Guptill,0,0,0,0,0,0,0,0,4,8,12,4,8,12,0,192,3,0,1,4.8087,0.313043,38.1217,82.7482,115,4
New Zealand,184,233.745,7.39674,0.36413,227.951,7.30435,0.353261,490,LRPL Taylor,0,0,0,0,0,0,0,0,4,8,12,4,8,12,0,192,3,0,1,3.68382,0.301471,36.7206,79.3959,136,4
Sri Lanka,244,223.373,7.09016,0.344262,227.578,7.47541,0.385246,490,WU Tharanga,0,0,0,0,0,0,0,0,12,7,19,12,7,19,193,195,1,1,1,3.93985,0.263158,32.9699,71.6035,133,4
Sri Lanka,244,223.373,7.09016,0.344262,227.578,7.47541,0.385246,490,TM Dilshan,0,0,0,0,0,0,0,0,12,7,19,12,7,19,193,195,1,1,1,4.60199,0.273632,38.3632,86.0219,201,4
Sri Lanka,244,223.373,7.09016,0.344262,227.578,7.47541,0.385246,490,KC Sangakkara,0,0,0,0,0,0,0,0,12,7,19,12,7,19,193,195,1,1,1,4.33659,0.360976,41.9854,80.6276,205,4
India,259,242.378,7.15058,0.339768,244.568,7.12741,0.30888,491,KD Karthik,0,0,0,0,0,0,0,0,16,9,25,16,9,25,0,223,2,0,1,2.46429,0.107143,21.6786,71.8769,56,1
India,259,242.378,7.15058,0.339768,244.568,7.12741,0.30888,491,V Kohli,0,0,0,0,0,0,0,0,16,9,25,16,9,25,0,223,2,0,1,4.66456,0.379747,44.9937,88.3325,158,4
India,259,242.378,7.15058,0.339768,244.568,7.12741,0.30888,491,V Sehwag,0,0,0,0,0,0,0,0,16,9,25,16,9,25,0,223,2,0,1,5.88636,0.238636,38.8295,108.649,88,0
New Zealand,184,233.745,7.39674,0.36413,227.951,7.30435,0.353261,491,BJ Watling,0,0,0,0,0,0,0,0,8,2,10,8,2,10,224,118,4,0,1,3,0.263158,27.7895,66.9202,19,4
New Zealand,184,233.745,7.39674,0.36413,227.951,7.30435,0.353261,491,MJ Guptill,0,0,0,0,0,0,0,0,8,2,10,8,2,10,224,118,4,0,1,4.8087,0.313043,38.1217,82.7482,115,4
New Zealand,184,233.745,7.39674,0.36413,227.951,7.30435,0.353261,491,LRPL Taylor,0,0,0,0,0,0,0,0,8,2,10,8,2,10,224,118,4,0,1,3.68382,0.301471,36.7206,79.3959,136,4
New Zealand,184,233.745,7.39674,0.36413,227.951,7.30435,0.353261,491,GD Elliott,0,0,0,0,0,0,0,0,8,2,10,8,2,10,224,118,4,0,1,2.67188,0.203125,29.4375,79.7629,64,4
New Zealand,184,233.745,7.39674,0.36413,227.951,7.30435,0.353261,491,SB Styris,0,0,0,0,0,0,0,0,8,2,10,8,2,10,224,118,4,0,1,3.20755,0.264151,33.8302,78.7094,53,4
India,259,242.378,7.15058,0.339768,244.568,7.12741,0.30888,492,KD Karthik,0,0,0,0,0,0,0,0,8,12,20,8,12,20,0,103,0,0,1,2.46429,0.107143,21.6786,71.8769,56,1
India,259,242.378,7.15058,0.339768,244.568,7.12741,0.30888,492,V Sehwag,0,0,0,0,0,0,0,0,8,12,20,8,12,20,0,103,0,0,1,5.88636,0.238636,38.8295,108.649,88,0
Sri Lanka,244,223.373,7.09016,0.344262,227.578,7.47541,0.385246,492,DPMD Jayawardene,0,0,0,0,0,0,0,0,28,6,34,28,6,34,104,104,2,1,1,3.20833,0.244792,31.6979,79.1109,192,4
Sri Lanka,244,223.373,7.09016,0.344262,227.578,7.47541,0.385246,492,TM Dilshan,0,0,0,0,0,0,0,0,28,6,34,28,6,34,104,104,2,1,1,4.60199,0.273632,38.3632,86.0219,201,4
Sri Lanka,244,223.373,7.09016,0.344262,227.578,7.47541,0.385246,493,DPMD Jayawardene,0,0,0,0,0,0,0,0,8,6,14,8,6,14,0,299,7,1,1,3.20833,0.244792,31.6979,79.1109,192,4
Sri Lanka,244,223.373,7.09016,0.344262,227.578,7.47541,0.385246,493,TM Dilshan,0,0,0,0,0,0,0,0,8,6,14,8,6,14,0,299,7,1,1,4.60199,0.273632,38.3632,86.0219,201,4
India,259,242.378,7.15058,0.339768,244.568,7.12741,0.30888,493,V Sehwag,0,0,0,0,0,0,0,0,24,7,31,24,7,31,300,225,3,0,1,5.88636,0.238636,38.8295,108.649,88,0
India,259,242.378,7.15058,0.339768,244.568,7.12741,0.30888,493,KD Karthik,0,0,0,0,0,0,0,0,24,7,31,24,7,31,300,225,3,0,1,2.46429,0.107143,21.6786,71.8769,56,1
India,259,242.378,7.15058,0.339768,244.568,7.12741,0.30888,493,V Kohli,0,0,0,0,0,0,0,0,24,7,31,24,7,31,300,225,3,0,1,4.66456,0.379747,44.9937,88.3325,158,4
Pakistan,211,222.621,7.38389,0.393365,235.517,7.54976,0.336493,494,Asad Shafiq,0,0,0,0,0,0,0,0,12,5,17,12,5,17,0,203,3,0,1,2.07843,0.176471,24.7843,67.1269,51,4
Pakistan,211,222.621,7.38389,0.393365,235.517,7.54976,0.336493,494,Mohammad Hafeez,0,0,0,0,0,0,0,0,12,5,17,12,5,17,0,203,3,0,1,4.04511,0.255639,34.3534,78.0625,133,4
South Africa,190,234.274,7.4,0.373684,232.363,7.33158,0.342105,494,GC Smith,0,0,0,0,0,0,0,0,8,17,25,8,17,25,204,207,0,0,1,3.97,0.29,33.57,79.6819,100,4
South Africa,190,234.274,7.4,0.373684,232.363,7.33158,0.342105,494,HM Amla,0,0,0,0,0,0,0,0,8,17,25,8,17,25,204,207,0,0,1,5.20168,0.403361,48.7899,86.9292,119,4
South Africa,190,234.274,7.4,0.373684,232.363,7.33158,0.342105,495,HM Amla,0,0,0,0,0,0,0,0,20,5,25,20,5,25,0,286,0,0,1,5.20168,0.403361,48.7899,86.9292,119,4
South Africa,190,234.274,7.4,0.373684,232.363,7.33158,0.342105,495,RJ Peterson,0,0,0,0,0,0,0,0,20,5,25,20,5,25,0,286,0,0,1,1.62069,0.0344828,15.7931,83.5766,29,1
South Africa,190,234.274,7.4,0.373684,232.363,7.33158,0.342105,495,CA Ingram,0,0,0,0,0,0,0,0,20,5,25,20,5,25,0,286,0,0,1,3,0.178571,27.1786,81.3904,28,4
Pakistan,211,222.621,7.38389,0.393365,235.517,7.54976,0.336493,495,Asad Shafiq,0,0,0,0,0,0,0,0,16,5,21,16,5,21,287,289,2,0,1,2.07843,0.176471,24.7843,67.1269,51,4
Pakistan,211,222.621,7.38389,0.393365,235.517,7.54976,0.336493,495,Mohammad Hafeez,0,0,0,0,0,0,0,0,16,5,21,16,5,21,287,289,2,0,1,4.04511,0.255639,34.3534,78.0625,133,4
Pakistan,211,222.621,7.38389,0.393365,235.517,7.54976,0.336493,495,Younis Khan,0,0,0,0,0,0,0,0,16,5,21,16,5,21,287,289,2,0,1,2.64655,0.215517,28.5,73.2713,116,4
South Africa,190,234.274,7.4,0.373684,232.363,7.33158,0.342105,496,GC Smith,0,0,0,0,0,0,0,0,12,11,23,12,11,23,0,274,1,0,1,3.97,0.29,33.57,79.6819,100,4
South Africa,190,234.274,7.4,0.373684,232.363,7.33158,0.342105,496,HM Amla,0,0,0,0,0,0,0,0,12,11,23,12,11,23,0,274,1,0,1,5.20168,0.403361,48.7899,86.9292,119,4
Pakistan,211,222.621,7.38389,0.393365,235.517,7.54976,0.336493,496,Imran Farhat,0,0,0,0,0,0,0,0,4,26,30,4,26,30,275,275,2,0,1,3.03333,0.266667,27.0333,62.9658,30,4
Pakistan,211,222.621,7.38389,0.393365,235.517,7.54976,0.336493,496,Mohammad Hafeez,0,0,0,0,0,0,0,0,4,26,30,4,26,30,275,275,2,0,1,4.04511,0.255639,34.3534,78.0625,133,4
Pakistan,211,222.621,7.38389,0.393365,235.517,7.54976,0.336493,496,Younis Khan,0,0,0,0,0,0,0,0,4,26,30,4,26,30,275,275,2,0,1,2.64655,0.215517,28.5,73.2713,116,4
South Africa,190,234.274,7.4,0.373684,232.363,7.33158,0.342105,497,HM Amla,0,0,0,0,0,0,0,0,28,8,36,28,8,36,0,317,1,0,1,5.20168,0.403361,48.7899,86.9292,119,4
South Africa,190,234.274,7.4,0.373684,232.363,7.33158,0.342105,497,GC Smith,0,0,0,0,0,0,0,0,28,8,36,28,8,36,0,317,1,0,1,3.97,0.29,33.57,79.6819,100,4
Pakistan,211,222.621,7.38389,0.393365,235.517,7.54976,0.336493,497,Shahzaib Hasan,0,0,0,0,0,0,0,0,20,6,26,20,6,26,318,260,1,0,1,5,0.333333,33.3333,84.7458,3,4
Pakistan,211,222.621,7.38389,0.393365,235.517,7.54976,0.336493,497,Mohammad Hafeez,0,0,0,0,0,0,0,0,20,6,26,20,6,26,318,260,1,0,1,4.04511,0.255639,34.3534,78.0625,133,4
South Africa,190,234.274,7.4,0.373684,232.363,7.33158,0.342105,498,HM Amla,0,0,0,0,0,0,0,0,32,8,40,32,8,40,0,351,3,1,1,5.20168,0.403361,48.7899,86.9292,119,4
South Africa,190,234.274,7.4,0.373684,232.363,7.33158,0.342105,498,GC Smith,0,0,0,0,0,0,0,0,32,8,40,32,8,40,0,351,3,1,1,3.97,0.29,33.57,79.6819,100,4
Zimbabwe,142,212.077,7.5,0.380282,227.704,6.97887,0.316901,498,H Masakadza,0,0,0,0,0,0,0,0,24,6,30,24,6,30,352,287,2,0,1,3.11215,0.186916,26.972,70.0485,107,4
Zimbabwe,142,212.077,7.5,0.380282,227.704,6.97887,0.316901,498,BRM Taylor,0,0,0,0,0,0,0,0,24,6,30,24,6,30,352,287,2,0,1,3.3,0.26,33.56,76.3421,100,4
Zimbabwe,142,212.077,7.5,0.380282,227.704,6.97887,0.316901,499,BRM Taylor,0,0,0,0,0,0,0,0,12,4,16,12,4,16,0,268,3,0,1,3.3,0.26,33.56,76.3421,100,4
Zimbabwe,142,212.077,7.5,0.380282,227.704,6.97887,0.316901,499,CJ Chibhabha,0,0,0,0,0,0,0,0,12,4,16,12,4,16,0,268,3,0,1,2.56716,0.149254,23.5373,64.7373,67,1
South Africa,190,234.274,7.4,0.373684,232.363,7.33158,0.342105,499,HM Amla,0,0,0,0,0,0,0,0,12,12,24,12,12,24,269,273,2,1,1,5.20168,0.403361,48.7899,86.9292,119,4
South Africa,190,234.274,7.4,0.373684,232.363,7.33158,0.342105,499,GC Smith,0,0,0,0,0,0,0,0,12,12,24,12,12,24,269,273,2,1,1,3.97,0.29,33.57,79.6819,100,4
South Africa,190,234.274,7.4,0.373684,232.363,7.33158,0.342105,500,GC Smith,0,0,0,0,0,0,0,0,36,9,45,36,9,45,0,399,4,1,1,3.97,0.29,33.57,79.6819,100,4
South Africa,190,234.274,7.4,0.373684,232.363,7.33158,0.342105,500,HM Amla,0,0,0,0,0,0,0,0,36,9,45,36,9,45,0,399,4,1,1,5.20168,0.403361,48.7899,86.9292,119,4
Zimbabwe,142,212.077,7.5,0.380282,227.704,6.97887,0.316901,500,BRM Taylor,0,0,0,0,0,0,0,0,14,9,23,14,9,23,400,127,0,0,1,3.3,0.26,33.56,76.3421,100,4
Zimbabwe,142,212.077,7.5,0.380282,227.704,6.97887,0.316901,500,H Masakadza,0,0,0,0,0,0,0,0,14,9,23,14,9,23,400,127,0,0,1,3.11215,0.186916,26.972,70.0485,107,4
Zimbabwe,142,212.077,7.5,0.380282,227.704,6.97887,0.316901,500,CJ Chibhabha,0,0,0,0,0,0,0,0,14,9,23,14,9,23,400,127,0,0,1,2.56716,0.149254,23.5373,64.7373,67,1
Zimbabwe,142,212.077,7.5,0.380282,227.704,6.97887,0.316901,500,T Taibu,0,0,0,0,0,0,0,0,14,9,23,14,9,23,400,127,0,0,1,2.36364,0.254545,29.4,71.0145,55,4
South Africa,190,234.274,7.4,0.373684,232.363,7.33158,0.342105,501,GC Smith,0,0,0,0,0,0,0,0,16,10,26,16,10,26,0,289,3,1,1,3.97,0.29,33.57,79.6819,100,4
South Africa,190,234.274,7.4,0.373684,232.363,7.33158,0.342105,501,HM Amla,0,0,0,0,0,0,0,0,16,10,26,16,10,26,0,289,3,1,1,5.20168,0.403361,48.7899,86.9292,119,4
South Africa,190,234.274,7.4,0.373684,232.363,7.33158,0.342105,501,CA Ingram,0,0,0,0,0,0,0,0,16,10,26,16,10,26,0,289,3,1,1,3,0.178571,27.1786,81.3904,28,4
India,259,242.378,7.15058,0.339768,244.568,7.12741,0.30888,501,M Vijay,0,0,0,0,0,0,0,0,4,15,19,4,15,19,290,154,6,0,1,2.25,0.0625,21.1875,65.6977,16,1
India,259,242.378,7.15058,0.339768,244.568,7.12741,0.30888,501,SR Tendulkar,0,0,0,0,0,0,0,0,4,15,19,4,15,19,290,154,6,0,1,5.89773,0.363636,45.6023,84.5376,88,4
India,259,242.378,7.15058,0.339768,244.568,7.12741,0.30888,501,V Kohli,0,0,0,0,0,0,0,0,4,15,19,4,15,19,290,154,6,0,1,4.66456,0.379747,44.9937,88.3325,158,4
India,259,242.378,7.15058,0.339768,244.568,7.12741,0.30888,501,RG Sharma,0,0,0,0,0,0,0,0,4,15,19,4,15,19,290,154,6,0,1,3.82836,0.268657,35.9179,83.083,134,4
India,259,242.378,7.15058,0.339768,244.568,7.12741,0.30888,502,M Vijay,0,0,0,0,0,0,0,0,8,4,12,8,4,12,0,190,0,0,1,2.25,0.0625,21.1875,65.6977,16,1
India,259,242.378,7.15058,0.339768,244.568,7.12741,0.30888,502,SR Tendulkar,0,0,0,0,0,0,0,0,8,4,12,8,4,12,0,190,0,0,1,5.89773,0.363636,45.6023,84.5376,88,4
South Africa,190,234.274,7.4,0.373684,232.363,7.33158,0.342105,502,HM Amla,0,0,0,0,0,0,0,0,16,7,23,16,7,23,191,189,0,1,1,5.20168,0.403361,48.7899,86.9292,119,4
South Africa,190,234.274,7.4,0.373684,232.363,7.33158,0.342105,502,GC Smith,0,0,0,0,0,0,0,0,16,7,23,16,7,23,191,189,0,1,1,3.97,0.29,33.57,79.6819,100,4
South Africa,190,234.274,7.4,0.373684,232.363,7.33158,0.342105,502,CA Ingram,0,0,0,0,0,0,0,0,16,7,23,16,7,23,191,189,0,1,1,3,0.178571,27.1786,81.3904,28,4
South Africa,190,234.274,7.4,0.373684,232.363,7.33158,0.342105,503,GC Smith,0,0,0,0,0,0,0,0,12,11,23,12,11,23,0,220,0,1,1,3.97,0.29,33.57,79.6819,100,4
South Africa,190,234.274,7.4,0.373684,232.363,7.33158,0.342105,503,HM Amla,0,0,0,0,0,0,0,0,12,11,23,12,11,23,0,220,0,1,1,5.20168,0.403361,48.7899,86.9292,119,4
India,259,242.378,7.15058,0.339768,244.568,7.12741,0.30888,503,RG Sharma,0,0,0,0,0,0,0,0,4,8,12,4,8,12,221,223,2,0,1,3.82836,0.268657,35.9179,83.083,134,4
India,259,242.378,7.15058,0.339768,244.568,7.12741,0.30888,503,M Vijay,0,0,0,0,0,0,0,0,4,8,12,4,8,12,221,223,2,0,1,2.25,0.0625,21.1875,65.6977,16,1
India,259,242.378,7.15058,0.339768,244.568,7.12741,0.30888,503,V Kohli,0,0,0,0,0,0,0,0,4,8,12,4,8,12,221,223,2,0,1,4.66456,0.379747,44.9937,88.3325,158,4
South Africa,190,234.274,7.4,0.373684,232.363,7.33158,0.342105,504,HM Amla,0,0,0,0,0,0,0,0,4,5,9,4,5,9,0,265,1,1,1,5.20168,0.403361,48.7899,86.9292,119,4
South Africa,190,234.274,7.4,0.373684,232.363,7.33158,0.342105,504,GC Smith,0,0,0,0,0,0,0,0,4,5,9,4,5,9,0,265,1,1,1,3.97,0.29,33.57,79.6819,100,4
India,259,242.378,7.15058,0.339768,244.568,7.12741,0.30888,504,RG Sharma,0,0,0,0,0,0,0,0,16,3,19,16,3,19,266,142,0,0,1,3.82836,0.268657,35.9179,83.083,134,4
India,259,242.378,7.15058,0.339768,244.568,7.12741,0.30888,504,PA Patel,0,0,0,0,0,0,0,0,16,3,19,16,3,19,266,142,0,0,1,2.65217,0.130435,22.1304,79.4072,23,4
India,259,242.378,7.15058,0.339768,244.568,7.12741,0.30888,504,V Kohli,0,0,0,0,0,0,0,0,16,3,19,16,3,19,266,142,0,0,1,4.66456,0.379747,44.9937,88.3325,158,4
Australia,228,239.627,7.69737,0.372807,232.079,7.23246,0.337719,505,SE Marsh,0,0,0,0,0,0,0,0,4,3,7,4,3,7,0,289,5,0,1,3.66667,0.291667,35.5417,74.7918,48,4
Australia,228,239.627,7.69737,0.372807,232.079,7.23246,0.337719,505,TD Paine,0,0,0,0,0,0,0,0,4,3,7,4,3,7,0,289,5,0,1,3.3913,0.217391,27.6522,65.7704,23,4
Australia,228,239.627,7.69737,0.372807,232.079,7.23246,0.337719,505,MJ Clarke,0,0,0,0,0,0,0,0,4,3,7,4,3,7,0,289,5,0,1,3.10294,0.301471,35.9265,74.0303,136,4
India,259,242.378,7.15058,0.339768,244.568,7.12741,0.30888,505,S Dhawan,0,0,0,0,0,0,0,0,8,10,18,8,10,18,290,292,5,1,1,5.65217,0.362319,43.2174,88.9088,69,4
India,259,242.378,7.15058,0.339768,244.568,7.12741,0.30888,505,V Kohli,0,0,0,0,0,0,0,0,8,10,18,8,10,18,290,292,5,1,1,4.66456,0.379747,44.9937,88.3325,158,4
India,259,242.378,7.15058,0.339768,244.568,7.12741,0.30888,505,M Vijay,0,0,0,0,0,0,0,0,8,10,18,8,10,18,290,292,5,1,1,2.25,0.0625,21.1875,65.6977,16,1
West Indies,176,217.33,7.15909,0.3125,225.278,7.57386,0.380682,508,CH Gayle,0,0,0,0,0,0,0,0,4,6,10,4,6,10,0,203,5,0,1,4.58621,0.206897,31.1293,89.4255,116,4
West Indies,176,217.33,7.15909,0.3125,225.278,7.57386,0.380682,508,AB Barath,0,0,0,0,0,0,0,0,4,6,10,4,6,10,0,203,5,0,1,2.76923,0.0769231,21.6154,56.4257,13,3
Sri Lanka,244,223.373,7.09016,0.344262,227.578,7.47541,0.385246,508,WU Tharanga,0,0,0,0,0,0,0,0,4,11,15,4,11,15,204,199,7,1,1,3.93985,0.263158,32.9699,71.6035,133,4
Sri Lanka,244,223.373,7.09016,0.344262,227.578,7.47541,0.385246,508,TM Dilshan,0,0,0,0,0,0,0,0,4,11,15,4,11,15,204,199,7,1,1,4.60199,0.273632,38.3632,86.0219,201,4
Sri Lanka,244,223.373,7.09016,0.344262,227.578,7.47541,0.385246,509,WU Tharanga,0,0,0,0,0,0,0,0,10,12,22,10,12,22,0,277,6,1,1,3.93985,0.263158,32.9699,71.6035,133,4
Sri Lanka,244,223.373,7.09016,0.344262,227.578,7.47541,0.385246,509,TM Dilshan,0,0,0,0,0,0,0,0,10,12,22,10,12,22,0,277,6,1,1,4.60199,0.273632,38.3632,86.0219,201,4
West Indies,176,217.33,7.15909,0.3125,225.278,7.57386,0.380682,509,CH Gayle,0,0,0,0,0,0,0,0,12,5,17,12,5,17,278,251,0,0,1,4.58621,0.206897,31.1293,89.4255,116,4
West Indies,176,217.33,7.15909,0.3125,225.278,7.57386,0.380682,509,DM Bravo,0,0,0,0,0,0,0,0,12,5,17,12,5,17,278,251,0,0,1,3,0.226667,28.52,67.4551,75,4
West Indies,176,217.33,7.15909,0.3125,225.278,7.57386,0.380682,509,AB Barath,0,0,0,0,0,0,0,0,12,5,17,12,5,17,278,251,0,0,1,2.76923,0.0769231,21.6154,56.4257,13,3
West Indies,176,217.33,7.15909,0.3125,225.278,7.57386,0.380682,509,RR Sarwan,0,0,0,0,0,0,0,0,12,5,17,12,5,17,278,251,0,0,1,2.8254,0.222222,29.1429,69.1005,63,4
India,259,242.378,7.15058,0.339768,244.568,7.12741,0.30888,510,M Vijay,0,0,0,0,0,0,0,0,16,8,24,16,8,24,0,276,3,1,1,2.25,0.0625,21.1875,65.6977,16,1
India,259,242.378,7.15058,0.339768,244.568,7.12741,0.30888,510,G Gambhir,0,0,0,0,0,0,0,0,16,8,24,16,8,24,0,276,3,1,1,3.99145,0.333333,37.4701,84.1944,117,4
New Zealand,184,233.745,7.39674,0.36413,227.951,7.30435,0.353261,510,MJ Guptill,0,0,0,0,0,0,0,0,12,4,16,12,4,16,277,236,1,0,1,4.8087,0.313043,38.1217,82.7482,115,4
New Zealand,184,233.745,7.39674,0.36413,227.951,7.30435,0.353261,510,JM How,0,0,0,0,0,0,0,0,12,4,16,12,4,16,277,236,1,0,1,3.34615,0.192308,29.9231,64.9416,26,4
New Zealand,184,233.745,7.39674,0.36413,227.951,7.30435,0.353261,511,MJ Guptill,0,0,0,0,0,0,0,0,16,5,21,16,5,21,0,258,1,0,1,4.8087,0.313043,38.1217,82.7482,115,4
New Zealand,184,233.745,7.39674,0.36413,227.951,7.30435,0.353261,511,JM How,0,0,0,0,0,0,0,0,16,5,21,16,5,21,0,258,1,0,1,3.34615,0.192308,29.9231,64.9416,26,4
New Zealand,184,233.745,7.39674,0.36413,227.951,7.30435,0.353261,511,KS Williamson,0,0,0,0,0,0,0,0,16,5,21,16,5,21,0,258,1,0,1,4.31707,0.390244,43.0488,82.8833,82,4
India,259,242.378,7.15058,0.339768,244.568,7.12741,0.30888,511,M Vijay,0,0,0,0,0,0,0,0,8,10,18,8,10,18,259,259,0,1,1,2.25,0.0625,21.1875,65.6977,16,1
India,259,242.378,7.15058,0.339768,244.568,7.12741,0.30888,511,G Gambhir,0,0,0,0,0,0,0,0,8,10,18,8,10,18,259,259,0,1,1,3.99145,0.333333,37.4701,84.1944,117,4
New Zealand,184,233.745,7.39674,0.36413,227.951,7.30435,0.353261,512,MJ Guptill,0,0,0,0,0,0,0,0,10,4,14,10,4,14,0,224,5,0,1,4.8087,0.313043,38.1217,82.7482,115,4
New Zealand,184,233.745,7.39674,0.36413,227.951,7.30435,0.353261,512,BB McCullum,0,0,0,0,0,0,0,0,10,4,14,10,4,14,0,224,5,0,1,3.98611,0.201389,29.9028,98.4004,144,0
New Zealand,184,233.745,7.39674,0.36413,227.951,7.30435,0.353261,512,KS Williamson,0,0,0,0,0,0,0,0,10,4,14,10,4,14,0,224,5,0,1,4.31707,0.390244,43.0488,82.8833,82,4
India,259,242.378,7.15058,0.339768,244.568,7.12741,0.30888,512,M Vijay,0,0,0,0,0,0,0,0,16,13,29,16,13,29,225,229,7,1,1,2.25,0.0625,21.1875,65.6977,16,1
India,259,242.378,7.15058,0.339768,244.568,7.12741,0.30888,512,G Gambhir,0,0,0,0,0,0,0,0,16,13,29,16,13,29,225,229,7,1,1,3.99145,0.333333,37.4701,84.1944,117,4
New Zealand,184,233.745,7.39674,0.36413,227.951,7.30435,0.353261,513,MJ Guptill,0,0,0,0,0,0,0,0,20,4,24,20,4,24,0,315,9,0,1,4.8087,0.313043,38.1217,82.7482,115,4
New Zealand,184,233.745,7.39674,0.36413,227.951,7.30435,0.353261,513,BB McCullum,0,0,0,0,0,0,0,0,20,4,24,20,4,24,0,315,9,0,1,3.98611,0.201389,29.9028,98.4004,144,0
India,259,242.378,7.15058,0.339768,244.568,7.12741,0.30888,513,G Gambhir,0,0,0,0,0,0,0,0,12,5,17,12,5,17,316,321,1,1,1,3.99145,0.333333,37.4701,84.1944,117,4
India,259,242.378,7.15058,0.339768,244.568,7.12741,0.30888,513,PA Patel,0,0,0,0,0,0,0,0,12,5,17,12,5,17,316,321,1,1,1,2.65217,0.130435,22.1304,79.4072,23,4
Pakistan,211,222.621,7.38389,0.393365,235.517,7.54976,0.336493,514,Kamran Akmal,0,0,0,0,0,0,0,0,4,6,10,4,6,10,0,124,1,0,1,3.01124,0.11236,23.0787,81.4433,89,4
Pakistan,211,222.621,7.38389,0.393365,235.517,7.54976,0.336493,514,Mohammad Hafeez,0,0,0,0,0,0,0,0,4,6,10,4,6,10,0,124,1,0,1,4.04511,0.255639,34.3534,78.0625,133,4
Pakistan,211,222.621,7.38389,0.393365,235.517,7.54976,0.336493,514,Younis Khan,0,0,0,0,0,0,0,0,4,6,10,4,6,10,0,124,1,0,1,2.64655,0.215517,28.5,73.2713,116,4
New Zealand,184,233.745,7.39674,0.36413,227.951,7.30435,0.353261,514,MJ Guptill,0,0,0,0,0,0,0,0,18,18,36,18,18,36,125,125,3,1,1,4.8087,0.313043,38.1217,82.7482,115,4
New Zealand,184,233.745,7.39674,0.36413,227.951,7.30435,0.353261,514,JD Ryder,0,0,0,0,0,0,0,0,18,18,36,18,18,36,125,125,3,1,1,4.88571,0.257143,34.4,97.2536,35,0
Pakistan,211,222.621,7.38389,0.393365,235.517,7.54976,0.336493,515,Mohammad Hafeez,0,0,0,0,0,0,0,0,4,9,13,4,9,13,0,293,0,0,1,4.04511,0.255639,34.3534,78.0625,133,4
Pakistan,211,222.621,7.38389,0.393365,235.517,7.54976,0.336493,515,Ahmed Shehzad,0,0,0,0,0,0,0,0,4,9,13,4,9,13,0,293,0,0,1,3.67143,0.242857,33.2714,70.8118,70,4
Pakistan,211,222.621,7.38389,0.393365,235.517,7.54976,0.336493,515,Kamran Akmal,0,0,0,0,0,0,0,0,4,9,13,4,9,13,0,293,0,0,1,3.01124,0.11236,23.0787,81.4433,89,4
Pakistan,211,222.621,7.38389,0.393365,235.517,7.54976,0.336493,515,Younis Khan,0,0,0,0,0,0,0,0,4,9,13,4,9,13,0,293,0,0,1,2.64655,0.215517,28.5,73.2713,116,4
New Zealand,184,233.745,7.39674,0.36413,227.951,7.30435,0.353261,515,MJ Guptill,0,0,0,0,0,0,0,0,20,6,26,20,6,26,294,250,0,1,1,4.8087,0.313043,38.1217,82.7482,115,4
New Zealand,184,233.745,7.39674,0.36413,227.951,7.30435,0.353261,515,JM How,0,0,0,0,0,0,0,0,20,6,26,20,6,26,294,250,0,1,1,3.34615,0.192308,29.9231,64.9416,26,4
New Zealand,184,233.745,7.39674,0.36413,227.951,7.30435,0.353261,516,MJ Guptill,0,0,0,0,0,0,0,0,16,4,20,16,4,20,0,262,5,1,1,4.8087,0.313043,38.1217,82.7482,115,4
New Zealand,184,233.745,7.39674,0.36413,227.951,7.30435,0.353261,516,JM How,0,0,0,0,0,0,0,0,16,4,20,16,4,20,0,262,5,1,1,3.34615,0.192308,29.9231,64.9416,26,4
Pakistan,211,222.621,7.38389,0.393365,235.517,7.54976,0.336493,516,Mohammad Hafeez,0,0,0,0,0,0,0,0,16,8,24,16,8,24,263,264,1,0,1,4.04511,0.255639,34.3534,78.0625,133,4
Pakistan,211,222.621,7.38389,0.393365,235.517,7.54976,0.336493,516,Ahmed Shehzad,0,0,0,0,0,0,0,0,16,8,24,16,8,24,263,264,1,0,1,3.67143,0.242857,33.2714,70.8118,70,4
Pakistan,211,222.621,7.38389,0.393365,235.517,7.54976,0.336493,517,Mohammad Hafeez,0,0,0,0,0,0,0,0,8,3,11,8,3,11,0,268,0,0,1,4.04511,0.255639,34.3534,78.0625,133,4
Pakistan,211,222.621,7.38389,0.393365,235.517,7.54976,0.336493,517,Ahmed Shehzad,0,0,0,0,0,0,0,0,8,3,11,8,3,11,0,268,0,0,1,3.67143,0.242857,33.2714,70.8118,70,4
New Zealand,184,233.745,7.39674,0.36413,227.951,7.30435,0.353261,517,MJ Guptill,0,0,0,0,0,0,0,0,8,6,14,8,6,14,269,227,5,1,1,4.8087,0.313043,38.1217,82.7482,115,4
New Zealand,184,233.745,7.39674,0.36413,227.951,7.30435,0.353261,517,JM How,0,0,0,0,0,0,0,0,8,6,14,8,6,14,269,227,5,1,1,3.34615,0.192308,29.9231,64.9416,26,4
New Zealand,184,233.745,7.39674,0.36413,227.951,7.30435,0.353261,518,MJ Guptill,0,0,0,0,0,0,0,0,14,5,19,14,5,19,0,311,6,1,1,4.8087,0.313043,38.1217,82.7482,115,4
New Zealand,184,233.745,7.39674,0.36413,227.951,7.30435,0.353261,518,BB McCullum,0,0,0,0,0,0,0,0,14,5,19,14,5,19,0,311,6,1,1,3.98611,0.201389,29.9028,98.4004,144,0
New Zealand,184,233.745,7.39674,0.36413,227.951,7.30435,0.353261,518,JD Ryder,0,0,0,0,0,0,0,0,14,5,19,14,5,19,0,311,6,1,1,4.88571,0.257143,34.4,97.2536,35,0
Pakistan,211,222.621,7.38389,0.393365,235.517,7.54976,0.336493,518,Mohammad Hafeez,0,0,0,0,0,0,0,0,18,9,27,18,9,27,312,254,1,0,1,4.04511,0.255639,34.3534,78.0625,133,4
Pakistan,211,222.621,7.38389,0.393365,235.517,7.54976,0.336493,518,Ahmed Shehzad,0,0,0,0,0,0,0,0,18,9,27,18,9,27,312,254,1,0,1,3.67143,0.242857,33.2714,70.8118,70,4
Pakistan,211,222.621,7.38389,0.393365,235.517,7.54976,0.336493,518,Kamran Akmal,0,0,0,0,0,0,0,0,18,9,27,18,9,27,312,254,1,0,1,3.01124,0.11236,23.0787,81.4433,89,4
England,221,237.176,7.17647,0.289593,230.633,7.45701,0.384615,519,AN Cook,0,0,0,0,0,0,0,0,16,10,26,16,10,26,0,229,3,1,1,4.17045,0.272727,35.75,75.5524,88,4
England,221,237.176,7.17647,0.289593,230.633,7.45701,0.384615,519,C Kieswetter,0,0,0,0,0,0,0,0,16,10,26,16,10,26,0,229,3,1,1,3.43243,0.135135,26.4324,88.0288,37,4
England,221,237.176,7.17647,0.289593,230.633,7.45701,0.384615,519,IJL Trott,0,0,0,0,0,0,0,0,16,10,26,16,10,26,0,229,3,1,1,3.3871,0.403226,43.7903,75.2494,62,4
Sri Lanka,244,223.373,7.09016,0.344262,227.578,7.47541,0.385246,519,TM Dilshan,0,0,0,0,0,0,0,0,4,9,13,4,9,13,230,121,2,0,1,4.60199,0.273632,38.3632,86.0219,201,4
Sri Lanka,244,223.373,7.09016,0.344262,227.578,7.47541,0.385246,519,ST Jayasuriya,0,0,0,0,0,0,0,0,4,9,13,4,9,13,230,121,2,0,1,4.91549,0.211268,33.9859,98.4898,71,0
Sri Lanka,244,223.373,7.09016,0.344262,227.578,7.47541,0.385246,519,DPMD Jayawardene,0,0,0,0,0,0,0,0,4,9,13,4,9,13,230,121,2,0,1,3.20833,0.244792,31.6979,79.1109,192,4
Sri Lanka,244,223.373,7.09016,0.344262,227.578,7.47541,0.385246,519,KC Sangakkara,0,0,0,0,0,0,0,0,4,9,13,4,9,13,230,121,2,0,1,4.33659,0.360976,41.9854,80.6276,205,4
Sri Lanka,244,223.373,7.09016,0.344262,227.578,7.47541,0.385246,519,SHT Kandamby,0,0,0,0,0,0,0,0,4,9,13,4,9,13,230,121,2,0,1,2.23333,0.166667,27.1667,69.5392,30,4
Sri Lanka,244,223.373,7.09016,0.344262,227.578,7.47541,0.385246,519,AD Mathews,0,0,0,0,0,0,0,0,4,9,13,4,9,13,230,121,2,0,1,2.64122,0.198473,28.6794,82.3362,131,4
Sri Lanka,244,223.373,7.09016,0.344262,227.578,7.47541,0.385246,520,DPMD Jayawardene,0,0,0,0,0,0,0,0,8,8,16,8,8,16,0,309,0,0,1,3.20833,0.244792,31.6979,79.1109,192,4
Sri Lanka,244,223.373,7.09016,0.344262,227.578,7.47541,0.385246,520,TM Dilshan,0,0,0,0,0,0,0,0,8,8,16,8,8,16,0,309,0,0,1,4.60199,0.273632,38.3632,86.0219,201,4
England,221,237.176,7.17647,0.289593,230.633,7.45701,0.384615,520,AN Cook,0,0,0,0,0,0,0,0,22,12,34,22,12,34,310,240,2,1,1,4.17045,0.272727,35.75,75.5524,88,4
England,221,237.176,7.17647,0.289593,230.633,7.45701,0.384615,520,C Kieswetter,0,0,0,0,0,0,0,0,22,12,34,22,12,34,310,240,2,1,1,3.43243,0.135135,26.4324,88.0288,37,4
England,221,237.176,7.17647,0.289593,230.633,7.45701,0.384615,521,AN Cook,0,0,0,0,0,0,0,0,12,5,17,12,5,17,0,246,0,1,1,4.17045,0.272727,35.75,75.5524,88,4
England,221,237.176,7.17647,0.289593,230.633,7.45701,0.384615,521,C Kieswetter,0,0,0,0,0,0,0,0,12,5,17,12,5,17,0,246,0,1,1,3.43243,0.135135,26.4324,88.0288,37,4
Sri Lanka,244,223.373,7.09016,0.344262,227.578,7.47541,0.385246,521,DPMD Jayawardene,0,0,0,0,0,0,0,0,20,9,29,20,9,29,247,249,1,0,1,3.20833,0.244792,31.6979,79.1109,192,4
Sri Lanka,244,223.373,7.09016,0.344262,227.578,7.47541,0.385246,521,TM Dilshan,0,0,0,0,0,0,0,0,20,9,29,20,9,29,247,249,1,0,1,4.60199,0.273632,38.3632,86.0219,201,4
Sri Lanka,244,223.373,7.09016,0.344262,227.578,7.47541,0.385246,521,LD Chandimal,0,0,0,0,0,0,0,0,20,9,29,20,9,29,247,249,1,0,1,2.18478,0.184783,25.7391,73.8615,92,4
Sri Lanka,244,223.373,7.09016,0.344262,227.578,7.47541,0.385246,522,DPMD Jayawardene,0,0,0,0,0,0,0,0,4,5,9,4,5,9,0,174,2,0,1,3.20833,0.244792,31.6979,79.1109,192,4
Sri Lanka,244,223.373,7.09016,0.344262,227.578,7.47541,0.385246,522,TM Dilshan,0,0,0,0,0,0,0,0,4,5,9,4,5,9,0,174,2,0,1,4.60199,0.273632,38.3632,86.0219,201,4
Sri Lanka,244,223.373,7.09016,0.344262,227.578,7.47541,0.385246,522,LD Chandimal,0,0,0,0,0,0,0,0,4,5,9,4,5,9,0,174,2,0,1,2.18478,0.184783,25.7391,73.8615,92,4
Sri Lanka,244,223.373,7.09016,0.344262,227.578,7.47541,0.385246,522,KC Sangakkara,0,0,0,0,0,0,0,0,4,5,9,4,5,9,0,174,2,0,1,4.33659,0.360976,41.9854,80.6276,205,4
Sri Lanka,244,223.373,7.09016,0.344262,227.578,7.47541,0.385246,522,SHT Kandamby,0,0,0,0,0,0,0,0,4,5,9,4,5,9,0,174,2,0,1,2.23333,0.166667,27.1667,69.5392,30,4
England,221,237.176,7.17647,0.289593,230.633,7.45701,0.384615,522,AN Cook,0,0,0,0,0,0,0,0,32,5,37,32,5,37,175,171,0,1,1,4.17045,0.272727,35.75,75.5524,88,4
England,221,237.176,7.17647,0.289593,230.633,7.45701,0.384615,522,C Kieswetter,0,0,0,0,0,0,0,0,32,5,37,32,5,37,175,171,0,1,1,3.43243,0.135135,26.4324,88.0288,37,4
India,259,242.378,7.15058,0.339768,244.568,7.12741,0.30888,523,PA Patel,0,0,0,0,0,0,0,0,28,7,35,28,7,35,0,187,1,0,1,2.65217,0.130435,22.1304,79.4072,23,4
India,259,242.378,7.15058,0.339768,244.568,7.12741,0.30888,523,AM Rahane,0,0,0,0,0,0,0,0,28,7,35,28,7,35,0,187,1,0,1,3.55738,0.262295,32.2295,78.0159,61,4
India,259,242.378,7.15058,0.339768,244.568,7.12741,0.30888,523,R Dravid,0,0,0,0,0,0,0,0,28,7,35,28,7,35,0,187,1,0,1,2.83721,0.255814,29.8605,72.7067,43,4
England,221,237.176,7.17647,0.289593,230.633,7.45701,0.384615,523,AN Cook,0,0,0,0,0,0,0,0,38,16,54,38,16,54,188,188,2,1,1,4.17045,0.272727,35.75,75.5524,88,4
England,221,237.176,7.17647,0.289593,230.633,7.45701,0.384615,523,C Kieswetter,0,0,0,0,0,0,0,0,38,16,54,38,16,54,188,188,2,1,1,3.43243,0.135135,26.4324,88.0288,37,4
India,259,242.378,7.15058,0.339768,244.568,7.12741,0.30888,524,PA Patel,0,0,0,0,0,0,0,0,0,5,5,0,5,5,0,234,4,0,1,2.65217,0.130435,22.1304,79.4072,23,4
India,259,242.378,7.15058,0.339768,244.568,7.12741,0.30888,524,AM Rahane,0,0,0,0,0,0,0,0,0,5,5,0,5,5,0,234,4,0,1,3.55738,0.262295,32.2295,78.0159,61,4
India,259,242.378,7.15058,0.339768,244.568,7.12741,0.30888,524,R Dravid,0,0,0,0,0,0,0,0,0,5,5,0,5,5,0,234,4,0,1,2.83721,0.255814,29.8605,72.7067,43,4
England,221,237.176,7.17647,0.289593,230.633,7.45701,0.384615,524,AN Cook,0,0,0,0,0,0,0,0,14,8,22,14,8,22,235,218,2,1,1,4.17045,0.272727,35.75,75.5524,88,4
England,221,237.176,7.17647,0.289593,230.633,7.45701,0.384615,524,C Kieswetter,0,0,0,0,0,0,0,0,14,8,22,14,8,22,235,218,2,1,1,3.43243,0.135135,26.4324,88.0288,37,4
India,259,242.378,7.15058,0.339768,244.568,7.12741,0.30888,525,PA Patel,0,0,0,0,0,0,0,0,0,5,5,0,5,5,0,280,4,0,1,2.65217,0.130435,22.1304,79.4072,23,4
India,259,242.378,7.15058,0.339768,244.568,7.12741,0.30888,525,AM Rahane,0,0,0,0,0,0,0,0,0,5,5,0,5,5,0,280,4,0,1,3.55738,0.262295,32.2295,78.0159,61,4
England,221,237.176,7.17647,0.289593,230.633,7.45701,0.384615,525,AN Cook,0,0,0,0,0,0,0,0,12,13,25,12,13,25,281,270,2,1,1,4.17045,0.272727,35.75,75.5524,88,4
England,221,237.176,7.17647,0.289593,230.633,7.45701,0.384615,525,C Kieswetter,0,0,0,0,0,0,0,0,12,13,25,12,13,25,281,270,2,1,1,3.43243,0.135135,26.4324,88.0288,37,4
England,221,237.176,7.17647,0.289593,230.633,7.45701,0.384615,525,IJL Trott,0,0,0,0,0,0,0,0,12,13,25,12,13,25,281,270,2,1,1,3.3871,0.403226,43.7903,75.2494,62,4
India,259,242.378,7.15058,0.339768,244.568,7.12741,0.30888,526,PA Patel,0,0,0,0,0,0,0,0,0,12,12,0,12,12,0,304,7,0,1,2.65217,0.130435,22.1304,79.4072,23,4
India,259,242.378,7.15058,0.339768,244.568,7.12741,0.30888,526,AM Rahane,0,0,0,0,0,0,0,0,0,12,12,0,12,12,0,304,7,0,1,3.55738,0.262295,32.2295,78.0159,61,4
England,221,237.176,7.17647,0.289593,230.633,7.45701,0.384615,526,AN Cook,0,0,0,0,0,0,0,0,20,9,29,20,9,29,305,241,0,1,1,4.17045,0.272727,35.75,75.5524,88,4
England,221,237.176,7.17647,0.289593,230.633,7.45701,0.384615,526,C Kieswetter,0,0,0,0,0,0,0,0,20,9,29,20,9,29,305,241,0,1,1,3.43243,0.135135,26.4324,88.0288,37,4
England,221,237.176,7.17647,0.289593,230.633,7.45701,0.384615,526,IJL Trott,0,0,0,0,0,0,0,0,20,9,29,20,9,29,305,241,0,1,1,3.3871,0.403226,43.7903,75.2494,62,4
Bangladesh,160,218.438,7.70625,0.4,211.106,7.05,0.325,527,Imrul Kayes,0,0,0,0,0,0,0,0,16,3,19,16,3,19,0,228,0,1,1,3,0.207547,26.2642,63.6488,53,4
Bangladesh,160,218.438,7.70625,0.4,211.106,7.05,0.325,527,Shahriar Nafees,0,0,0,0,0,0,0,0,16,3,19,16,3,19,0,228,0,1,1,3.40541,0.162162,24.4865,69.1076,37,4
New Zealand,184,233.745,7.39674,0.36413,227.951,7.30435,0.353261,527,BB McCullum,0,0,0,0,0,0,0,0,24,15,39,24,15,39,229,200,0,0,1,3.98611,0.201389,29.9028,98.4004,144,0
New Zealand,184,233.745,7.39674,0.36413,227.951,7.30435,0.353261,527,JD Ryder,0,0,0,0,0,0,0,0,24,15,39,24,15,39,229,200,0,0,1,4.88571,0.257143,34.4,97.2536,35,0
New Zealand,184,233.745,7.39674,0.36413,227.951,7.30435,0.353261,528,BB McCullum,0,0,0,0,0,0,0,0,14,9,23,14,9,23,0,173,2,0,1,3.98611,0.201389,29.9028,98.4004,144,0
New Zealand,184,233.745,7.39674,0.36413,227.951,7.30435,0.353261,528,BJ Watling,0,0,0,0,0,0,0,0,14,9,23,14,9,23,0,173,2,0,1,3,0.263158,27.7895,66.9202,19,4
New Zealand,184,233.745,7.39674,0.36413,227.951,7.30435,0.353261,528,JD Ryder,0,0,0,0,0,0,0,0,14,9,23,14,9,23,0,173,2,0,1,4.88571,0.257143,34.4,97.2536,35,0
Bangladesh,160,218.438,7.70625,0.4,211.106,7.05,0.325,528,Imrul Kayes,0,0,0,0,0,0,0,0,20,14,34,20,14,34,174,177,1,1,1,3,0.207547,26.2642,63.6488,53,4
Bangladesh,160,218.438,7.70625,0.4,211.106,7.05,0.325,528,Shahriar Nafees,0,0,0,0,0,0,0,0,20,14,34,20,14,34,174,177,1,1,1,3.40541,0.162162,24.4865,69.1076,37,4
Bangladesh,160,218.438,7.70625,0.4,211.106,7.05,0.325,529,Imrul Kayes,0,0,0,0,0,0,0,0,16,9,25,16,9,25,0,241,2,1,1,3,0.207547,26.2642,63.6488,53,4
Bangladesh,160,218.438,7.70625,0.4,211.106,7.05,0.325,529,Shahriar Nafees,0,0,0,0,0,0,0,0,16,9,25,16,9,25,0,241,2,1,1,3.40541,0.162162,24.4865,69.1076,37,4
Bangladesh,160,218.438,7.70625,0.4,211.106,7.05,0.325,529,Junaid Siddique,0,0,0,0,0,0,0,0,16,9,25,16,9,25,0,241,2,1,1,2.16279,0.116279,20.0233,68.225,43,1
Bangladesh,160,218.438,7.70625,0.4,211.106,7.05,0.325,529,Raqibul Hasan,0,0,0,0,0,0,0,0,16,9,25,16,9,25,0,241,2,1,1,1.85106,0.12766,23.2766,59.2312,47,1
New Zealand,184,233.745,7.39674,0.36413,227.951,7.30435,0.353261,529,BB McCullum,0,0,0,0,0,0,0,0,4,19,23,4,19,23,242,232,0,0,1,3.98611,0.201389,29.9028,98.4004,144,0
New Zealand,184,233.745,7.39674,0.36413,227.951,7.30435,0.353261,529,BJ Watling,0,0,0,0,0,0,0,0,4,19,23,4,19,23,242,232,0,0,1,3,0.263158,27.7895,66.9202,19,4
New Zealand,184,233.745,7.39674,0.36413,227.951,7.30435,0.353261,529,AJ Redmond,0,0,0,0,0,0,0,0,4,19,23,4,19,23,242,232,0,0,1,3.16667,0.166667,25.3333,57.1429,6,3
Bangladesh,160,218.438,7.70625,0.4,211.106,7.05,0.325,530,Imrul Kayes,0,0,0,0,0,0,0,0,14,7,21,14,7,21,0,174,2,1,1,3,0.207547,26.2642,63.6488,53,4
Bangladesh,160,218.438,7.70625,0.4,211.106,7.05,0.325,530,Shahriar Nafees,0,0,0,0,0,0,0,0,14,7,21,14,7,21,0,174,2,1,1,3.40541,0.162162,24.4865,69.1076,37,4
Bangladesh,160,218.438,7.70625,0.4,211.106,7.05,0.325,530,Junaid Siddique,0,0,0,0,0,0,0,0,14,7,21,14,7,21,0,174,2,1,1,2.16279,0.116279,20.0233,68.225,43,1
New Zealand,184,233.745,7.39674,0.36413,227.951,7.30435,0.353261,530,BB McCullum,0,0,0,0,0,0,0,0,0,11,11,0,11,11,175,171,4,0,1,3.98611,0.201389,29.9028,98.4004,144,0
New Zealand,184,233.745,7.39674,0.36413,227.951,7.30435,0.353261,530,JD Ryder,0,0,0,0,0,0,0,0,0,11,11,0,11,11,175,171,4,0,1,4.88571,0.257143,34.4,97.2536,35,0
New Zealand,184,233.745,7.39674,0.36413,227.951,7.30435,0.353261,530,BJ Watling,0,0,0,0,0,0,0,0,0,11,11,0,11,11,175,171,4,0,1,3,0.263158,27.7895,66.9202,19,4
New Zealand,184,233.745,7.39674,0.36413,227.951,7.30435,0.353261,530,LRPL Taylor,0,0,0,0,0,0,0,0,0,11,11,0,11,11,175,171,4,0,1,3.68382,0.301471,36.7206,79.3959,136,4
New Zealand,184,233.745,7.39674,0.36413,227.951,7.30435,0.353261,530,KS Williamson,0,0,0,0,0,0,0,0,0,11,11,0,11,11,175,171,4,0,1,4.31707,0.390244,43.0488,82.8833,82,4
England,221,237.176,7.17647,0.289593,230.633,7.45701,0.384615,531,IJL Trott,0,0,0,0,0,0,0,0,4,7,11,4,7,11,0,201,1,0,1,3.3871,0.403226,43.7903,75.2494,62,4
England,221,237.176,7.17647,0.289593,230.633,7.45701,0.384615,531,C Kieswetter,0,0,0,0,0,0,0,0,4,7,11,4,7,11,0,201,1,0,1,3.43243,0.135135,26.4324,88.0288,37,4
Ireland,55,219.527,7.65455,0.290909,202.727,7.56364,0.4,531,EC Joyce,0,0,0,0,0,0,0,0,14,1,15,14,1,15,202,117,2,1,1,3.08571,0.2,28.3429,68.6505,35,4
Ireland,55,219.527,7.65455,0.290909,202.727,7.56364,0.4,531,PR Stirling,0,0,0,0,0,0,0,0,14,1,15,14,1,15,202,117,2,1,1,3.47826,0.173913,24.2174,88.1329,23,0
Ireland,55,219.527,7.65455,0.290909,202.727,7.56364,0.4,531,WTS Porterfield,0,0,0,0,0,0,0,0,14,1,15,14,1,15,202,117,2,1,1,2.6,0.142857,24.6857,56.2866,35,3
Zimbabwe,142,212.077,7.5,0.380282,227.704,6.97887,0.316901,532,BRM Taylor,0,0,0,0,0,0,0,0,12,8,20,12,8,20,0,191,5,0,1,3.3,0.26,33.56,76.3421,100,4
Zimbabwe,142,212.077,7.5,0.380282,227.704,6.97887,0.316901,532,CJ Chibhabha,0,0,0,0,0,0,0,0,12,8,20,12,8,20,0,191,5,0,1,2.56716,0.149254,23.5373,64.7373,67,1
Zimbabwe,142,212.077,7.5,0.380282,227.704,6.97887,0.316901,532,RW Chakabva,0,0,0,0,0,0,0,0,12,8,20,12,8,20,0,191,5,0,1,0.846154,0,13.2692,51.3393,26,3
Bangladesh,160,218.438,7.70625,0.4,211.106,7.05,0.325,532,Tamim Iqbal,0,0,0,0,0,0,0,0,14,9,23,14,9,23,192,194,3,1,1,4.05344,0.274809,31.8015,76.8068,131,4
Bangladesh,160,218.438,7.70625,0.4,211.106,7.05,0.325,532,Imrul Kayes,0,0,0,0,0,0,0,0,14,9,23,14,9,23,192,194,3,1,1,3,0.207547,26.2642,63.6488,53,4
Bangladesh,160,218.438,7.70625,0.4,211.106,7.05,0.325,533,Tamim Iqbal,0,0,0,0,0,0,0,0,8,3,11,8,3,11,0,246,4,1,1,4.05344,0.274809,31.8015,76.8068,131,4
Bangladesh,160,218.438,7.70625,0.4,211.106,7.05,0.325,533,Imrul Kayes,0,0,0,0,0,0,0,0,8,3,11,8,3,11,0,246,4,1,1,3,0.207547,26.2642,63.6488,53,4
Bangladesh,160,218.438,7.70625,0.4,211.106,7.05,0.325,533,Junaid Siddique,0,0,0,0,0,0,0,0,8,3,11,8,3,11,0,246,4,1,1,2.16279,0.116279,20.0233,68.225,43,1
Bangladesh,160,218.438,7.70625,0.4,211.106,7.05,0.325,533,Raqibul Hasan,0,0,0,0,0,0,0,0,8,3,11,8,3,11,0,246,4,1,1,1.85106,0.12766,23.2766,59.2312,47,1
Zimbabwe,142,212.077,7.5,0.380282,227.704,6.97887,0.316901,533,BRM Taylor,0,0,0,0,0,0,0,0,4,15,19,4,15,19,247,181,0,0,1,3.3,0.26,33.56,76.3421,100,4
Zimbabwe,142,212.077,7.5,0.380282,227.704,6.97887,0.316901,533,CJ Chibhabha,0,0,0,0,0,0,0,0,4,15,19,4,15,19,247,181,0,0,1,2.56716,0.149254,23.5373,64.7373,67,1
Zimbabwe,142,212.077,7.5,0.380282,227.704,6.97887,0.316901,533,H Masakadza,0,0,0,0,0,0,0,0,4,15,19,4,15,19,247,181,0,0,1,3.11215,0.186916,26.972,70.0485,107,4
Zimbabwe,142,212.077,7.5,0.380282,227.704,6.97887,0.316901,534,BRM Taylor,0,0,0,0,0,0,0,0,0,9,9,0,9,9,0,188,1,0,1,3.3,0.26,33.56,76.3421,100,4
Zimbabwe,142,212.077,7.5,0.380282,227.704,6.97887,0.316901,534,KM Dabengwa,0,0,0,0,0,0,0,0,0,9,9,0,9,9,0,188,1,0,1,1.2,0,16.7,61.1722,20,1
Zimbabwe,142,212.077,7.5,0.380282,227.704,6.97887,0.316901,534,H Masakadza,0,0,0,0,0,0,0,0,0,9,9,0,9,9,0,188,1,0,1,3.11215,0.186916,26.972,70.0485,107,4
Bangladesh,160,218.438,7.70625,0.4,211.106,7.05,0.325,534,Tamim Iqbal,0,0,0,0,0,0,0,0,0,10,10,0,10,10,189,189,6,1,1,4.05344,0.274809,31.8015,76.8068,131,4
Bangladesh,160,218.438,7.70625,0.4,211.106,7.05,0.325,534,Imrul Kayes,0,0,0,0,0,0,0,0,0,10,10,0,10,10,189,189,6,1,1,3,0.207547,26.2642,63.6488,53,4
Bangladesh,160,218.438,7.70625,0.4,211.106,7.05,0.325,534,Junaid Siddique,0,0,0,0,0,0,0,0,0,10,10,0,10,10,189,189,6,1,1,2.16279,0.116279,20.0233,68.225,43,1
West Indies,176,217.33,7.15909,0.3125,225.278,7.57386,0.380682,535,LMP Simmons,0,0,0,0,0,0,0,0,12,7,19,12,7,19,0,221,6,1,1,3.3125,0.28125,30.5938,71.4338,64,4
West Indies,176,217.33,7.15909,0.3125,225.278,7.57386,0.380682,535,DS Smith,0,0,0,0,0,0,0,0,12,7,19,12,7,19,0,221,6,1,1,2.61765,0.147059,23.5588,71.2,34,4
Pakistan,211,222.621,7.38389,0.393365,235.517,7.54976,0.336493,535,Mohammad Hafeez,0,0,0,0,0,0,0,0,28,7,35,28,7,35,222,222,0,0,1,4.04511,0.255639,34.3534,78.0625,133,4
Pakistan,211,222.621,7.38389,0.393365,235.517,7.54976,0.336493,535,Ahmed Shehzad,0,0,0,0,0,0,0,0,28,7,35,28,7,35,222,222,0,0,1,3.67143,0.242857,33.2714,70.8118,70,4
West Indies,176,217.33,7.15909,0.3125,225.278,7.57386,0.380682,536,LMP Simmons,0,0,0,0,0,0,0,0,10,9,19,10,9,19,0,220,4,1,1,3.3125,0.28125,30.5938,71.4338,64,4
West Indies,176,217.33,7.15909,0.3125,225.278,7.57386,0.380682,536,DS Smith,0,0,0,0,0,0,0,0,10,9,19,10,9,19,0,220,4,1,1,2.61765,0.147059,23.5588,71.2,34,4
Pakistan,211,222.621,7.38389,0.393365,235.517,7.54976,0.336493,536,Mohammad Hafeez,0,0,0,0,0,0,0,0,12,9,21,12,9,21,221,223,0,0,1,4.04511,0.255639,34.3534,78.0625,133,4
Pakistan,211,222.621,7.38389,0.393365,235.517,7.54976,0.336493,536,Ahmed Shehzad,0,0,0,0,0,0,0,0,12,9,21,12,9,21,221,223,0,0,1,3.67143,0.242857,33.2714,70.8118,70,4
West Indies,176,217.33,7.15909,0.3125,225.278,7.57386,0.380682,537,LMP Simmons,0,0,0,0,0,0,0,0,4,5,9,4,5,9,0,171,6,1,1,3.3125,0.28125,30.5938,71.4338,64,4
West Indies,176,217.33,7.15909,0.3125,225.278,7.57386,0.380682,537,DS Smith,0,0,0,0,0,0,0,0,4,5,9,4,5,9,0,171,6,1,1,2.61765,0.147059,23.5588,71.2,34,4
West Indies,176,217.33,7.15909,0.3125,225.278,7.57386,0.380682,537,DM Bravo,0,0,0,0,0,0,0,0,4,5,9,4,5,9,0,171,6,1,1,3,0.226667,28.52,67.4551,75,4
Pakistan,211,222.621,7.38389,0.393365,235.517,7.54976,0.336493,537,Mohammad Hafeez,0,0,0,0,0,0,0,0,8,6,14,8,6,14,172,177,5,0,1,4.04511,0.255639,34.3534,78.0625,133,4
Pakistan,211,222.621,7.38389,0.393365,235.517,7.54976,0.336493,537,Ahmed Shehzad,0,0,0,0,0,0,0,0,8,6,14,8,6,14,172,177,5,0,1,3.67143,0.242857,33.2714,70.8118,70,4
Pakistan,211,222.621,7.38389,0.393365,235.517,7.54976,0.336493,537,Asad Shafiq,0,0,0,0,0,0,0,0,8,6,14,8,6,14,172,177,5,0,1,2.07843,0.176471,24.7843,67.1269,51,4
Pakistan,211,222.621,7.38389,0.393365,235.517,7.54976,0.336493,537,Misbah-ul-Haq,0,0,0,0,0,0,0,0,8,6,14,8,6,14,172,177,5,0,1,2.95238,0.285714,34.9921,71.8195,126,4
Pakistan,211,222.621,7.38389,0.393365,235.517,7.54976,0.336493,537,Umar Akmal,0,0,0,0,0,0,0,0,8,6,14,8,6,14,172,177,5,0,1,2.76842,0.2,27.5053,82.7947,95,4
Pakistan,211,222.621,7.38389,0.393365,235.517,7.54976,0.336493,538,Mohammad Hafeez,0,0,0,0,0,0,0,0,8,8,16,8,8,16,0,248,0,0,1,4.04511,0.255639,34.3534,78.0625,133,4
Pakistan,211,222.621,7.38389,0.393365,235.517,7.54976,0.336493,538,Ahmed Shehzad,0,0,0,0,0,0,0,0,8,8,16,8,8,16,0,248,0,0,1,3.67143,0.242857,33.2714,70.8118,70,4
Pakistan,211,222.621,7.38389,0.393365,235.517,7.54976,0.336493,538,Asad Shafiq,0,0,0,0,0,0,0,0,8,8,16,8,8,16,0,248,0,0,1,2.07843,0.176471,24.7843,67.1269,51,4
West Indies,176,217.33,7.15909,0.3125,225.278,7.57386,0.380682,538,LMP Simmons,0,0,0,0,0,0,0,0,8,11,19,8,11,19,249,154,1,1,1,3.3125,0.28125,30.5938,71.4338,64,4
West Indies,176,217.33,7.15909,0.3125,225.278,7.57386,0.380682,538,KA Edwards,0,0,0,0,0,0,0,0,8,11,19,8,11,19,249,154,1,1,1,1.875,0.0625,20.6875,64.902,16,1
West Indies,176,217.33,7.15909,0.3125,225.278,7.57386,0.380682,538,DM Bravo,0,0,0,0,0,0,0,0,8,11,19,8,11,19,249,154,1,1,1,3,0.226667,28.52,67.4551,75,4
Pakistan,211,222.621,7.38389,0.393365,235.517,7.54976,0.336493,539,Mohammad Hafeez,0,0,0,0,0,0,0,0,8,9,17,8,9,17,0,139,1,0,1,4.04511,0.255639,34.3534,78.0625,133,4
Pakistan,211,222.621,7.38389,0.393365,235.517,7.54976,0.336493,539,Ahmed Shehzad,0,0,0,0,0,0,0,0,8,9,17,8,9,17,0,139,1,0,1,3.67143,0.242857,33.2714,70.8118,70,4
West Indies,176,217.33,7.15909,0.3125,225.278,7.57386,0.380682,539,LMP Simmons,0,0,0,0,0,0,0,0,8,9,17,8,9,17,140,140,9,1,1,3.3125,0.28125,30.5938,71.4338,64,4
West Indies,176,217.33,7.15909,0.3125,225.278,7.57386,0.380682,539,KA Edwards,0,0,0,0,0,0,0,0,8,9,17,8,9,17,140,140,9,1,1,1.875,0.0625,20.6875,64.902,16,1
West Indies,176,217.33,7.15909,0.3125,225.278,7.57386,0.380682,540,LMP Simmons,0,0,0,0,0,0,0,0,8,5,13,8,5,13,0,214,8,1,1,3.3125,0.28125,30.5938,71.4338,64,4
West Indies,176,217.33,7.15909,0.3125,225.278,7.57386,0.380682,540,KA Edwards,0,0,0,0,0,0,0,0,8,5,13,8,5,13,0,214,8,1,1,1.875,0.0625,20.6875,64.902,16,1
India,259,242.378,7.15058,0.339768,244.568,7.12741,0.30888,540,PA Patel,0,0,0,0,0,0,0,0,16,10,26,16,10,26,215,217,3,0,1,2.65217,0.130435,22.1304,79.4072,23,4
India,259,242.378,7.15058,0.339768,244.568,7.12741,0.30888,540,S Dhawan,0,0,0,0,0,0,0,0,16,10,26,16,10,26,215,217,3,0,1,5.65217,0.362319,43.2174,88.9088,69,4
West Indies,176,217.33,7.15909,0.3125,225.278,7.57386,0.380682,541,LMP Simmons,0,0,0,0,0,0,0,0,4,5,9,4,5,9,0,225,1,1,1,3.3125,0.28125,30.5938,71.4338,64,4
West Indies,176,217.33,7.15909,0.3125,225.278,7.57386,0.380682,541,KA Edwards,0,0,0,0,0,0,0,0,4,5,9,4,5,9,0,225,1,1,1,1.875,0.0625,20.6875,64.902,16,1
West Indies,176,217.33,7.15909,0.3125,225.278,7.57386,0.380682,541,RR Sarwan,0,0,0,0,0,0,0,0,4,5,9,4,5,9,0,225,1,1,1,2.8254,0.222222,29.1429,69.1005,63,4
India,259,242.378,7.15058,0.339768,244.568,7.12741,0.30888,541,PA Patel,0,0,0,0,0,0,0,0,0,13,13,0,13,13,226,228,2,0,1,2.65217,0.130435,22.1304,79.4072,23,4
India,259,242.378,7.15058,0.339768,244.568,7.12741,0.30888,541,S Dhawan,0,0,0,0,0,0,0,0,0,13,13,0,13,13,226,228,2,0,1,5.65217,0.362319,43.2174,88.9088,69,4
West Indies,176,217.33,7.15909,0.3125,225.278,7.57386,0.380682,542,LMP Simmons,0,0,0,0,0,0,0,0,4,5,9,4,5,9,0,249,3,1,1,3.3125,0.28125,30.5938,71.4338,64,4
West Indies,176,217.33,7.15909,0.3125,225.278,7.57386,0.380682,542,DP Hyatt,0,0,0,0,0,0,0,0,4,5,9,4,5,9,0,249,3,1,1,1.55556,0,12.4444,59.2593,9,3
West Indies,176,217.33,7.15909,0.3125,225.278,7.57386,0.380682,542,RR Sarwan,0,0,0,0,0,0,0,0,4,5,9,4,5,9,0,249,3,1,1,2.8254,0.222222,29.1429,69.1005,63,4
West Indies,176,217.33,7.15909,0.3125,225.278,7.57386,0.380682,542,DM Bravo,0,0,0,0,0,0,0,0,4,5,9,4,5,9,0,249,3,1,1,3,0.226667,28.52,67.4551,75,4
India,259,242.378,7.15058,0.339768,244.568,7.12741,0.30888,542,PA Patel,0,0,0,0,0,0,0,0,8,11,19,8,11,19,250,146,0,0,1,2.65217,0.130435,22.1304,79.4072,23,4
India,259,242.378,7.15058,0.339768,244.568,7.12741,0.30888,542,MK Tiwary,0,0,0,0,0,0,0,0,8,11,19,8,11,19,250,146,0,0,1,2.7,0.2,28.2,72.3077,10,4
India,259,242.378,7.15058,0.339768,244.568,7.12741,0.30888,543,S Dhawan,0,0,0,0,0,0,0,0,4,11,15,4,11,15,0,251,2,0,1,5.65217,0.362319,43.2174,88.9088,69,4
India,259,242.378,7.15058,0.339768,244.568,7.12741,0.30888,543,PA Patel,0,0,0,0,0,0,0,0,4,11,15,4,11,15,0,251,2,0,1,2.65217,0.130435,22.1304,79.4072,23,4
India,259,242.378,7.15058,0.339768,244.568,7.12741,0.30888,543,V Kohli,0,0,0,0,0,0,0,0,4,11,15,4,11,15,0,251,2,0,1,4.66456,0.379747,44.9937,88.3325,158,4
West Indies,176,217.33,7.15909,0.3125,225.278,7.57386,0.380682,543,LMP Simmons,0,0,0,0,0,0,0,0,0,9,9,0,9,9,252,255,3,1,1,3.3125,0.28125,30.5938,71.4338,64,4
West Indies,176,217.33,7.15909,0.3125,225.278,7.57386,0.380682,543,AB Barath,0,0,0,0,0,0,0,0,0,9,9,0,9,9,252,255,3,1,1,2.76923,0.0769231,21.6154,56.4257,13,3
West Indies,176,217.33,7.15909,0.3125,225.278,7.57386,0.380682,543,RR Sarwan,0,0,0,0,0,0,0,0,0,9,9,0,9,9,252,255,3,1,1,2.8254,0.222222,29.1429,69.1005,63,4
Australia,228,239.627,7.69737,0.372807,232.079,7.23246,0.337719,544,SR Watson,0,0,0,0,0,0,0,0,12,12,24,12,12,24,0,270,0,0,1,4.71318,0.286822,37.7907,90.0943,129,4
Australia,228,239.627,7.69737,0.372807,232.079,7.23246,0.337719,544,BJ Haddin,0,0,0,0,0,0,0,0,12,12,24,12,12,24,0,270,0,0,1,3.14737,0.147368,26.7789,81.382,95,4
Australia,228,239.627,7.69737,0.372807,232.079,7.23246,0.337719,544,RT Ponting,0,0,0,0,0,0,0,0,12,12,24,12,12,24,0,270,0,0,1,4.17431,0.33945,38.1009,80.8606,109,4
Bangladesh,160,218.438,7.70625,0.4,211.106,7.05,0.325,544,Tamim Iqbal,0,0,0,0,0,0,0,0,8,6,14,8,6,14,271,210,1,1,1,4.05344,0.274809,31.8015,76.8068,131,4
Bangladesh,160,218.438,7.70625,0.4,211.106,7.05,0.325,544,Imrul Kayes,0,0,0,0,0,0,0,0,8,6,14,8,6,14,271,210,1,1,1,3,0.207547,26.2642,63.6488,53,4
Bangladesh,160,218.438,7.70625,0.4,211.106,7.05,0.325,544,Shahriar Nafees,0,0,0,0,0,0,0,0,8,6,14,8,6,14,271,210,1,1,1,3.40541,0.162162,24.4865,69.1076,37,4
Bangladesh,160,218.438,7.70625,0.4,211.106,7.05,0.325,544,Raqibul Hasan,0,0,0,0,0,0,0,0,8,6,14,8,6,14,271,210,1,1,1,1.85106,0.12766,23.2766,59.2312,47,1
Bangladesh,160,218.438,7.70625,0.4,211.106,7.05,0.325,545,Tamim Iqbal,0,0,0,0,0,0,0,0,8,5,13,8,5,13,0,229,4,1,1,4.05344,0.274809,31.8015,76.8068,131,4
Bangladesh,160,218.438,7.70625,0.4,211.106,7.05,0.325,545,Imrul Kayes,0,0,0,0,0,0,0,0,8,5,13,8,5,13,0,229,4,1,1,3,0.207547,26.2642,63.6488,53,4
Bangladesh,160,218.438,7.70625,0.4,211.106,7.05,0.325,545,Shahriar Nafees,0,0,0,0,0,0,0,0,8,5,13,8,5,13,0,229,4,1,1,3.40541,0.162162,24.4865,69.1076,37,4
Australia,228,239.627,7.69737,0.372807,232.079,7.23246,0.337719,545,SR Watson,0,0,0,0,0,0,0,0,26,7,33,26,7,33,230,232,1,0,1,4.71318,0.286822,37.7907,90.0943,129,4
Australia,228,239.627,7.69737,0.372807,232.079,7.23246,0.337719,545,BJ Haddin,0,0,0,0,0,0,0,0,26,7,33,26,7,33,230,232,1,0,1,3.14737,0.147368,26.7789,81.382,95,4
Australia,228,239.627,7.69737,0.372807,232.079,7.23246,0.337719,546,SR Watson,0,0,0,0,0,0,0,0,50,5,55,50,5,55,0,361,0,0,1,4.71318,0.286822,37.7907,90.0943,129,4
Australia,228,239.627,7.69737,0.372807,232.079,7.23246,0.337719,546,RT Ponting,0,0,0,0,0,0,0,0,50,5,55,50,5,55,0,361,0,0,1,4.17431,0.33945,38.1009,80.8606,109,4
Bangladesh,160,218.438,7.70625,0.4,211.106,7.05,0.325,546,Tamim Iqbal,0,0,0,0,0,0,0,0,38,4,42,38,4,42,362,295,1,1,1,4.05344,0.274809,31.8015,76.8068,131,4
Bangladesh,160,218.438,7.70625,0.4,211.106,7.05,0.325,546,Imrul Kayes,0,0,0,0,0,0,0,0,38,4,42,38,4,42,362,295,1,1,1,3,0.207547,26.2642,63.6488,53,4
Bangladesh,160,218.438,7.70625,0.4,211.106,7.05,0.325,546,Shahriar Nafees,0,0,0,0,0,0,0,0,38,4,42,38,4,42,362,295,1,1,1,3.40541,0.162162,24.4865,69.1076,37,4
Australia,228,239.627,7.69737,0.372807,232.079,7.23246,0.337719,548,DA Warner,0,0,0,0,0,0,0,0,32,4,36,32,4,36,0,183,1,0,1,4.20312,0.265625,35.2031,87.7336,64,4
Australia,228,239.627,7.69737,0.372807,232.079,7.23246,0.337719,548,RT Ponting,0,0,0,0,0,0,0,0,32,4,36,32,4,36,0,183,1,0,1,4.17431,0.33945,38.1009,80.8606,109,4
Australia,228,239.627,7.69737,0.372807,232.079,7.23246,0.337719,548,MJ Clarke,0,0,0,0,0,0,0,0,32,4,36,32,4,36,0,183,1,0,1,3.10294,0.301471,35.9265,74.0303,136,4
South Africa,190,234.274,7.4,0.373684,232.363,7.33158,0.342105,548,GC Smith,0,0,0,0,0,0,0,0,14,6,20,14,6,20,184,129,1,1,1,3.97,0.29,33.57,79.6819,100,4
South Africa,190,234.274,7.4,0.373684,232.363,7.33158,0.342105,548,JH Kallis,0,0,0,0,0,0,0,0,14,6,20,14,6,20,184,129,1,1,1,3.58621,0.356322,37.2644,76.4442,87,4
South Africa,190,234.274,7.4,0.373684,232.363,7.33158,0.342105,548,HM Amla,0,0,0,0,0,0,0,0,14,6,20,14,6,20,184,129,1,1,1,5.20168,0.403361,48.7899,86.9292,119,4
South Africa,190,234.274,7.4,0.373684,232.363,7.33158,0.342105,549,HM Amla,0,0,0,0,0,0,0,0,22,7,29,22,7,29,0,303,2,1,1,5.20168,0.403361,48.7899,86.9292,119,4
South Africa,190,234.274,7.4,0.373684,232.363,7.33158,0.342105,549,JH Kallis,0,0,0,0,0,0,0,0,22,7,29,22,7,29,0,303,2,1,1,3.58621,0.356322,37.2644,76.4442,87,4
South Africa,190,234.274,7.4,0.373684,232.363,7.33158,0.342105,549,GC Smith,0,0,0,0,0,0,0,0,22,7,29,22,7,29,0,303,2,1,1,3.97,0.29,33.57,79.6819,100,4
Australia,228,239.627,7.69737,0.372807,232.079,7.23246,0.337719,549,DA Warner,0,0,0,0,0,0,0,0,28,7,35,28,7,35,304,223,1,0,1,4.20312,0.265625,35.2031,87.7336,64,4
Australia,228,239.627,7.69737,0.372807,232.079,7.23246,0.337719,549,RT Ponting,0,0,0,0,0,0,0,0,28,7,35,28,7,35,304,223,1,0,1,4.17431,0.33945,38.1009,80.8606,109,4
Australia,228,239.627,7.69737,0.372807,232.079,7.23246,0.337719,549,MJ Clarke,0,0,0,0,0,0,0,0,28,7,35,28,7,35,304,223,1,0,1,3.10294,0.301471,35.9265,74.0303,136,4
South Africa,190,234.274,7.4,0.373684,232.363,7.33158,0.342105,550,HM Amla,0,0,0,0,0,0,0,0,0,16,16,0,16,16,0,301,2,1,1,5.20168,0.403361,48.7899,86.9292,119,4
South Africa,190,234.274,7.4,0.373684,232.363,7.33158,0.342105,550,GC Smith,0,0,0,0,0,0,0,0,0,16,16,0,16,16,0,301,2,1,1,3.97,0.29,33.57,79.6819,100,4
South Africa,190,234.274,7.4,0.373684,232.363,7.33158,0.342105,550,JH Kallis,0,0,0,0,0,0,0,0,0,16,16,0,16,16,0,301,2,1,1,3.58621,0.356322,37.2644,76.4442,87,4
Sri Lanka,244,223.373,7.09016,0.344262,227.578,7.47541,0.385246,550,WU Tharanga,0,0,0,0,0,0,0,0,8,0,8,8,0,8,302,43,1,0,1,3.93985,0.263158,32.9699,71.6035,133,4
Sri Lanka,244,223.373,7.09016,0.344262,227.578,7.47541,0.385246,550,KC Sangakkara,0,0,0,0,0,0,0,0,8,0,8,8,0,8,302,43,1,0,1,4.33659,0.360976,41.9854,80.6276,205,4
Sri Lanka,244,223.373,7.09016,0.344262,227.578,7.47541,0.385246,550,TM Dilshan,0,0,0,0,0,0,0,0,8,0,8,8,0,8,302,43,1,0,1,4.60199,0.273632,38.3632,86.0219,201,4
Sri Lanka,244,223.373,7.09016,0.344262,227.578,7.47541,0.385246,550,LD Chandimal,0,0,0,0,0,0,0,0,8,0,8,8,0,8,302,43,1,0,1,2.18478,0.184783,25.7391,73.8615,92,4
Sri Lanka,244,223.373,7.09016,0.344262,227.578,7.47541,0.385246,550,DPMD Jayawardene,0,0,0,0,0,0,0,0,8,0,8,8,0,8,302,43,1,0,1,3.20833,0.244792,31.6979,79.1109,192,4
Sri Lanka,244,223.373,7.09016,0.344262,227.578,7.47541,0.385246,550,AD Mathews,0,0,0,0,0,0,0,0,8,0,8,8,0,8,302,43,1,0,1,2.64122,0.198473,28.6794,82.3362,131,4
Sri Lanka,244,223.373,7.09016,0.344262,227.578,7.47541,0.385246,551,WU Tharanga,0,0,0,0,0,0,0,0,0,7,7,0,7,7,0,236,0,0,1,3.93985,0.263158,32.9699,71.6035,133,4
Sri Lanka,244,223.373,7.09016,0.344262,227.578,7.47541,0.385246,551,TM Dilshan,0,0,0,0,0,0,0,0,0,7,7,0,7,7,0,236,0,0,1,4.60199,0.273632,38.3632,86.0219,201,4
Sri Lanka,244,223.373,7.09016,0.344262,227.578,7.47541,0.385246,551,KC Sangakkara,0,0,0,0,0,0,0,0,0,7,7,0,7,7,0,236,0,0,1,4.33659,0.360976,41.9854,80.6276,205,4
South Africa,190,234.274,7.4,0.373684,232.363,7.33158,0.342105,551,GC Smith,0,0,0,0,0,0,0,0,10,10,20,10,10,20,237,237,1,1,1,3.97,0.29,33.57,79.6819,100,4
South Africa,190,234.274,7.4,0.373684,232.363,7.33158,0.342105,551,HM Amla,0,0,0,0,0,0,0,0,10,10,20,10,10,20,237,237,1,1,1,5.20168,0.403361,48.7899,86.9292,119,4
Sri Lanka,244,223.373,7.09016,0.344262,227.578,7.47541,0.385246,552,WU Tharanga,0,0,0,0,0,0,0,0,8,18,26,8,18,26,0,266,1,0,1,3.93985,0.263158,32.9699,71.6035,133,4
Sri Lanka,244,223.373,7.09016,0.344262,227.578,7.47541,0.385246,552,TM Dilshan,0,0,0,0,0,0,0,0,8,18,26,8,18,26,0,266,1,0,1,4.60199,0.273632,38.3632,86.0219,201,4
South Africa,190,234.274,7.4,0.373684,232.363,7.33158,0.342105,552,GC Smith,0,0,0,0,0,0,0,0,4,9,13,4,9,13,267,179,1,1,1,3.97,0.29,33.57,79.6819,100,4
South Africa,190,234.274,7.4,0.373684,232.363,7.33158,0.342105,552,AN Petersen,0,0,0,0,0,0,0,0,4,9,13,4,9,13,267,179,1,1,1,3.11111,0.222222,27.6667,81.6393,18,4
South Africa,190,234.274,7.4,0.373684,232.363,7.33158,0.342105,552,CA Ingram,0,0,0,0,0,0,0,0,4,9,13,4,9,13,267,179,1,1,1,3,0.178571,27.1786,81.3904,28,4
South Africa,190,234.274,7.4,0.373684,232.363,7.33158,0.342105,553,AN Petersen,0,0,0,0,0,0,0,0,12,13,25,12,13,25,0,299,1,1,1,3.11111,0.222222,27.6667,81.6393,18,4
South Africa,190,234.274,7.4,0.373684,232.363,7.33158,0.342105,553,GC Smith,0,0,0,0,0,0,0,0,12,13,25,12,13,25,0,299,1,1,1,3.97,0.29,33.57,79.6819,100,4
Sri Lanka,244,223.373,7.09016,0.344262,227.578,7.47541,0.385246,553,WU Tharanga,0,0,0,0,0,0,0,0,22,8,30,22,8,30,300,304,1,0,1,3.93985,0.263158,32.9699,71.6035,133,4
Sri Lanka,244,223.373,7.09016,0.344262,227.578,7.47541,0.385246,553,TM Dilshan,0,0,0,0,0,0,0,0,22,8,30,22,8,30,300,304,1,0,1,4.60199,0.273632,38.3632,86.0219,201,4
Sri Lanka,244,223.373,7.09016,0.344262,227.578,7.47541,0.385246,553,KC Sangakkara,0,0,0,0,0,0,0,0,22,8,30,22,8,30,300,304,1,0,1,4.33659,0.360976,41.9854,80.6276,205,4
South Africa,190,234.274,7.4,0.373684,232.363,7.33158,0.342105,554,GC Smith,0,0,0,0,0,0,0,0,4,10,14,4,10,14,0,312,0,1,1,3.97,0.29,33.57,79.6819,100,4
South Africa,190,234.274,7.4,0.373684,232.363,7.33158,0.342105,554,AN Petersen,0,0,0,0,0,0,0,0,4,10,14,4,10,14,0,312,0,1,1,3.11111,0.222222,27.6667,81.6393,18,4
South Africa,190,234.274,7.4,0.373684,232.363,7.33158,0.342105,554,F du Plessis,0,0,0,0,0,0,0,0,4,10,14,4,10,14,0,312,0,1,1,3.45122,0.292683,34.9268,83.135,82,4
Sri Lanka,244,223.373,7.09016,0.344262,227.578,7.47541,0.385246,554,WU Tharanga,0,0,0,0,0,0,0,0,30,12,42,30,12,42,313,314,1,0,1,3.93985,0.263158,32.9699,71.6035,133,4
Sri Lanka,244,223.373,7.09016,0.344262,227.578,7.47541,0.385246,554,TM Dilshan,0,0,0,0,0,0,0,0,30,12,42,30,12,42,313,314,1,0,1,4.60199,0.273632,38.3632,86.0219,201,4
Sri Lanka,244,223.373,7.09016,0.344262,227.578,7.47541,0.385246,555,WU Tharanga,0,0,0,0,0,0,0,0,24,7,31,24,7,31,0,191,1,1,1,3.93985,0.263158,32.9699,71.6035,133,4
Sri Lanka,244,223.373,7.09016,0.344262,227.578,7.47541,0.385246,555,TM Dilshan,0,0,0,0,0,0,0,0,24,7,31,24,7,31,0,191,1,1,1,4.60199,0.273632,38.3632,86.0219,201,4
Australia,228,239.627,7.69737,0.372807,232.079,7.23246,0.337719,555,SR Watson,0,0,0,0,0,0,0,0,20,11,31,20,11,31,192,192,0,0,1,4.71318,0.286822,37.7907,90.0943,129,4
Australia,228,239.627,7.69737,0.372807,232.079,7.23246,0.337719,555,BJ Haddin,0,0,0,0,0,0,0,0,20,11,31,20,11,31,192,192,0,0,1,3.14737,0.147368,26.7789,81.382,95,4
Sri Lanka,244,223.373,7.09016,0.344262,227.578,7.47541,0.385246,556,WU Tharanga,0,0,0,0,0,0,0,0,20,7,27,20,7,27,0,208,1,1,1,3.93985,0.263158,32.9699,71.6035,133,4
Sri Lanka,244,223.373,7.09016,0.344262,227.578,7.47541,0.385246,556,TM Dilshan,0,0,0,0,0,0,0,0,20,7,27,20,7,27,0,208,1,1,1,4.60199,0.273632,38.3632,86.0219,201,4
Australia,228,239.627,7.69737,0.372807,232.079,7.23246,0.337719,556,SR Watson,0,0,0,0,0,0,0,0,12,6,18,12,6,18,209,211,3,0,1,4.71318,0.286822,37.7907,90.0943,129,4
Australia,228,239.627,7.69737,0.372807,232.079,7.23246,0.337719,556,BJ Haddin,0,0,0,0,0,0,0,0,12,6,18,12,6,18,209,211,3,0,1,3.14737,0.147368,26.7789,81.382,95,4
Australia,228,239.627,7.69737,0.372807,232.079,7.23246,0.337719,556,RT Ponting,0,0,0,0,0,0,0,0,12,6,18,12,6,18,209,211,3,0,1,4.17431,0.33945,38.1009,80.8606,109,4
Sri Lanka,244,223.373,7.09016,0.344262,227.578,7.47541,0.385246,557,WU Tharanga,0,0,0,0,0,0,0,0,12,15,27,12,15,27,0,286,0,1,1,3.93985,0.263158,32.9699,71.6035,133,4
Sri Lanka,244,223.373,7.09016,0.344262,227.578,7.47541,0.385246,557,TM Dilshan,0,0,0,0,0,0,0,0,12,15,27,12,15,27,0,286,0,1,1,4.60199,0.273632,38.3632,86.0219,201,4
Australia,228,239.627,7.69737,0.372807,232.079,7.23246,0.337719,557,SR Watson,0,0,0,0,0,0,0,0,8,3,11,8,3,11,287,208,4,0,1,4.71318,0.286822,37.7907,90.0943,129,4
Australia,228,239.627,7.69737,0.372807,232.079,7.23246,0.337719,557,BJ Haddin,0,0,0,0,0,0,0,0,8,3,11,8,3,11,287,208,4,0,1,3.14737,0.147368,26.7789,81.382,95,4
Australia,228,239.627,7.69737,0.372807,232.079,7.23246,0.337719,557,RT Ponting,0,0,0,0,0,0,0,0,8,3,11,8,3,11,287,208,4,0,1,4.17431,0.33945,38.1009,80.8606,109,4
Sri Lanka,244,223.373,7.09016,0.344262,227.578,7.47541,0.385246,558,WU Tharanga,0,0,0,0,0,0,0,0,12,7,19,12,7,19,0,132,0,1,1,3.93985,0.263158,32.9699,71.6035,133,4
Sri Lanka,244,223.373,7.09016,0.344262,227.578,7.47541,0.385246,558,TM Dilshan,0,0,0,0,0,0,0,0,12,7,19,12,7,19,0,132,0,1,1,4.60199,0.273632,38.3632,86.0219,201,4
Australia,228,239.627,7.69737,0.372807,232.079,7.23246,0.337719,558,SR Watson,0,0,0,0,0,0,0,0,16,3,19,16,3,19,133,133,0,0,1,4.71318,0.286822,37.7907,90.0943,129,4
Australia,228,239.627,7.69737,0.372807,232.079,7.23246,0.337719,558,SE Marsh,0,0,0,0,0,0,0,0,16,3,19,16,3,19,133,133,0,0,1,3.66667,0.291667,35.5417,74.7918,48,4
Australia,228,239.627,7.69737,0.372807,232.079,7.23246,0.337719,559,MS Wade,0,0,0,0,0,0,0,0,4,10,14,4,10,14,0,216,1,1,1,1.86275,0.117647,20.3333,78.2642,51,1
Australia,228,239.627,7.69737,0.372807,232.079,7.23246,0.337719,559,DA Warner,0,0,0,0,0,0,0,0,4,10,14,4,10,14,0,216,1,1,1,4.20312,0.265625,35.2031,87.7336,64,4
India,259,242.378,7.15058,0.339768,244.568,7.12741,0.30888,559,G Gambhir,0,0,0,0,0,0,0,0,0,13,13,0,13,13,217,151,5,0,1,3.99145,0.333333,37.4701,84.1944,117,4
India,259,242.378,7.15058,0.339768,244.568,7.12741,0.30888,559,SR Tendulkar,0,0,0,0,0,0,0,0,0,13,13,0,13,13,217,151,5,0,1,5.89773,0.363636,45.6023,84.5376,88,4
India,259,242.378,7.15058,0.339768,244.568,7.12741,0.30888,559,V Kohli,0,0,0,0,0,0,0,0,0,13,13,0,13,13,217,151,5,0,1,4.66456,0.379747,44.9937,88.3325,158,4
India,259,242.378,7.15058,0.339768,244.568,7.12741,0.30888,559,RG Sharma,0,0,0,0,0,0,0,0,0,13,13,0,13,13,217,151,5,0,1,3.82836,0.268657,35.9179,83.083,134,4
Sri Lanka,244,223.373,7.09016,0.344262,227.578,7.47541,0.385246,560,WU Tharanga,0,0,0,0,0,0,0,0,12,8,20,12,8,20,0,233,0,0,1,3.93985,0.263158,32.9699,71.6035,133,4
Sri Lanka,244,223.373,7.09016,0.344262,227.578,7.47541,0.385246,560,TM Dilshan,0,0,0,0,0,0,0,0,12,8,20,12,8,20,0,233,0,0,1,4.60199,0.273632,38.3632,86.0219,201,4
Sri Lanka,244,223.373,7.09016,0.344262,227.578,7.47541,0.385246,560,KC Sangakkara,0,0,0,0,0,0,0,0,12,8,20,12,8,20,0,233,0,0,1,4.33659,0.360976,41.9854,80.6276,205,4
India,259,242.378,7.15058,0.339768,244.568,7.12741,0.30888,560,V Sehwag,0,0,0,0,0,0,0,0,20,7,27,20,7,27,234,234,1,0,1,5.88636,0.238636,38.8295,108.649,88,0
India,259,242.378,7.15058,0.339768,244.568,7.12741,0.30888,560,SR Tendulkar,0,0,0,0,0,0,0,0,20,7,27,20,7,27,234,234,1,0,1,5.89773,0.363636,45.6023,84.5376,88,4
India,259,242.378,7.15058,0.339768,244.568,7.12741,0.30888,560,V Kohli,0,0,0,0,0,0,0,0,20,7,27,20,7,27,234,234,1,0,1,4.66456,0.379747,44.9937,88.3325,158,4
Australia,228,239.627,7.69737,0.372807,232.079,7.23246,0.337719,561,DA Warner,0,0,0,0,0,0,0,0,16,9,25,16,9,25,0,231,2,1,1,4.20312,0.265625,35.2031,87.7336,64,4
Australia,228,239.627,7.69737,0.372807,232.079,7.23246,0.337719,561,MS Wade,0,0,0,0,0,0,0,0,16,9,25,16,9,25,0,231,2,1,1,1.86275,0.117647,20.3333,78.2642,51,1
Australia,228,239.627,7.69737,0.372807,232.079,7.23246,0.337719,561,RT Ponting,0,0,0,0,0,0,0,0,16,9,25,16,9,25,0,231,2,1,1,4.17431,0.33945,38.1009,80.8606,109,4
Australia,228,239.627,7.69737,0.372807,232.079,7.23246,0.337719,561,MJ Clarke,0,0,0,0,0,0,0,0,16,9,25,16,9,25,0,231,2,1,1,3.10294,0.301471,35.9265,74.0303,136,4
Sri Lanka,244,223.373,7.09016,0.344262,227.578,7.47541,0.385246,561,WU Tharanga,0,0,0,0,0,0,0,0,12,4,16,12,4,16,232,226,0,0,1,3.93985,0.263158,32.9699,71.6035,133,4
Sri Lanka,244,223.373,7.09016,0.344262,227.578,7.47541,0.385246,561,TM Dilshan,0,0,0,0,0,0,0,0,12,4,16,12,4,16,232,226,0,0,1,4.60199,0.273632,38.3632,86.0219,201,4
Sri Lanka,244,223.373,7.09016,0.344262,227.578,7.47541,0.385246,561,KC Sangakkara,0,0,0,0,0,0,0,0,12,4,16,12,4,16,232,226,0,0,1,4.33659,0.360976,41.9854,80.6276,205,4
Australia,228,239.627,7.69737,0.372807,232.079,7.23246,0.337719,562,DA Warner,0,0,0,0,0,0,0,0,12,12,24,12,12,24,0,269,3,1,1,4.20312,0.265625,35.2031,87.7336,64,4
Australia,228,239.627,7.69737,0.372807,232.079,7.23246,0.337719,562,RT Ponting,0,0,0,0,0,0,0,0,12,12,24,12,12,24,0,269,3,1,1,4.17431,0.33945,38.1009,80.8606,109,4
Australia,228,239.627,7.69737,0.372807,232.079,7.23246,0.337719,562,MJ Clarke,0,0,0,0,0,0,0,0,12,12,24,12,12,24,0,269,3,1,1,3.10294,0.301471,35.9265,74.0303,136,4
India,259,242.378,7.15058,0.339768,244.568,7.12741,0.30888,562,G Gambhir,0,0,0,0,0,0,0,0,16,7,23,16,7,23,270,270,3,0,1,3.99145,0.333333,37.4701,84.1944,117,4
India,259,242.378,7.15058,0.339768,244.568,7.12741,0.30888,562,V Sehwag,0,0,0,0,0,0,0,0,16,7,23,16,7,23,270,270,3,0,1,5.88636,0.238636,38.8295,108.649,88,0
Sri Lanka,244,223.373,7.09016,0.344262,227.578,7.47541,0.385246,563,WU Tharanga,0,0,0,0,0,0,0,0,8,7,15,8,7,15,0,236,2,0,1,3.93985,0.263158,32.9699,71.6035,133,4
Sri Lanka,244,223.373,7.09016,0.344262,227.578,7.47541,0.385246,563,KC Sangakkara,0,0,0,0,0,0,0,0,8,7,15,8,7,15,0,236,2,0,1,4.33659,0.360976,41.9854,80.6276,205,4
Sri Lanka,244,223.373,7.09016,0.344262,227.578,7.47541,0.385246,563,TM Dilshan,0,0,0,0,0,0,0,0,8,7,15,8,7,15,0,236,2,0,1,4.60199,0.273632,38.3632,86.0219,201,4
India,259,242.378,7.15058,0.339768,244.568,7.12741,0.30888,563,G Gambhir,0,0,0,0,0,0,0,0,8,12,20,8,12,20,237,236,3,0,1,3.99145,0.333333,37.4701,84.1944,117,4
India,259,242.378,7.15058,0.339768,244.568,7.12741,0.30888,563,SR Tendulkar,0,0,0,0,0,0,0,0,8,12,20,8,12,20,237,236,3,0,1,5.89773,0.363636,45.6023,84.5376,88,4
Australia,228,239.627,7.69737,0.372807,232.079,7.23246,0.337719,564,DA Warner,0,0,0,0,0,0,0,0,8,6,14,8,6,14,0,158,7,1,1,4.20312,0.265625,35.2031,87.7336,64,4
Australia,228,239.627,7.69737,0.372807,232.079,7.23246,0.337719,564,MS Wade,0,0,0,0,0,0,0,0,8,6,14,8,6,14,0,158,7,1,1,1.86275,0.117647,20.3333,78.2642,51,1
Sri Lanka,244,223.373,7.09016,0.344262,227.578,7.47541,0.385246,564,DPMD Jayawardene,0,0,0,0,0,0,0,0,22,16,38,22,16,38,159,152,3,0,1,3.20833,0.244792,31.6979,79.1109,192,4
Sri Lanka,244,223.373,7.09016,0.344262,227.578,7.47541,0.385246,564,TM Dilshan,0,0,0,0,0,0,0,0,22,16,38,22,16,38,159,152,3,0,1,4.60199,0.273632,38.3632,86.0219,201,4
Australia,228,239.627,7.69737,0.372807,232.079,7.23246,0.337719,565,MS Wade,0,0,0,0,0,0,0,0,4,11,15,4,11,15,0,288,2,1,1,1.86275,0.117647,20.3333,78.2642,51,1
Australia,228,239.627,7.69737,0.372807,232.079,7.23246,0.337719,565,DA Warner,0,0,0,0,0,0,0,0,4,11,15,4,11,15,0,288,2,1,1,4.20312,0.265625,35.2031,87.7336,64,4
India,259,242.378,7.15058,0.339768,244.568,7.12741,0.30888,565,G Gambhir,0,0,0,0,0,0,0,0,4,9,13,4,9,13,289,178,2,0,1,3.99145,0.333333,37.4701,84.1944,117,4
India,259,242.378,7.15058,0.339768,244.568,7.12741,0.30888,565,SR Tendulkar,0,0,0,0,0,0,0,0,4,9,13,4,9,13,289,178,2,0,1,5.89773,0.363636,45.6023,84.5376,88,4
India,259,242.378,7.15058,0.339768,244.568,7.12741,0.30888,565,V Kohli,0,0,0,0,0,0,0,0,4,9,13,4,9,13,289,178,2,0,1,4.66456,0.379747,44.9937,88.3325,158,4
Sri Lanka,244,223.373,7.09016,0.344262,227.578,7.47541,0.385246,566,DPMD Jayawardene,0,0,0,0,0,0,0,0,8,13,21,8,13,21,0,289,1,0,1,3.20833,0.244792,31.6979,79.1109,192,4
Sri Lanka,244,223.373,7.09016,0.344262,227.578,7.47541,0.385246,566,TM Dilshan,0,0,0,0,0,0,0,0,8,13,21,8,13,21,0,289,1,0,1,4.60199,0.273632,38.3632,86.0219,201,4
India,259,242.378,7.15058,0.339768,244.568,7.12741,0.30888,566,V Sehwag,0,0,0,0,0,0,0,0,16,11,27,16,11,27,290,238,2,0,1,5.88636,0.238636,38.8295,108.649,88,0
India,259,242.378,7.15058,0.339768,244.568,7.12741,0.30888,566,SR Tendulkar,0,0,0,0,0,0,0,0,16,11,27,16,11,27,290,238,2,0,1,5.89773,0.363636,45.6023,84.5376,88,4
India,259,242.378,7.15058,0.339768,244.568,7.12741,0.30888,566,G Gambhir,0,0,0,0,0,0,0,0,16,11,27,16,11,27,290,238,2,0,1,3.99145,0.333333,37.4701,84.1944,117,4
Australia,228,239.627,7.69737,0.372807,232.079,7.23246,0.337719,567,MS Wade,0,0,0,0,0,0,0,0,8,13,21,8,13,21,0,280,3,1,1,1.86275,0.117647,20.3333,78.2642,51,1
Australia,228,239.627,7.69737,0.372807,232.079,7.23246,0.337719,567,DA Warner,0,0,0,0,0,0,0,0,8,13,21,8,13,21,0,280,3,1,1,4.20312,0.265625,35.2031,87.7336,64,4
Australia,228,239.627,7.69737,0.372807,232.079,7.23246,0.337719,567,PJ Forrest,0,0,0,0,0,0,0,0,8,13,21,8,13,21,0,280,3,1,1,2.71429,0.285714,26.2143,63.6049,14,4
Sri Lanka,244,223.373,7.09016,0.344262,227.578,7.47541,0.385246,567,DPMD Jayawardene,0,0,0,0,0,0,0,0,18,12,30,18,12,30,281,283,7,0,1,3.20833,0.244792,31.6979,79.1109,192,4
Sri Lanka,244,223.373,7.09016,0.344262,227.578,7.47541,0.385246,567,TM Dilshan,0,0,0,0,0,0,0,0,18,12,30,18,12,30,281,283,7,0,1,4.60199,0.273632,38.3632,86.0219,201,4
Sri Lanka,244,223.373,7.09016,0.344262,227.578,7.47541,0.385246,568,DPMD Jayawardene,0,0,0,0,0,0,0,0,14,6,20,14,6,20,0,320,1,0,1,3.20833,0.244792,31.6979,79.1109,192,4
Sri Lanka,244,223.373,7.09016,0.344262,227.578,7.47541,0.385246,568,TM Dilshan,0,0,0,0,0,0,0,0,14,6,20,14,6,20,0,320,1,0,1,4.60199,0.273632,38.3632,86.0219,201,4
India,259,242.378,7.15058,0.339768,244.568,7.12741,0.30888,568,V Sehwag,0,0,0,0,0,0,0,0,34,14,48,34,14,48,321,321,0,0,1,5.88636,0.238636,38.8295,108.649,88,0
India,259,242.378,7.15058,0.339768,244.568,7.12741,0.30888,568,SR Tendulkar,0,0,0,0,0,0,0,0,34,14,48,34,14,48,321,321,0,0,1,5.89773,0.363636,45.6023,84.5376,88,4
Sri Lanka,244,223.373,7.09016,0.344262,227.578,7.47541,0.385246,569,DPMD Jayawardene,0,0,0,0,0,0,0,0,12,4,16,12,4,16,0,238,1,0,1,3.20833,0.244792,31.6979,79.1109,192,4
Sri Lanka,244,223.373,7.09016,0.344262,227.578,7.47541,0.385246,569,TM Dilshan,0,0,0,0,0,0,0,0,12,4,16,12,4,16,0,238,1,0,1,4.60199,0.273632,38.3632,86.0219,201,4
Sri Lanka,244,223.373,7.09016,0.344262,227.578,7.47541,0.385246,569,KC Sangakkara,0,0,0,0,0,0,0,0,12,4,16,12,4,16,0,238,1,0,1,4.33659,0.360976,41.9854,80.6276,205,4
Australia,228,239.627,7.69737,0.372807,232.079,7.23246,0.337719,569,MS Wade,0,0,0,0,0,0,0,0,12,12,24,12,12,24,239,229,2,1,1,1.86275,0.117647,20.3333,78.2642,51,1
Australia,228,239.627,7.69737,0.372807,232.079,7.23246,0.337719,569,DA Warner,0,0,0,0,0,0,0,0,12,12,24,12,12,24,239,229,2,1,1,4.20312,0.265625,35.2031,87.7336,64,4
Australia,228,239.627,7.69737,0.372807,232.079,7.23246,0.337719,569,SR Watson,0,0,0,0,0,0,0,0,12,12,24,12,12,24,239,229,2,1,1,4.71318,0.286822,37.7907,90.0943,129,4
Australia,228,239.627,7.69737,0.372807,232.079,7.23246,0.337719,569,PJ Forrest,0,0,0,0,0,0,0,0,12,12,24,12,12,24,239,229,2,1,1,2.71429,0.285714,26.2143,63.6049,14,4
Australia,228,239.627,7.69737,0.372807,232.079,7.23246,0.337719,570,DA Warner,0,0,0,0,0,0,0,0,18,18,36,18,18,36,0,321,5,1,1,4.20312,0.265625,35.2031,87.7336,64,4
Australia,228,239.627,7.69737,0.372807,232.079,7.23246,0.337719,570,MS Wade,0,0,0,0,0,0,0,0,18,18,36,18,18,36,0,321,5,1,1,1.86275,0.117647,20.3333,78.2642,51,1
Sri Lanka,244,223.373,7.09016,0.344262,227.578,7.47541,0.385246,570,DPMD Jayawardene,0,0,0,0,0,0,0,0,24,11,35,24,11,35,322,306,4,0,1,3.20833,0.244792,31.6979,79.1109,192,4
Sri Lanka,244,223.373,7.09016,0.344262,227.578,7.47541,0.385246,570,TM Dilshan,0,0,0,0,0,0,0,0,24,11,35,24,11,35,322,306,4,0,1,4.60199,0.273632,38.3632,86.0219,201,4
Sri Lanka,244,223.373,7.09016,0.344262,227.578,7.47541,0.385246,570,KC Sangakkara,0,0,0,0,0,0,0,0,24,11,35,24,11,35,322,306,4,0,1,4.33659,0.360976,41.9854,80.6276,205,4
Australia,228,239.627,7.69737,0.372807,232.079,7.23246,0.337719,571,MS Wade,0,0,0,0,0,0,0,0,8,11,19,8,11,19,0,271,4,1,1,1.86275,0.117647,20.3333,78.2642,51,1
Australia,228,239.627,7.69737,0.372807,232.079,7.23246,0.337719,571,DA Warner,0,0,0,0,0,0,0,0,8,11,19,8,11,19,0,271,4,1,1,4.20312,0.265625,35.2031,87.7336,64,4
Australia,228,239.627,7.69737,0.372807,232.079,7.23246,0.337719,571,SR Watson,0,0,0,0,0,0,0,0,8,11,19,8,11,19,0,271,4,1,1,4.71318,0.286822,37.7907,90.0943,129,4
Sri Lanka,244,223.373,7.09016,0.344262,227.578,7.47541,0.385246,571,DPMD Jayawardene,0,0,0,0,0,0,0,0,20,9,29,20,9,29,272,274,13,0,1,3.20833,0.244792,31.6979,79.1109,192,4
Sri Lanka,244,223.373,7.09016,0.344262,227.578,7.47541,0.385246,571,TM Dilshan,0,0,0,0,0,0,0,0,20,9,29,20,9,29,272,274,13,0,1,4.60199,0.273632,38.3632,86.0219,201,4
Australia,228,239.627,7.69737,0.372807,232.079,7.23246,0.337719,572,MS Wade,0,0,0,0,0,0,0,0,8,9,17,8,9,17,0,231,2,1,1,1.86275,0.117647,20.3333,78.2642,51,1
Australia,228,239.627,7.69737,0.372807,232.079,7.23246,0.337719,572,DA Warner,0,0,0,0,0,0,0,0,8,9,17,8,9,17,0,231,2,1,1,4.20312,0.265625,35.2031,87.7336,64,4
Sri Lanka,244,223.373,7.09016,0.344262,227.578,7.47541,0.385246,572,DPMD Jayawardene,0,0,0,0,0,0,0,0,20,14,34,20,14,34,232,215,6,0,1,3.20833,0.244792,31.6979,79.1109,192,4
Sri Lanka,244,223.373,7.09016,0.344262,227.578,7.47541,0.385246,572,TM Dilshan,0,0,0,0,0,0,0,0,20,14,34,20,14,34,232,215,6,0,1,4.60199,0.273632,38.3632,86.0219,201,4
Sri Lanka,244,223.373,7.09016,0.344262,227.578,7.47541,0.385246,572,KC Sangakkara,0,0,0,0,0,0,0,0,20,14,34,20,14,34,232,215,6,0,1,4.33659,0.360976,41.9854,80.6276,205,4
New Zealand,184,233.745,7.39674,0.36413,227.951,7.30435,0.353261,573,RJ Nicol,0,0,0,0,0,0,0,0,16,9,25,16,9,25,0,248,2,1,1,3.3,0.2,29.25,73.4003,20,4
New Zealand,184,233.745,7.39674,0.36413,227.951,7.30435,0.353261,573,BB McCullum,0,0,0,0,0,0,0,0,16,9,25,16,9,25,0,248,2,1,1,3.98611,0.201389,29.9028,98.4004,144,0
New Zealand,184,233.745,7.39674,0.36413,227.951,7.30435,0.353261,573,KS Williamson,0,0,0,0,0,0,0,0,16,9,25,16,9,25,0,248,2,1,1,4.31707,0.390244,43.0488,82.8833,82,4
New Zealand,184,233.745,7.39674,0.36413,227.951,7.30435,0.353261,573,MJ Guptill,0,0,0,0,0,0,0,0,16,9,25,16,9,25,0,248,2,1,1,4.8087,0.313043,38.1217,82.7482,115,4
Zimbabwe,142,212.077,7.5,0.380282,227.704,6.97887,0.316901,573,H Masakadza,0,0,0,0,0,0,0,0,4,6,10,4,6,10,249,158,0,0,1,3.11215,0.186916,26.972,70.0485,107,4
Zimbabwe,142,212.077,7.5,0.380282,227.704,6.97887,0.316901,573,S Matsikenyeri,0,0,0,0,0,0,0,0,4,6,10,4,6,10,249,158,0,0,1,2,0.106383,19.9787,75.7869,47,1
Zimbabwe,142,212.077,7.5,0.380282,227.704,6.97887,0.316901,573,RW Chakabva,0,0,0,0,0,0,0,0,4,6,10,4,6,10,249,158,0,0,1,0.846154,0,13.2692,51.3393,26,3
New Zealand,184,233.745,7.39674,0.36413,227.951,7.30435,0.353261,574,RJ Nicol,0,0,0,0,0,0,0,0,4,6,10,4,6,10,0,372,0,1,1,3.3,0.2,29.25,73.4003,20,4
New Zealand,184,233.745,7.39674,0.36413,227.951,7.30435,0.353261,574,MJ Guptill,0,0,0,0,0,0,0,0,4,6,10,4,6,10,0,372,0,1,1,4.8087,0.313043,38.1217,82.7482,115,4
Zimbabwe,142,212.077,7.5,0.380282,227.704,6.97887,0.316901,574,H Masakadza,0,0,0,0,0,0,0,0,0,11,11,0,11,11,373,231,1,0,1,3.11215,0.186916,26.972,70.0485,107,4
Zimbabwe,142,212.077,7.5,0.380282,227.704,6.97887,0.316901,574,S Matsikenyeri,0,0,0,0,0,0,0,0,0,11,11,0,11,11,373,231,1,0,1,2,0.106383,19.9787,75.7869,47,1
Zimbabwe,142,212.077,7.5,0.380282,227.704,6.97887,0.316901,574,RW Chakabva,0,0,0,0,0,0,0,0,0,11,11,0,11,11,373,231,1,0,1,0.846154,0,13.2692,51.3393,26,3
New Zealand,184,233.745,7.39674,0.36413,227.951,7.30435,0.353261,575,RJ Nicol,0,0,0,0,0,0,0,0,30,7,37,30,7,37,0,373,3,1,1,3.3,0.2,29.25,73.4003,20,4
New Zealand,184,233.745,7.39674,0.36413,227.951,7.30435,0.353261,575,MJ Guptill,0,0,0,0,0,0,0,0,30,7,37,30,7,37,0,373,3,1,1,4.8087,0.313043,38.1217,82.7482,115,4
Zimbabwe,142,212.077,7.5,0.380282,227.704,6.97887,0.316901,575,TMK Mawoyo,0,0,0,0,0,0,0,0,8,6,14,8,6,14,374,171,0,0,1,0.571429,0,8.28571,34.9398,7,3
Zimbabwe,142,212.077,7.5,0.380282,227.704,6.97887,0.316901,575,S Matsikenyeri,0,0,0,0,0,0,0,0,8,6,14,8,6,14,374,171,0,0,1,2,0.106383,19.9787,75.7869,47,1
New Zealand,184,233.745,7.39674,0.36413,227.951,7.30435,0.353261,576,RJ Nicol,0,0,0,0,0,0,0,0,0,6,6,0,6,6,0,253,7,1,1,3.3,0.2,29.25,73.4003,20,4
New Zealand,184,233.745,7.39674,0.36413,227.951,7.30435,0.353261,576,MJ Guptill,0,0,0,0,0,0,0,0,0,6,6,0,6,6,0,253,7,1,1,4.8087,0.313043,38.1217,82.7482,115,4
South Africa,190,234.274,7.4,0.373684,232.363,7.33158,0.342105,576,HM Amla,0,0,0,0,0,0,0,0,8,11,19,8,11,19,254,254,0,0,1,5.20168,0.403361,48.7899,86.9292,119,4
South Africa,190,234.274,7.4,0.373684,232.363,7.33158,0.342105,576,GC Smith,0,0,0,0,0,0,0,0,8,11,19,8,11,19,254,254,0,0,1,3.97,0.29,33.57,79.6819,100,4
South Africa,190,234.274,7.4,0.373684,232.363,7.33158,0.342105,576,JP Duminy,0,0,0,0,0,0,0,0,8,11,19,8,11,19,254,254,0,0,1,2.3252,0.186992,29.9675,80.2351,123,4
New Zealand,184,233.745,7.39674,0.36413,227.951,7.30435,0.353261,577,RJ Nicol,0,0,0,0,0,0,0,0,4,9,13,4,9,13,0,206,1,1,1,3.3,0.2,29.25,73.4003,20,4
New Zealand,184,233.745,7.39674,0.36413,227.951,7.30435,0.353261,577,MJ Guptill,0,0,0,0,0,0,0,0,4,9,13,4,9,13,0,206,1,1,1,4.8087,0.313043,38.1217,82.7482,115,4
New Zealand,184,233.745,7.39674,0.36413,227.951,7.30435,0.353261,577,BB McCullum,0,0,0,0,0,0,0,0,4,9,13,4,9,13,0,206,1,1,1,3.98611,0.201389,29.9028,98.4004,144,0
South Africa,190,234.274,7.4,0.373684,232.363,7.33158,0.342105,577,HM Amla,0,0,0,0,0,0,0,0,8,12,20,8,12,20,207,208,2,0,1,5.20168,0.403361,48.7899,86.9292,119,4
South Africa,190,234.274,7.4,0.373684,232.363,7.33158,0.342105,577,WD Parnell,0,0,0,0,0,0,0,0,8,12,20,8,12,20,207,208,2,0,1,1.47826,0.0434783,15.8261,74.7433,23,1
India,259,242.378,7.15058,0.339768,244.568,7.12741,0.30888,578,PA Patel,0,0,0,0,0,0,0,0,4,10,14,4,10,14,0,300,5,1,1,2.65217,0.130435,22.1304,79.4072,23,4
India,259,242.378,7.15058,0.339768,244.568,7.12741,0.30888,578,AM Rahane,0,0,0,0,0,0,0,0,4,10,14,4,10,14,0,300,5,1,1,3.55738,0.262295,32.2295,78.0159,61,4
India,259,242.378,7.15058,0.339768,244.568,7.12741,0.30888,578,G Gambhir,0,0,0,0,0,0,0,0,4,10,14,4,10,14,0,300,5,1,1,3.99145,0.333333,37.4701,84.1944,117,4
England,221,237.176,7.17647,0.289593,230.633,7.45701,0.384615,578,AN Cook,0,0,0,0,0,0,0,0,20,9,29,20,9,29,301,174,0,0,1,4.17045,0.272727,35.75,75.5524,88,4
England,221,237.176,7.17647,0.289593,230.633,7.45701,0.384615,578,C Kieswetter,0,0,0,0,0,0,0,0,20,9,29,20,9,29,301,174,0,0,1,3.43243,0.135135,26.4324,88.0288,37,4
England,221,237.176,7.17647,0.289593,230.633,7.45701,0.384615,578,KP Pietersen,0,0,0,0,0,0,0,0,20,9,29,20,9,29,301,174,0,0,1,3.69892,0.236559,33.4946,82.2117,93,4
England,221,237.176,7.17647,0.289593,230.633,7.45701,0.384615,579,AN Cook,0,0,0,0,0,0,0,0,16,3,19,16,3,19,0,237,1,0,1,4.17045,0.272727,35.75,75.5524,88,4
England,221,237.176,7.17647,0.289593,230.633,7.45701,0.384615,579,IJL Trott,0,0,0,0,0,0,0,0,16,3,19,16,3,19,0,237,1,0,1,3.3871,0.403226,43.7903,75.2494,62,4
England,221,237.176,7.17647,0.289593,230.633,7.45701,0.384615,579,C Kieswetter,0,0,0,0,0,0,0,0,16,3,19,16,3,19,0,237,1,0,1,3.43243,0.135135,26.4324,88.0288,37,4
England,221,237.176,7.17647,0.289593,230.633,7.45701,0.384615,579,KP Pietersen,0,0,0,0,0,0,0,0,16,3,19,16,3,19,0,237,1,0,1,3.69892,0.236559,33.4946,82.2117,93,4
India,259,242.378,7.15058,0.339768,244.568,7.12741,0.30888,579,PA Patel,0,0,0,0,0,0,0,0,8,5,13,8,5,13,238,238,1,1,1,2.65217,0.130435,22.1304,79.4072,23,4
India,259,242.378,7.15058,0.339768,244.568,7.12741,0.30888,579,AM Rahane,0,0,0,0,0,0,0,0,8,5,13,8,5,13,238,238,1,1,1,3.55738,0.262295,32.2295,78.0159,61,4
India,259,242.378,7.15058,0.339768,244.568,7.12741,0.30888,579,G Gambhir,0,0,0,0,0,0,0,0,8,5,13,8,5,13,238,238,1,1,1,3.99145,0.333333,37.4701,84.1944,117,4
England,221,237.176,7.17647,0.289593,230.633,7.45701,0.384615,580,AN Cook,0,0,0,0,0,0,0,0,8,8,16,8,8,16,0,298,2,0,1,4.17045,0.272727,35.75,75.5524,88,4
England,221,237.176,7.17647,0.289593,230.633,7.45701,0.384615,580,C Kieswetter,0,0,0,0,0,0,0,0,8,8,16,8,8,16,0,298,2,0,1,3.43243,0.135135,26.4324,88.0288,37,4
England,221,237.176,7.17647,0.289593,230.633,7.45701,0.384615,580,IJL Trott,0,0,0,0,0,0,0,0,8,8,16,8,8,16,0,298,2,0,1,3.3871,0.403226,43.7903,75.2494,62,4
India,259,242.378,7.15058,0.339768,244.568,7.12741,0.30888,580,PA Patel,0,0,0,0,0,0,0,0,8,15,23,8,15,23,299,300,2,1,1,2.65217,0.130435,22.1304,79.4072,23,4
India,259,242.378,7.15058,0.339768,244.568,7.12741,0.30888,580,AM Rahane,0,0,0,0,0,0,0,0,8,15,23,8,15,23,299,300,2,1,1,3.55738,0.262295,32.2295,78.0159,61,4
England,221,237.176,7.17647,0.289593,230.633,7.45701,0.384615,581,AN Cook,0,0,0,0,0,0,0,0,22,2,24,22,2,24,0,220,0,0,1,4.17045,0.272727,35.75,75.5524,88,4
England,221,237.176,7.17647,0.289593,230.633,7.45701,0.384615,581,C Kieswetter,0,0,0,0,0,0,0,0,22,2,24,22,2,24,0,220,0,0,1,3.43243,0.135135,26.4324,88.0288,37,4
India,259,242.378,7.15058,0.339768,244.568,7.12741,0.30888,581,PA Patel,0,0,0,0,0,0,0,0,0,13,13,0,13,13,221,223,4,1,1,2.65217,0.130435,22.1304,79.4072,23,4
India,259,242.378,7.15058,0.339768,244.568,7.12741,0.30888,581,AM Rahane,0,0,0,0,0,0,0,0,0,13,13,0,13,13,221,223,4,1,1,3.55738,0.262295,32.2295,78.0159,61,4
India,259,242.378,7.15058,0.339768,244.568,7.12741,0.30888,582,AM Rahane,0,0,0,0,0,0,0,0,16,7,23,16,7,23,0,271,0,1,1,3.55738,0.262295,32.2295,78.0159,61,4
India,259,242.378,7.15058,0.339768,244.568,7.12741,0.30888,582,G Gambhir,0,0,0,0,0,0,0,0,16,7,23,16,7,23,0,271,0,1,1,3.99145,0.333333,37.4701,84.1944,117,4
England,221,237.176,7.17647,0.289593,230.633,7.45701,0.384615,582,C Kieswetter,0,0,0,0,0,0,0,0,18,11,29,18,11,29,272,176,1,0,1,3.43243,0.135135,26.4324,88.0288,37,4
England,221,237.176,7.17647,0.289593,230.633,7.45701,0.384615,582,AN Cook,0,0,0,0,0,0,0,0,18,11,29,18,11,29,272,176,1,0,1,4.17045,0.272727,35.75,75.5524,88,4
Bangladesh,160,218.438,7.70625,0.4,211.106,7.05,0.325,583,Tamim Iqbal,0,0,0,0,0,0,0,0,0,6,6,0,6,6,0,184,0,0,1,4.05344,0.274809,31.8015,76.8068,131,4
Bangladesh,160,218.438,7.70625,0.4,211.106,7.05,0.325,583,Imrul Kayes,0,0,0,0,0,0,0,0,0,6,6,0,6,6,0,184,0,0,1,3,0.207547,26.2642,63.6488,53,4
Zimbabwe,142,212.077,7.5,0.380282,227.704,6.97887,0.316901,583,BRM Taylor,0,0,0,0,0,0,0,0,12,10,22,12,10,22,185,186,6,1,1,3.3,0.26,33.56,76.3421,100,4
Zimbabwe,142,212.077,7.5,0.380282,227.704,6.97887,0.316901,583,V Sibanda,0,0,0,0,0,0,0,0,12,10,22,12,10,22,185,186,6,1,1,2.9697,0.181818,23.5152,63.5545,66,1
Zimbabwe,142,212.077,7.5,0.380282,227.704,6.97887,0.316901,583,H Masakadza,0,0,0,0,0,0,0,0,12,10,22,12,10,22,185,186,6,1,1,3.11215,0.186916,26.972,70.0485,107,4
Bangladesh,160,218.438,7.70625,0.4,211.106,7.05,0.325,584,Tamim Iqbal,0,0,0,0,0,0,0,0,12,7,19,12,7,19,0,188,1,0,1,4.05344,0.274809,31.8015,76.8068,131,4
Bangladesh,160,218.438,7.70625,0.4,211.106,7.05,0.325,584,Imrul Kayes,0,0,0,0,0,0,0,0,12,7,19,12,7,19,0,188,1,0,1,3,0.207547,26.2642,63.6488,53,4
Bangladesh,160,218.438,7.70625,0.4,211.106,7.05,0.325,584,Mushfiqur Rahim,0,0,0,0,0,0,0,0,12,7,19,12,7,19,0,188,1,0,1,2.61111,0.18254,27.7778,75.2526,126,4
Zimbabwe,142,212.077,7.5,0.380282,227.704,6.97887,0.316901,584,BRM Taylor,0,0,0,0,0,0,0,0,4,4,8,4,4,8,189,191,0,1,1,3.3,0.26,33.56,76.3421,100,4
Zimbabwe,142,212.077,7.5,0.380282,227.704,6.97887,0.316901,584,V Sibanda,0,0,0,0,0,0,0,0,4,4,8,4,4,8,189,191,0,1,1,2.9697,0.181818,23.5152,63.5545,66,1
Zimbabwe,142,212.077,7.5,0.380282,227.704,6.97887,0.316901,584,H Masakadza,0,0,0,0,0,0,0,0,4,4,8,4,4,8,189,191,0,1,1,3.11215,0.186916,26.972,70.0485,107,4
Zimbabwe,142,212.077,7.5,0.380282,227.704,6.97887,0.316901,585,BRM Taylor,0,0,0,0,0,0,0,0,0,9,9,0,9,9,0,250,1,1,1,3.3,0.26,33.56,76.3421,100,4
Zimbabwe,142,212.077,7.5,0.380282,227.704,6.97887,0.316901,585,V Sibanda,0,0,0,0,0,0,0,0,0,9,9,0,9,9,0,250,1,1,1,2.9697,0.181818,23.5152,63.5545,66,1
Bangladesh,160,218.438,7.70625,0.4,211.106,7.05,0.325,585,Tamim Iqbal,0,0,0,0,0,0,0,0,4,14,18,4,14,18,251,245,3,0,1,4.05344,0.274809,31.8015,76.8068,131,4
Bangladesh,160,218.438,7.70625,0.4,211.106,7.05,0.325,585,Imrul Kayes,0,0,0,0,0,0,0,0,4,14,18,4,14,18,251,245,3,0,1,3,0.207547,26.2642,63.6488,53,4
Bangladesh,160,218.438,7.70625,0.4,211.106,7.05,0.325,586,Tamim Iqbal,0,0,0,0,0,0,0,0,4,11,15,4,11,15,0,253,1,0,1,4.05344,0.274809,31.8015,76.8068,131,4
Bangladesh,160,218.438,7.70625,0.4,211.106,7.05,0.325,586,Imrul Kayes,0,0,0,0,0,0,0,0,4,11,15,4,11,15,0,253,1,0,1,3,0.207547,26.2642,63.6488,53,4
Zimbabwe,142,212.077,7.5,0.380282,227.704,6.97887,0.316901,586,BRM Taylor,0,0,0,0,0,0,0,0,14,4,18,14,4,18,254,160,4,1,1,3.3,0.26,33.56,76.3421,100,4
Zimbabwe,142,212.077,7.5,0.380282,227.704,6.97887,0.316901,586,V Sibanda,0,0,0,0,0,0,0,0,14,4,18,14,4,18,254,160,4,1,1,2.9697,0.181818,23.5152,63.5545,66,1
Zimbabwe,142,212.077,7.5,0.380282,227.704,6.97887,0.316901,586,H Masakadza,0,0,0,0,0,0,0,0,14,4,18,14,4,18,254,160,4,1,1,3.11215,0.186916,26.972,70.0485,107,4
Pakistan,211,222.621,7.38389,0.393365,235.517,7.54976,0.336493,587,Mohammad Hafeez,0,0,0,0,0,0,0,0,12,5,17,12,5,17,0,247,2,0,1,4.04511,0.255639,34.3534,78.0625,133,4
Pakistan,211,222.621,7.38389,0.393365,235.517,7.54976,0.336493,587,Imran Farhat,0,0,0,0,0,0,0,0,12,5,17,12,5,17,0,247,2,0,1,3.03333,0.266667,27.0333,62.9658,30,4
Pakistan,211,222.621,7.38389,0.393365,235.517,7.54976,0.336493,587,Younis Khan,0,0,0,0,0,0,0,0,12,5,17,12,5,17,0,247,2,0,1,2.64655,0.215517,28.5,73.2713,116,4
Zimbabwe,142,212.077,7.5,0.380282,227.704,6.97887,0.316901,587,V Sibanda,0,0,0,0,0,0,0,0,18,3,21,18,3,21,248,242,0,1,1,2.9697,0.181818,23.5152,63.5545,66,1
Zimbabwe,142,212.077,7.5,0.380282,227.704,6.97887,0.316901,587,CJ Chibhabha,0,0,0,0,0,0,0,0,18,3,21,18,3,21,248,242,0,1,1,2.56716,0.149254,23.5373,64.7373,67,1
Zimbabwe,142,212.077,7.5,0.380282,227.704,6.97887,0.316901,587,H Masakadza,0,0,0,0,0,0,0,0,18,3,21,18,3,21,248,242,0,1,1,3.11215,0.186916,26.972,70.0485,107,4
Zimbabwe,142,212.077,7.5,0.380282,227.704,6.97887,0.316901,588,V Sibanda,0,0,0,0,0,0,0,0,4,6,10,4,6,10,0,225,4,1,1,2.9697,0.181818,23.5152,63.5545,66,1
Zimbabwe,142,212.077,7.5,0.380282,227.704,6.97887,0.316901,588,CJ Chibhabha,0,0,0,0,0,0,0,0,4,6,10,4,6,10,0,225,4,1,1,2.56716,0.149254,23.5373,64.7373,67,1
Zimbabwe,142,212.077,7.5,0.380282,227.704,6.97887,0.316901,588,H Masakadza,0,0,0,0,0,0,0,0,4,6,10,4,6,10,0,225,4,1,1,3.11215,0.186916,26.972,70.0485,107,4
Pakistan,211,222.621,7.38389,0.393365,235.517,7.54976,0.336493,588,Mohammad Hafeez,0,0,0,0,0,0,0,0,0,6,6,0,6,6,226,228,3,0,1,4.04511,0.255639,34.3534,78.0625,133,4
Pakistan,211,222.621,7.38389,0.393365,235.517,7.54976,0.336493,588,Imran Farhat,0,0,0,0,0,0,0,0,0,6,6,0,6,6,226,228,3,0,1,3.03333,0.266667,27.0333,62.9658,30,4
Pakistan,211,222.621,7.38389,0.393365,235.517,7.54976,0.336493,589,Mohammad Hafeez,0,0,0,0,0,0,0,0,24,9,33,24,9,33,0,270,3,0,1,4.04511,0.255639,34.3534,78.0625,133,4
Pakistan,211,222.621,7.38389,0.393365,235.517,7.54976,0.336493,589,Imran Farhat,0,0,0,0,0,0,0,0,24,9,33,24,9,33,0,270,3,0,1,3.03333,0.266667,27.0333,62.9658,30,4
Zimbabwe,142,212.077,7.5,0.380282,227.704,6.97887,0.316901,589,V Sibanda,0,0,0,0,0,0,0,0,4,7,11,4,7,11,271,242,2,1,1,2.9697,0.181818,23.5152,63.5545,66,1
Zimbabwe,142,212.077,7.5,0.380282,227.704,6.97887,0.316901,589,CJ Chibhabha,0,0,0,0,0,0,0,0,4,7,11,4,7,11,271,242,2,1,1,2.56716,0.149254,23.5373,64.7373,67,1
Zimbabwe,142,212.077,7.5,0.380282,227.704,6.97887,0.316901,592,V Sibanda,0,0,0,0,0,0,0,0,4,3,7,4,3,7,0,231,0,1,1,2.9697,0.181818,23.5152,63.5545,66,1
Zimbabwe,142,212.077,7.5,0.380282,227.704,6.97887,0.316901,592,CJ Chibhabha,0,0,0,0,0,0,0,0,4,3,7,4,3,7,0,231,0,1,1,2.56716,0.149254,23.5373,64.7373,67,1
Zimbabwe,142,212.077,7.5,0.380282,227.704,6.97887,0.316901,592,H Masakadza,0,0,0,0,0,0,0,0,4,3,7,4,3,7,0,231,0,1,1,3.11215,0.186916,26.972,70.0485,107,4
New Zealand,184,233.745,7.39674,0.36413,227.951,7.30435,0.353261,592,RJ Nicol,0,0,0,0,0,0,0,0,20,19,39,20,19,39,232,232,4,0,1,3.3,0.2,29.25,73.4003,20,4
New Zealand,184,233.745,7.39674,0.36413,227.951,7.30435,0.353261,592,MJ Guptill,0,0,0,0,0,0,0,0,20,19,39,20,19,39,232,232,4,0,1,4.8087,0.313043,38.1217,82.7482,115,4
Zimbabwe,142,212.077,7.5,0.380282,227.704,6.97887,0.316901,593,V Sibanda,0,0,0,0,0,0,0,0,12,4,16,12,4,16,0,259,1,1,1,2.9697,0.181818,23.5152,63.5545,66,1
Zimbabwe,142,212.077,7.5,0.380282,227.704,6.97887,0.316901,593,H Masakadza,0,0,0,0,0,0,0,0,12,4,16,12,4,16,0,259,1,1,1,3.11215,0.186916,26.972,70.0485,107,4
New Zealand,184,233.745,7.39674,0.36413,227.951,7.30435,0.353261,593,RJ Nicol,0,0,0,0,0,0,0,0,20,11,31,20,11,31,260,261,1,0,1,3.3,0.2,29.25,73.4003,20,4
New Zealand,184,233.745,7.39674,0.36413,227.951,7.30435,0.353261,593,MJ Guptill,0,0,0,0,0,0,0,0,20,11,31,20,11,31,260,261,1,0,1,4.8087,0.313043,38.1217,82.7482,115,4
New Zealand,184,233.745,7.39674,0.36413,227.951,7.30435,0.353261,594,RJ Nicol,0,0,0,0,0,0,0,0,12,7,19,12,7,19,0,328,2,0,1,3.3,0.2,29.25,73.4003,20,4
New Zealand,184,233.745,7.39674,0.36413,227.951,7.30435,0.353261,594,BB McCullum,0,0,0,0,0,0,0,0,12,7,19,12,7,19,0,328,2,0,1,3.98611,0.201389,29.9028,98.4004,144,0
Zimbabwe,142,212.077,7.5,0.380282,227.704,6.97887,0.316901,594,V Sibanda,0,0,0,0,0,0,0,0,14,6,20,14,6,20,329,329,0,1,1,2.9697,0.181818,23.5152,63.5545,66,1
Zimbabwe,142,212.077,7.5,0.380282,227.704,6.97887,0.316901,594,BRM Taylor,0,0,0,0,0,0,0,0,14,6,20,14,6,20,329,329,0,1,1,3.3,0.26,33.56,76.3421,100,4
Zimbabwe,142,212.077,7.5,0.380282,227.704,6.97887,0.316901,594,H Masakadza,0,0,0,0,0,0,0,0,14,6,20,14,6,20,329,329,0,1,1,3.11215,0.186916,26.972,70.0485,107,4
Sri Lanka,244,223.373,7.09016,0.344262,227.578,7.47541,0.385246,595,WU Tharanga,0,0,0,0,0,0,0,0,12,11,23,12,11,23,0,235,5,0,1,3.93985,0.263158,32.9699,71.6035,133,4
Sri Lanka,244,223.373,7.09016,0.344262,227.578,7.47541,0.385246,595,TM Dilshan,0,0,0,0,0,0,0,0,12,11,23,12,11,23,0,235,5,0,1,4.60199,0.273632,38.3632,86.0219,201,4
Pakistan,211,222.621,7.38389,0.393365,235.517,7.54976,0.336493,595,Mohammad Hafeez,0,0,0,0,0,0,0,0,12,8,20,12,8,20,236,210,3,0,1,4.04511,0.255639,34.3534,78.0625,133,4
Pakistan,211,222.621,7.38389,0.393365,235.517,7.54976,0.336493,595,Younis Khan,0,0,0,0,0,0,0,0,12,8,20,12,8,20,236,210,3,0,1,2.64655,0.215517,28.5,73.2713,116,4
Pakistan,211,222.621,7.38389,0.393365,235.517,7.54976,0.336493,595,Misbah-ul-Haq,0,0,0,0,0,0,0,0,12,8,20,12,8,20,236,210,3,0,1,2.95238,0.285714,34.9921,71.8195,126,4
Pakistan,211,222.621,7.38389,0.393365,235.517,7.54976,0.336493,595,Imran Farhat,0,0,0,0,0,0,0,0,12,8,20,12,8,20,236,210,3,0,1,3.03333,0.266667,27.0333,62.9658,30,4
Pakistan,211,222.621,7.38389,0.393365,235.517,7.54976,0.336493,595,Umar Akmal,0,0,0,0,0,0,0,0,12,8,20,12,8,20,236,210,3,0,1,2.76842,0.2,27.5053,82.7947,95,4
Pakistan,211,222.621,7.38389,0.393365,235.517,7.54976,0.336493,596,Mohammad Hafeez,0,0,0,0,0,0,0,0,12,11,23,12,11,23,0,257,0,0,1,4.04511,0.255639,34.3534,78.0625,133,4
Pakistan,211,222.621,7.38389,0.393365,235.517,7.54976,0.336493,596,Imran Farhat,0,0,0,0,0,0,0,0,12,11,23,12,11,23,0,257,0,0,1,3.03333,0.266667,27.0333,62.9658,30,4
Sri Lanka,244,223.373,7.09016,0.344262,227.578,7.47541,0.385246,596,WU Tharanga,0,0,0,0,0,0,0,0,16,10,26,16,10,26,258,236,3,0,1,3.93985,0.263158,32.9699,71.6035,133,4
Sri Lanka,244,223.373,7.09016,0.344262,227.578,7.47541,0.385246,596,KC Sangakkara,0,0,0,0,0,0,0,0,16,10,26,16,10,26,258,236,3,0,1,4.33659,0.360976,41.9854,80.6276,205,4
Sri Lanka,244,223.373,7.09016,0.344262,227.578,7.47541,0.385246,596,TM Dilshan,0,0,0,0,0,0,0,0,16,10,26,16,10,26,258,236,3,0,1,4.60199,0.273632,38.3632,86.0219,201,4
Pakistan,211,222.621,7.38389,0.393365,235.517,7.54976,0.336493,597,Mohammad Hafeez,0,0,0,0,0,0,0,0,12,4,16,12,4,16,0,200,2,0,1,4.04511,0.255639,34.3534,78.0625,133,4
Pakistan,211,222.621,7.38389,0.393365,235.517,7.54976,0.336493,597,Imran Farhat,0,0,0,0,0,0,0,0,12,4,16,12,4,16,0,200,2,0,1,3.03333,0.266667,27.0333,62.9658,30,4
Sri Lanka,244,223.373,7.09016,0.344262,227.578,7.47541,0.385246,597,WU Tharanga,0,0,0,0,0,0,0,0,20,7,27,20,7,27,201,174,1,0,1,3.93985,0.263158,32.9699,71.6035,133,4
Sri Lanka,244,223.373,7.09016,0.344262,227.578,7.47541,0.385246,597,TM Dilshan,0,0,0,0,0,0,0,0,20,7,27,20,7,27,201,174,1,0,1,4.60199,0.273632,38.3632,86.0219,201,4
Sri Lanka,244,223.373,7.09016,0.344262,227.578,7.47541,0.385246,597,KC Sangakkara,0,0,0,0,0,0,0,0,20,7,27,20,7,27,201,174,1,0,1,4.33659,0.360976,41.9854,80.6276,205,4
Sri Lanka,244,223.373,7.09016,0.344262,227.578,7.47541,0.385246,598,WU Tharanga,0,0,0,0,0,0,0,0,4,12,16,4,12,16,0,218,4,0,1,3.93985,0.263158,32.9699,71.6035,133,4
Sri Lanka,244,223.373,7.09016,0.344262,227.578,7.47541,0.385246,598,TM Dilshan,0,0,0,0,0,0,0,0,4,12,16,4,12,16,0,218,4,0,1,4.60199,0.273632,38.3632,86.0219,201,4
Sri Lanka,244,223.373,7.09016,0.344262,227.578,7.47541,0.385246,598,LD Chandimal,0,0,0,0,0,0,0,0,4,12,16,4,12,16,0,218,4,0,1,2.18478,0.184783,25.7391,73.8615,92,4
Sri Lanka,244,223.373,7.09016,0.344262,227.578,7.47541,0.385246,598,KC Sangakkara,0,0,0,0,0,0,0,0,4,12,16,4,12,16,0,218,4,0,1,4.33659,0.360976,41.9854,80.6276,205,4
Pakistan,211,222.621,7.38389,0.393365,235.517,7.54976,0.336493,598,Mohammad Hafeez,0,0,0,0,0,0,0,0,8,5,13,8,5,13,219,219,1,0,1,4.04511,0.255639,34.3534,78.0625,133,4
Pakistan,211,222.621,7.38389,0.393365,235.517,7.54976,0.336493,598,Asad Shafiq,0,0,0,0,0,0,0,0,8,5,13,8,5,13,219,219,1,0,1,2.07843,0.176471,24.7843,67.1269,51,4
England,221,237.176,7.17647,0.289593,230.633,7.45701,0.384615,599,AN Cook,0,0,0,0,0,0,0,0,8,11,19,8,11,19,0,260,5,0,1,4.17045,0.272727,35.75,75.5524,88,4
England,221,237.176,7.17647,0.289593,230.633,7.45701,0.384615,599,KP Pietersen,0,0,0,0,0,0,0,0,8,11,19,8,11,19,0,260,5,0,1,3.69892,0.236559,33.4946,82.2117,93,4
Pakistan,211,222.621,7.38389,0.393365,235.517,7.54976,0.336493,599,Mohammad Hafeez,0,0,0,0,0,0,0,0,12,6,18,12,6,18,261,130,2,0,1,4.04511,0.255639,34.3534,78.0625,133,4
Pakistan,211,222.621,7.38389,0.393365,235.517,7.54976,0.336493,599,Imran Farhat,0,0,0,0,0,0,0,0,12,6,18,12,6,18,261,130,2,0,1,3.03333,0.266667,27.0333,62.9658,30,4
Pakistan,211,222.621,7.38389,0.393365,235.517,7.54976,0.336493,599,Asad Shafiq,0,0,0,0,0,0,0,0,12,6,18,12,6,18,261,130,2,0,1,2.07843,0.176471,24.7843,67.1269,51,4
Pakistan,211,222.621,7.38389,0.393365,235.517,7.54976,0.336493,599,Younis Khan,0,0,0,0,0,0,0,0,12,6,18,12,6,18,261,130,2,0,1,2.64655,0.215517,28.5,73.2713,116,4
England,221,237.176,7.17647,0.289593,230.633,7.45701,0.384615,600,AN Cook,0,0,0,0,0,0,0,0,8,4,12,8,4,12,0,250,7,0,1,4.17045,0.272727,35.75,75.5524,88,4
England,221,237.176,7.17647,0.289593,230.633,7.45701,0.384615,600,KP Pietersen,0,0,0,0,0,0,0,0,8,4,12,8,4,12,0,250,7,0,1,3.69892,0.236559,33.4946,82.2117,93,4
Pakistan,211,222.621,7.38389,0.393365,235.517,7.54976,0.336493,600,Mohammad Hafeez,0,0,0,0,0,0,0,0,0,7,7,0,7,7,251,230,2,0,1,4.04511,0.255639,34.3534,78.0625,133,4
Pakistan,211,222.621,7.38389,0.393365,235.517,7.54976,0.336493,600,Imran Farhat,0,0,0,0,0,0,0,0,0,7,7,0,7,7,251,230,2,0,1,3.03333,0.266667,27.0333,62.9658,30,4
Pakistan,211,222.621,7.38389,0.393365,235.517,7.54976,0.336493,601,Mohammad Hafeez,0,0,0,0,0,0,0,0,8,16,24,8,16,24,0,222,4,0,1,4.04511,0.255639,34.3534,78.0625,133,4
Pakistan,211,222.621,7.38389,0.393365,235.517,7.54976,0.336493,601,Imran Farhat,0,0,0,0,0,0,0,0,8,16,24,8,16,24,0,222,4,0,1,3.03333,0.266667,27.0333,62.9658,30,4
Pakistan,211,222.621,7.38389,0.393365,235.517,7.54976,0.336493,601,Azhar Ali,0,0,0,0,0,0,0,0,8,16,24,8,16,24,0,222,4,0,1,3.83333,0.3,38.5333,73.6775,30,4
England,221,237.176,7.17647,0.289593,230.633,7.45701,0.384615,601,AN Cook,0,0,0,0,0,0,0,0,22,12,34,22,12,34,223,226,6,0,1,4.17045,0.272727,35.75,75.5524,88,4
England,221,237.176,7.17647,0.289593,230.633,7.45701,0.384615,601,KP Pietersen,0,0,0,0,0,0,0,0,22,12,34,22,12,34,223,226,6,0,1,3.69892,0.236559,33.4946,82.2117,93,4
Pakistan,211,222.621,7.38389,0.393365,235.517,7.54976,0.336493,602,Mohammad Hafeez,0,0,0,0,0,0,0,0,4,11,15,4,11,15,0,237,0,0,1,4.04511,0.255639,34.3534,78.0625,133,4
Pakistan,211,222.621,7.38389,0.393365,235.517,7.54976,0.336493,602,Azhar Ali,0,0,0,0,0,0,0,0,4,11,15,4,11,15,0,237,0,0,1,3.83333,0.3,38.5333,73.6775,30,4
Pakistan,211,222.621,7.38389,0.393365,235.517,7.54976,0.336493,602,Asad Shafiq,0,0,0,0,0,0,0,0,4,11,15,4,11,15,0,237,0,0,1,2.07843,0.176471,24.7843,67.1269,51,4
England,221,237.176,7.17647,0.289593,230.633,7.45701,0.384615,602,AN Cook,0,0,0,0,0,0,0,0,12,8,20,12,8,20,238,241,1,0,1,4.17045,0.272727,35.75,75.5524,88,4
England,221,237.176,7.17647,0.289593,230.633,7.45701,0.384615,602,IJL Trott,0,0,0,0,0,0,0,0,12,8,20,12,8,20,238,241,1,0,1,3.3871,0.403226,43.7903,75.2494,62,4
England,221,237.176,7.17647,0.289593,230.633,7.45701,0.384615,602,KP Pietersen,0,0,0,0,0,0,0,0,12,8,20,12,8,20,238,241,1,0,1,3.69892,0.236559,33.4946,82.2117,93,4
West Indies,176,217.33,7.15909,0.3125,225.278,7.57386,0.380682,603,LMP Simmons,0,0,0,0,0,0,0,0,0,10,10,0,10,10,0,298,1,0,1,3.3125,0.28125,30.5938,71.4338,64,4
West Indies,176,217.33,7.15909,0.3125,225.278,7.57386,0.380682,603,AB Barath,0,0,0,0,0,0,0,0,0,10,10,0,10,10,0,298,1,0,1,2.76923,0.0769231,21.6154,56.4257,13,3
Bangladesh,160,218.438,7.70625,0.4,211.106,7.05,0.325,603,Tamim Iqbal,0,0,0,0,0,0,0,0,8,8,16,8,8,16,299,258,7,1,1,4.05344,0.274809,31.8015,76.8068,131,4
Bangladesh,160,218.438,7.70625,0.4,211.106,7.05,0.325,603,Naeem Islam,0,0,0,0,0,0,0,0,8,8,16,8,8,16,299,258,7,1,1,1.88889,0.111111,18.6889,67.496,45,1
West Indies,176,217.33,7.15909,0.3125,225.278,7.57386,0.380682,604,DP Hyatt,0,0,0,0,0,0,0,0,0,7,7,0,7,7,0,61,1,0,1,1.55556,0,12.4444,59.2593,9,3
West Indies,176,217.33,7.15909,0.3125,225.278,7.57386,0.380682,604,KOA Powell,0,0,0,0,0,0,0,0,0,7,7,0,7,7,0,61,1,0,1,3.59259,0.222222,26.4815,80.6088,27,4
Bangladesh,160,218.438,7.70625,0.4,211.106,7.05,0.325,604,Tamim Iqbal,0,0,0,0,0,0,0,0,6,16,22,6,16,22,62,62,3,1,1,4.05344,0.274809,31.8015,76.8068,131,4
Bangladesh,160,218.438,7.70625,0.4,211.106,7.05,0.325,604,Imrul Kayes,0,0,0,0,0,0,0,0,6,16,22,6,16,22,62,62,3,1,1,3,0.207547,26.2642,63.6488,53,4
England,221,237.176,7.17647,0.289593,230.633,7.45701,0.384615,605,AN Cook,0,0,0,0,0,0,0,0,4,8,12,4,8,12,0,288,4,1,1,4.17045,0.272727,35.75,75.5524,88,4
England,221,237.176,7.17647,0.289593,230.633,7.45701,0.384615,605,IJL Trott,0,0,0,0,0,0,0,0,4,8,12,4,8,12,0,288,4,1,1,3.3871,0.403226,43.7903,75.2494,62,4
England,221,237.176,7.17647,0.289593,230.633,7.45701,0.384615,605,IR Bell,0,0,0,0,0,0,0,0,4,8,12,4,8,12,0,288,4,1,1,3.63433,0.246269,35.3806,75.6623,134,4
West Indies,176,217.33,7.15909,0.3125,225.278,7.57386,0.380682,605,LMP Simmons,0,0,0,0,0,0,0,0,12,12,24,12,12,24,289,172,1,0,1,3.3125,0.28125,30.5938,71.4338,64,4
West Indies,176,217.33,7.15909,0.3125,225.278,7.57386,0.380682,605,DR Smith,0,0,0,0,0,0,0,0,12,12,24,12,12,24,289,172,1,0,1,2.5,0.12,17.96,84.5574,50,1
West Indies,176,217.33,7.15909,0.3125,225.278,7.57386,0.380682,605,D Ramdin,0,0,0,0,0,0,0,0,12,12,24,12,12,24,289,172,1,0,1,1.7439,0.097561,19.1951,81.1759,82,1
West Indies,176,217.33,7.15909,0.3125,225.278,7.57386,0.380682,606,LMP Simmons,0,0,0,0,0,0,0,0,4,4,8,4,4,8,0,238,0,0,1,3.3125,0.28125,30.5938,71.4338,64,4
West Indies,176,217.33,7.15909,0.3125,225.278,7.57386,0.380682,606,CH Gayle,0,0,0,0,0,0,0,0,4,4,8,4,4,8,0,238,0,0,1,4.58621,0.206897,31.1293,89.4255,116,4
England,221,237.176,7.17647,0.289593,230.633,7.45701,0.384615,606,AN Cook,0,0,0,0,0,0,0,0,16,5,21,16,5,21,239,239,2,1,1,4.17045,0.272727,35.75,75.5524,88,4
England,221,237.176,7.17647,0.289593,230.633,7.45701,0.384615,606,IR Bell,0,0,0,0,0,0,0,0,16,5,21,16,5,21,239,239,2,1,1,3.63433,0.246269,35.3806,75.6623,134,4
England,221,237.176,7.17647,0.289593,230.633,7.45701,0.384615,607,AN Cook,0,0,0,0,0,0,0,0,0,7,7,0,7,7,0,272,4,1,1,4.17045,0.272727,35.75,75.5524,88,4
England,221,237.176,7.17647,0.289593,230.633,7.45701,0.384615,607,IR Bell,0,0,0,0,0,0,0,0,0,7,7,0,7,7,0,272,4,1,1,3.63433,0.246269,35.3806,75.6623,134,4
Australia,228,239.627,7.69737,0.372807,232.079,7.23246,0.337719,607,SR Watson,0,0,0,0,0,0,0,0,0,14,14,0,14,14,273,257,1,0,1,4.71318,0.286822,37.7907,90.0943,129,4
Australia,228,239.627,7.69737,0.372807,232.079,7.23246,0.337719,607,DA Warner,0,0,0,0,0,0,0,0,0,14,14,0,14,14,273,257,1,0,1,4.20312,0.265625,35.2031,87.7336,64,4
Australia,228,239.627,7.69737,0.372807,232.079,7.23246,0.337719,608,SR Watson,0,0,0,0,0,0,0,0,8,6,14,8,6,14,0,251,2,0,1,4.71318,0.286822,37.7907,90.0943,129,4
Australia,228,239.627,7.69737,0.372807,232.079,7.23246,0.337719,608,DA Warner,0,0,0,0,0,0,0,0,8,6,14,8,6,14,0,251,2,0,1,4.20312,0.265625,35.2031,87.7336,64,4
Australia,228,239.627,7.69737,0.372807,232.079,7.23246,0.337719,608,PJ Forrest,0,0,0,0,0,0,0,0,8,6,14,8,6,14,0,251,2,0,1,2.71429,0.285714,26.2143,63.6049,14,4
England,221,237.176,7.17647,0.289593,230.633,7.45701,0.384615,608,AN Cook,0,0,0,0,0,0,0,0,12,13,25,12,13,25,252,252,8,1,1,4.17045,0.272727,35.75,75.5524,88,4
England,221,237.176,7.17647,0.289593,230.633,7.45701,0.384615,608,IR Bell,0,0,0,0,0,0,0,0,12,13,25,12,13,25,252,252,8,1,1,3.63433,0.246269,35.3806,75.6623,134,4
Australia,228,239.627,7.69737,0.372807,232.079,7.23246,0.337719,609,SR Watson,0,0,0,0,0,0,0,0,0,6,6,0,6,6,0,200,0,0,1,4.71318,0.286822,37.7907,90.0943,129,4
Australia,228,239.627,7.69737,0.372807,232.079,7.23246,0.337719,609,DA Warner,0,0,0,0,0,0,0,0,0,6,6,0,6,6,0,200,0,0,1,4.20312,0.265625,35.2031,87.7336,64,4
England,221,237.176,7.17647,0.289593,230.633,7.45701,0.384615,609,AN Cook,0,0,0,0,0,0,0,0,12,9,21,12,9,21,201,201,1,1,1,4.17045,0.272727,35.75,75.5524,88,4
England,221,237.176,7.17647,0.289593,230.633,7.45701,0.384615,609,IR Bell,0,0,0,0,0,0,0,0,12,9,21,12,9,21,201,201,1,1,1,3.63433,0.246269,35.3806,75.6623,134,4
Australia,228,239.627,7.69737,0.372807,232.079,7.23246,0.337719,610,MS Wade,0,0,0,0,0,0,0,0,4,4,8,4,4,8,0,145,1,0,1,1.86275,0.117647,20.3333,78.2642,51,1
Australia,228,239.627,7.69737,0.372807,232.079,7.23246,0.337719,610,DA Warner,0,0,0,0,0,0,0,0,4,4,8,4,4,8,0,145,1,0,1,4.20312,0.265625,35.2031,87.7336,64,4
England,221,237.176,7.17647,0.289593,230.633,7.45701,0.384615,610,AN Cook,0,0,0,0,0,0,0,0,8,11,19,8,11,19,146,138,1,1,1,4.17045,0.272727,35.75,75.5524,88,4
England,221,237.176,7.17647,0.289593,230.633,7.45701,0.384615,610,IR Bell,0,0,0,0,0,0,0,0,8,11,19,8,11,19,146,138,1,1,1,3.63433,0.246269,35.3806,75.6623,134,4
England,221,237.176,7.17647,0.289593,230.633,7.45701,0.384615,610,IJL Trott,0,0,0,0,0,0,0,0,8,11,19,8,11,19,146,138,1,1,1,3.3871,0.403226,43.7903,75.2494,62,4
South Africa,190,234.274,7.4,0.373684,232.363,7.33158,0.342105,611,GC Smith,0,0,0,0,0,0,0,0,0,11,11,0,11,11,0,287,0,0,1,3.97,0.29,33.57,79.6819,100,4
South Africa,190,234.274,7.4,0.373684,232.363,7.33158,0.342105,611,HM Amla,0,0,0,0,0,0,0,0,0,11,11,0,11,11,0,287,0,0,1,5.20168,0.403361,48.7899,86.9292,119,4
England,221,237.176,7.17647,0.289593,230.633,7.45701,0.384615,611,AN Cook,0,0,0,0,0,0,0,0,16,12,28,16,12,28,288,207,1,1,1,4.17045,0.272727,35.75,75.5524,88,4
England,221,237.176,7.17647,0.289593,230.633,7.45701,0.384615,611,IJL Trott,0,0,0,0,0,0,0,0,16,12,28,16,12,28,288,207,1,1,1,3.3871,0.403226,43.7903,75.2494,62,4
England,221,237.176,7.17647,0.289593,230.633,7.45701,0.384615,611,IR Bell,0,0,0,0,0,0,0,0,16,12,28,16,12,28,288,207,1,1,1,3.63433,0.246269,35.3806,75.6623,134,4
South Africa,190,234.274,7.4,0.373684,232.363,7.33158,0.342105,612,HM Amla,0,0,0,0,0,0,0,0,16,13,29,16,13,29,0,211,1,0,1,5.20168,0.403361,48.7899,86.9292,119,4
South Africa,190,234.274,7.4,0.373684,232.363,7.33158,0.342105,612,GC Smith,0,0,0,0,0,0,0,0,16,13,29,16,13,29,0,211,1,0,1,3.97,0.29,33.57,79.6819,100,4
England,221,237.176,7.17647,0.289593,230.633,7.45701,0.384615,612,AN Cook,0,0,0,0,0,0,0,0,12,3,15,12,3,15,212,212,2,1,1,4.17045,0.272727,35.75,75.5524,88,4
England,221,237.176,7.17647,0.289593,230.633,7.45701,0.384615,612,IR Bell,0,0,0,0,0,0,0,0,12,3,15,12,3,15,212,212,2,1,1,3.63433,0.246269,35.3806,75.6623,134,4
England,221,237.176,7.17647,0.289593,230.633,7.45701,0.384615,612,IJL Trott,0,0,0,0,0,0,0,0,12,3,15,12,3,15,212,212,2,1,1,3.3871,0.403226,43.7903,75.2494,62,4
England,221,237.176,7.17647,0.289593,230.633,7.45701,0.384615,613,AN Cook,0,0,0,0,0,0,0,0,20,3,23,20,3,23,0,182,1,1,1,4.17045,0.272727,35.75,75.5524,88,4
England,221,237.176,7.17647,0.289593,230.633,7.45701,0.384615,613,IR Bell,0,0,0,0,0,0,0,0,20,3,23,20,3,23,0,182,1,1,1,3.63433,0.246269,35.3806,75.6623,134,4
England,221,237.176,7.17647,0.289593,230.633,7.45701,0.384615,613,RS Bopara,0,0,0,0,0,0,0,0,20,3,23,20,3,23,0,182,1,1,1,2.22115,0.144231,25.1538,75.9361,104,4
England,221,237.176,7.17647,0.289593,230.633,7.45701,0.384615,613,JM Bairstow,0,0,0,0,0,0,0,0,20,3,23,20,3,23,0,182,1,1,1,3,0.1,25.9,91.1972,10,0
South Africa,190,234.274,7.4,0.373684,232.363,7.33158,0.342105,613,HM Amla,0,0,0,0,0,0,0,0,4,9,13,4,9,13,183,186,1,0,1,5.20168,0.403361,48.7899,86.9292,119,4
South Africa,190,234.274,7.4,0.373684,232.363,7.33158,0.342105,613,GC Smith,0,0,0,0,0,0,0,0,4,9,13,4,9,13,183,186,1,0,1,3.97,0.29,33.57,79.6819,100,4
South Africa,190,234.274,7.4,0.373684,232.363,7.33158,0.342105,613,F du Plessis,0,0,0,0,0,0,0,0,4,9,13,4,9,13,183,186,1,0,1,3.45122,0.292683,34.9268,83.135,82,4
South Africa,190,234.274,7.4,0.373684,232.363,7.33158,0.342105,613,D Elgar,0,0,0,0,0,0,0,0,4,9,13,4,9,13,183,186,1,0,1,1,0,19.6,60.4938,5,1
South Africa,190,234.274,7.4,0.373684,232.363,7.33158,0.342105,613,AB de Villiers,0,0,0,0,0,0,0,0,4,9,13,4,9,13,183,186,1,0,1,5.04969,0.403727,47.2174,98.8428,161,4
Pakistan,211,222.621,7.38389,0.393365,235.517,7.54976,0.336493,614,Mohammad Hafeez,0,0,0,0,0,0,0,0,8,5,13,8,5,13,0,262,1,0,1,4.04511,0.255639,34.3534,78.0625,133,4
Pakistan,211,222.621,7.38389,0.393365,235.517,7.54976,0.336493,614,Nasir Jamshed,0,0,0,0,0,0,0,0,8,5,13,8,5,13,0,262,1,0,1,3.63043,0.23913,30.2174,73.8184,46,4
Bangladesh,160,218.438,7.70625,0.4,211.106,7.05,0.325,614,Tamim Iqbal,0,0,0,0,0,0,0,0,8,5,13,8,5,13,263,241,0,1,1,4.05344,0.274809,31.8015,76.8068,131,4
Bangladesh,160,218.438,7.70625,0.4,211.106,7.05,0.325,614,Nazimuddin,0,0,0,0,0,0,0,0,8,5,13,8,5,13,263,241,0,1,1,2,0,14.5,62.2318,10,1
India,259,242.378,7.15058,0.339768,244.568,7.12741,0.30888,615,G Gambhir,0,0,0,0,0,0,0,0,8,7,15,8,7,15,0,304,2,0,1,3.99145,0.333333,37.4701,84.1944,117,4
India,259,242.378,7.15058,0.339768,244.568,7.12741,0.30888,615,SR Tendulkar,0,0,0,0,0,0,0,0,8,7,15,8,7,15,0,304,2,0,1,5.89773,0.363636,45.6023,84.5376,88,4
Sri Lanka,244,223.373,7.09016,0.344262,227.578,7.47541,0.385246,615,DPMD Jayawardene,0,0,0,0,0,0,0,0,26,5,31,26,5,31,305,254,0,0,1,3.20833,0.244792,31.6979,79.1109,192,4
Sri Lanka,244,223.373,7.09016,0.344262,227.578,7.47541,0.385246,615,TM Dilshan,0,0,0,0,0,0,0,0,26,5,31,26,5,31,305,254,0,0,1,4.60199,0.273632,38.3632,86.0219,201,4
Sri Lanka,244,223.373,7.09016,0.344262,227.578,7.47541,0.385246,615,KC Sangakkara,0,0,0,0,0,0,0,0,26,5,31,26,5,31,305,254,0,0,1,4.33659,0.360976,41.9854,80.6276,205,4
Sri Lanka,244,223.373,7.09016,0.344262,227.578,7.47541,0.385246,616,DPMD Jayawardene,0,0,0,0,0,0,0,0,20,9,29,20,9,29,0,188,4,0,1,3.20833,0.244792,31.6979,79.1109,192,4
Sri Lanka,244,223.373,7.09016,0.344262,227.578,7.47541,0.385246,616,TM Dilshan,0,0,0,0,0,0,0,0,20,9,29,20,9,29,0,188,4,0,1,4.60199,0.273632,38.3632,86.0219,201,4
Pakistan,211,222.621,7.38389,0.393365,235.517,7.54976,0.336493,616,Mohammad Hafeez,0,0,0,0,0,0,0,0,4,7,11,4,7,11,189,189,0,0,1,4.04511,0.255639,34.3534,78.0625,133,4
Pakistan,211,222.621,7.38389,0.393365,235.517,7.54976,0.336493,616,Nasir Jamshed,0,0,0,0,0,0,0,0,4,7,11,4,7,11,189,189,0,0,1,3.63043,0.23913,30.2174,73.8184,46,4
India,259,242.378,7.15058,0.339768,244.568,7.12741,0.30888,617,G Gambhir,0,0,0,0,0,0,0,0,12,5,17,12,5,17,0,289,2,0,1,3.99145,0.333333,37.4701,84.1944,117,4
India,259,242.378,7.15058,0.339768,244.568,7.12741,0.30888,617,SR Tendulkar,0,0,0,0,0,0,0,0,12,5,17,12,5,17,0,289,2,0,1,5.89773,0.363636,45.6023,84.5376,88,4
Bangladesh,160,218.438,7.70625,0.4,211.106,7.05,0.325,617,Tamim Iqbal,0,0,0,0,0,0,0,0,4,11,15,4,11,15,290,293,0,1,1,4.05344,0.274809,31.8015,76.8068,131,4
Bangladesh,160,218.438,7.70625,0.4,211.106,7.05,0.325,617,Nazimuddin,0,0,0,0,0,0,0,0,4,11,15,4,11,15,290,293,0,1,1,2,0,14.5,62.2318,10,1
Bangladesh,160,218.438,7.70625,0.4,211.106,7.05,0.325,617,Jahurul Islam,0,0,0,0,0,0,0,0,4,11,15,4,11,15,290,293,0,1,1,2.18182,0.0909091,20.5455,69.5385,11,1
Pakistan,211,222.621,7.38389,0.393365,235.517,7.54976,0.336493,618,Mohammad Hafeez,0,0,0,0,0,0,0,0,20,6,26,20,6,26,0,329,1,0,1,4.04511,0.255639,34.3534,78.0625,133,4
Pakistan,211,222.621,7.38389,0.393365,235.517,7.54976,0.336493,618,Nasir Jamshed,0,0,0,0,0,0,0,0,20,6,26,20,6,26,0,329,1,0,1,3.63043,0.23913,30.2174,73.8184,46,4
India,259,242.378,7.15058,0.339768,244.568,7.12741,0.30888,618,G Gambhir,0,0,0,0,0,0,0,0,22,10,32,22,10,32,330,330,6,0,1,3.99145,0.333333,37.4701,84.1944,117,4
India,259,242.378,7.15058,0.339768,244.568,7.12741,0.30888,618,V Kohli,0,0,0,0,0,0,0,0,22,10,32,22,10,32,330,330,6,0,1,4.66456,0.379747,44.9937,88.3325,158,4
India,259,242.378,7.15058,0.339768,244.568,7.12741,0.30888,618,SR Tendulkar,0,0,0,0,0,0,0,0,22,10,32,22,10,32,330,330,6,0,1,5.89773,0.363636,45.6023,84.5376,88,4
Sri Lanka,244,223.373,7.09016,0.344262,227.578,7.47541,0.385246,619,DPMD Jayawardene,0,0,0,0,0,0,0,0,12,8,20,12,8,20,0,232,0,0,1,3.20833,0.244792,31.6979,79.1109,192,4
Sri Lanka,244,223.373,7.09016,0.344262,227.578,7.47541,0.385246,619,TM Dilshan,0,0,0,0,0,0,0,0,12,8,20,12,8,20,0,232,0,0,1,4.60199,0.273632,38.3632,86.0219,201,4
Sri Lanka,244,223.373,7.09016,0.344262,227.578,7.47541,0.385246,619,KC Sangakkara,0,0,0,0,0,0,0,0,12,8,20,12,8,20,0,232,0,0,1,4.33659,0.360976,41.9854,80.6276,205,4
Bangladesh,160,218.438,7.70625,0.4,211.106,7.05,0.325,619,Tamim Iqbal,0,0,0,0,0,0,0,0,12,7,19,12,7,19,233,212,6,1,1,4.05344,0.274809,31.8015,76.8068,131,4
Bangladesh,160,218.438,7.70625,0.4,211.106,7.05,0.325,619,Nazimuddin,0,0,0,0,0,0,0,0,12,7,19,12,7,19,233,212,6,1,1,2,0,14.5,62.2318,10,1
Bangladesh,160,218.438,7.70625,0.4,211.106,7.05,0.325,619,Jahurul Islam,0,0,0,0,0,0,0,0,12,7,19,12,7,19,233,212,6,1,1,2.18182,0.0909091,20.5455,69.5385,11,1
Pakistan,211,222.621,7.38389,0.393365,235.517,7.54976,0.336493,620,Mohammad Hafeez,0,0,0,0,0,0,0,0,12,5,17,12,5,17,0,236,2,0,1,4.04511,0.255639,34.3534,78.0625,133,4
Pakistan,211,222.621,7.38389,0.393365,235.517,7.54976,0.336493,620,Nasir Jamshed,0,0,0,0,0,0,0,0,12,5,17,12,5,17,0,236,2,0,1,3.63043,0.23913,30.2174,73.8184,46,4
Pakistan,211,222.621,7.38389,0.393365,235.517,7.54976,0.336493,620,Younis Khan,0,0,0,0,0,0,0,0,12,5,17,12,5,17,0,236,2,0,1,2.64655,0.215517,28.5,73.2713,116,4
Bangladesh,160,218.438,7.70625,0.4,211.106,7.05,0.325,620,Tamim Iqbal,0,0,0,0,0,0,0,0,8,6,14,8,6,14,237,234,0,1,1,4.05344,0.274809,31.8015,76.8068,131,4
Bangladesh,160,218.438,7.70625,0.4,211.106,7.05,0.325,620,Nazimuddin,0,0,0,0,0,0,0,0,8,6,14,8,6,14,237,234,0,1,1,2,0,14.5,62.2318,10,1
West Indies,176,217.33,7.15909,0.3125,225.278,7.57386,0.380682,621,LMP Simmons,0,0,0,0,0,0,0,0,12,6,18,12,6,18,0,211,1,0,1,3.3125,0.28125,30.5938,71.4338,64,4
West Indies,176,217.33,7.15909,0.3125,225.278,7.57386,0.380682,621,AB Barath,0,0,0,0,0,0,0,0,12,6,18,12,6,18,0,211,1,0,1,2.76923,0.0769231,21.6154,56.4257,13,3
West Indies,176,217.33,7.15909,0.3125,225.278,7.57386,0.380682,621,MN Samuels,0,0,0,0,0,0,0,0,12,6,18,12,6,18,0,211,1,0,1,3.74757,0.23301,31.6214,74.5821,103,4
India,259,242.378,7.15058,0.339768,244.568,7.12741,0.30888,621,PA Patel,0,0,0,0,0,0,0,0,24,10,34,24,10,34,212,213,8,1,1,2.65217,0.130435,22.1304,79.4072,23,4
India,259,242.378,7.15058,0.339768,244.568,7.12741,0.30888,621,V Sehwag,0,0,0,0,0,0,0,0,24,10,34,24,10,34,212,213,8,1,1,5.88636,0.238636,38.8295,108.649,88,0
India,259,242.378,7.15058,0.339768,244.568,7.12741,0.30888,621,G Gambhir,0,0,0,0,0,0,0,0,24,10,34,24,10,34,212,213,8,1,1,3.99145,0.333333,37.4701,84.1944,117,4
India,259,242.378,7.15058,0.339768,244.568,7.12741,0.30888,621,V Kohli,0,0,0,0,0,0,0,0,24,10,34,24,10,34,212,213,8,1,1,4.66456,0.379747,44.9937,88.3325,158,4
West Indies,176,217.33,7.15909,0.3125,225.278,7.57386,0.380682,622,LMP Simmons,0,0,0,0,0,0,0,0,4,3,7,4,3,7,0,260,0,0,1,3.3125,0.28125,30.5938,71.4338,64,4
West Indies,176,217.33,7.15909,0.3125,225.278,7.57386,0.380682,622,DP Hyatt,0,0,0,0,0,0,0,0,4,3,7,4,3,7,0,260,0,0,1,1.55556,0,12.4444,59.2593,9,3
West Indies,176,217.33,7.15909,0.3125,225.278,7.57386,0.380682,622,MN Samuels,0,0,0,0,0,0,0,0,4,3,7,4,3,7,0,260,0,0,1,3.74757,0.23301,31.6214,74.5821,103,4
India,259,242.378,7.15058,0.339768,244.568,7.12741,0.30888,622,PA Patel,0,0,0,0,0,0,0,0,20,4,24,20,4,24,261,244,0,1,1,2.65217,0.130435,22.1304,79.4072,23,4
India,259,242.378,7.15058,0.339768,244.568,7.12741,0.30888,622,V Sehwag,0,0,0,0,0,0,0,0,20,4,24,20,4,24,261,244,0,1,1,5.88636,0.238636,38.8295,108.649,88,0
India,259,242.378,7.15058,0.339768,244.568,7.12741,0.30888,622,G Gambhir,0,0,0,0,0,0,0,0,20,4,24,20,4,24,261,244,0,1,1,3.99145,0.333333,37.4701,84.1944,117,4
India,259,242.378,7.15058,0.339768,244.568,7.12741,0.30888,622,V Kohli,0,0,0,0,0,0,0,0,20,4,24,20,4,24,261,244,0,1,1,4.66456,0.379747,44.9937,88.3325,158,4
India,259,242.378,7.15058,0.339768,244.568,7.12741,0.30888,623,G Gambhir,0,0,0,0,0,0,0,0,22,8,30,22,8,30,0,418,0,1,1,3.99145,0.333333,37.4701,84.1944,117,4
India,259,242.378,7.15058,0.339768,244.568,7.12741,0.30888,623,V Sehwag,0,0,0,0,0,0,0,0,22,8,30,22,8,30,0,418,0,1,1,5.88636,0.238636,38.8295,108.649,88,0
West Indies,176,217.33,7.15909,0.3125,225.278,7.57386,0.380682,623,LMP Simmons,0,0,0,0,0,0,0,0,30,8,38,30,8,38,419,265,0,0,1,3.3125,0.28125,30.5938,71.4338,64,4
West Indies,176,217.33,7.15909,0.3125,225.278,7.57386,0.380682,623,KOA Powell,0,0,0,0,0,0,0,0,30,8,38,30,8,38,419,265,0,0,1,3.59259,0.222222,26.4815,80.6088,27,4
West Indies,176,217.33,7.15909,0.3125,225.278,7.57386,0.380682,623,MN Samuels,0,0,0,0,0,0,0,0,30,8,38,30,8,38,419,265,0,0,1,3.74757,0.23301,31.6214,74.5821,103,4
India,259,242.378,7.15058,0.339768,244.568,7.12741,0.30888,624,G Gambhir,0,0,0,0,0,0,0,0,4,14,18,4,14,18,0,267,1,1,1,3.99145,0.333333,37.4701,84.1944,117,4
India,259,242.378,7.15058,0.339768,244.568,7.12741,0.30888,624,AM Rahane,0,0,0,0,0,0,0,0,4,14,18,4,14,18,0,267,1,1,1,3.55738,0.262295,32.2295,78.0159,61,4
India,259,242.378,7.15058,0.339768,244.568,7.12741,0.30888,624,PA Patel,0,0,0,0,0,0,0,0,4,14,18,4,14,18,0,267,1,1,1,2.65217,0.130435,22.1304,79.4072,23,4
India,259,242.378,7.15058,0.339768,244.568,7.12741,0.30888,624,MK Tiwary,0,0,0,0,0,0,0,0,4,14,18,4,14,18,0,267,1,1,1,2.7,0.2,28.2,72.3077,10,4
West Indies,176,217.33,7.15909,0.3125,225.278,7.57386,0.380682,624,LMP Simmons,0,0,0,0,0,0,0,0,16,6,22,16,6,22,268,233,7,0,1,3.3125,0.28125,30.5938,71.4338,64,4
West Indies,176,217.33,7.15909,0.3125,225.278,7.57386,0.380682,624,MN Samuels,0,0,0,0,0,0,0,0,16,6,22,16,6,22,268,233,7,0,1,3.74757,0.23301,31.6214,74.5821,103,4
West Indies,176,217.33,7.15909,0.3125,225.278,7.57386,0.380682,624,KOA Powell,0,0,0,0,0,0,0,0,16,6,22,16,6,22,268,233,7,0,1,3.59259,0.222222,26.4815,80.6088,27,4
Bangladesh,160,218.438,7.70625,0.4,211.106,7.05,0.325,625,Tamim Iqbal,0,0,0,0,0,0,0,0,0,1,1,0,1,1,0,91,1,1,1,4.05344,0.274809,31.8015,76.8068,131,4
Bangladesh,160,218.438,7.70625,0.4,211.106,7.05,0.325,625,Naeem Islam,0,0,0,0,0,0,0,0,0,1,1,0,1,1,0,91,1,1,1,1.88889,0.111111,18.6889,67.496,45,1
Bangladesh,160,218.438,7.70625,0.4,211.106,7.05,0.325,625,Shahriar Nafees,0,0,0,0,0,0,0,0,0,1,1,0,1,1,0,91,1,1,1,3.40541,0.162162,24.4865,69.1076,37,4
Pakistan,211,222.621,7.38389,0.393365,235.517,7.54976,0.336493,625,Mohammad Hafeez,0,0,0,0,0,0,0,0,16,2,18,16,2,18,92,93,2,0,1,4.04511,0.255639,34.3534,78.0625,133,4
Pakistan,211,222.621,7.38389,0.393365,235.517,7.54976,0.336493,625,Imran Farhat,0,0,0,0,0,0,0,0,16,2,18,16,2,18,92,93,2,0,1,3.03333,0.266667,27.0333,62.9658,30,4
Pakistan,211,222.621,7.38389,0.393365,235.517,7.54976,0.336493,626,Mohammad Hafeez,0,0,0,0,0,0,0,0,12,1,13,12,1,13,0,262,5,0,1,4.04511,0.255639,34.3534,78.0625,133,4
Pakistan,211,222.621,7.38389,0.393365,235.517,7.54976,0.336493,626,Imran Farhat,0,0,0,0,0,0,0,0,12,1,13,12,1,13,0,262,5,0,1,3.03333,0.266667,27.0333,62.9658,30,4
Pakistan,211,222.621,7.38389,0.393365,235.517,7.54976,0.336493,626,Younis Khan,0,0,0,0,0,0,0,0,12,1,13,12,1,13,0,262,5,0,1,2.64655,0.215517,28.5,73.2713,116,4
Bangladesh,160,218.438,7.70625,0.4,211.106,7.05,0.325,626,Tamim Iqbal,0,0,0,0,0,0,0,0,0,9,9,0,9,9,263,186,1,1,1,4.05344,0.274809,31.8015,76.8068,131,4
Bangladesh,160,218.438,7.70625,0.4,211.106,7.05,0.325,626,Imrul Kayes,0,0,0,0,0,0,0,0,0,9,9,0,9,9,263,186,1,1,1,3,0.207547,26.2642,63.6488,53,4
Bangladesh,160,218.438,7.70625,0.4,211.106,7.05,0.325,626,Shahriar Nafees,0,0,0,0,0,0,0,0,0,9,9,0,9,9,263,186,1,1,1,3.40541,0.162162,24.4865,69.1076,37,4
Pakistan,211,222.621,7.38389,0.393365,235.517,7.54976,0.336493,627,Mohammad Hafeez,0,0,0,0,0,0,0,0,8,5,13,8,5,13,0,177,5,0,1,4.04511,0.255639,34.3534,78.0625,133,4
Pakistan,211,222.621,7.38389,0.393365,235.517,7.54976,0.336493,627,Younis Khan,0,0,0,0,0,0,0,0,8,5,13,8,5,13,0,177,5,0,1,2.64655,0.215517,28.5,73.2713,116,4
Pakistan,211,222.621,7.38389,0.393365,235.517,7.54976,0.336493,627,Asad Shafiq,0,0,0,0,0,0,0,0,8,5,13,8,5,13,0,177,5,0,1,2.07843,0.176471,24.7843,67.1269,51,4
Bangladesh,160,218.438,7.70625,0.4,211.106,7.05,0.325,627,Tamim Iqbal,0,0,0,0,0,0,0,0,4,9,13,4,9,13,178,119,3,1,1,4.05344,0.274809,31.8015,76.8068,131,4
Bangladesh,160,218.438,7.70625,0.4,211.106,7.05,0.325,627,Mahmudullah,0,0,0,0,0,0,0,0,4,9,13,4,9,13,178,119,3,1,1,2.26531,0.153061,24.4286,70.9544,98,4
Bangladesh,160,218.438,7.70625,0.4,211.106,7.05,0.325,627,Shahriar Nafees,0,0,0,0,0,0,0,0,4,9,13,4,9,13,178,119,3,1,1,3.40541,0.162162,24.4865,69.1076,37,4
Australia,228,239.627,7.69737,0.372807,232.079,7.23246,0.337719,628,SR Watson,0,0,0,0,0,0,0,0,16,7,23,16,7,23,0,204,2,0,1,4.71318,0.286822,37.7907,90.0943,129,4
Australia,228,239.627,7.69737,0.372807,232.079,7.23246,0.337719,628,DA Warner,0,0,0,0,0,0,0,0,16,7,23,16,7,23,0,204,2,0,1,4.20312,0.265625,35.2031,87.7336,64,4
West Indies,176,217.33,7.15909,0.3125,225.278,7.57386,0.380682,628,KOA Powell,0,0,0,0,0,0,0,0,16,4,20,16,4,20,205,140,1,1,1,3.59259,0.222222,26.4815,80.6088,27,4
West Indies,176,217.33,7.15909,0.3125,225.278,7.57386,0.380682,628,J Charles,0,0,0,0,0,0,0,0,16,4,20,16,4,20,205,140,1,1,1,3.82353,0.147059,28.2353,81.2183,34,4
West Indies,176,217.33,7.15909,0.3125,225.278,7.57386,0.380682,628,MN Samuels,0,0,0,0,0,0,0,0,16,4,20,16,4,20,205,140,1,1,1,3.74757,0.23301,31.6214,74.5821,103,4
Australia,228,239.627,7.69737,0.372807,232.079,7.23246,0.337719,629,SR Watson,0,0,0,0,0,0,0,0,4,12,16,4,12,16,0,154,0,0,1,4.71318,0.286822,37.7907,90.0943,129,4
Australia,228,239.627,7.69737,0.372807,232.079,7.23246,0.337719,629,DA Warner,0,0,0,0,0,0,0,0,4,12,16,4,12,16,0,154,0,0,1,4.20312,0.265625,35.2031,87.7336,64,4
West Indies,176,217.33,7.15909,0.3125,225.278,7.57386,0.380682,629,KOA Powell,0,0,0,0,0,0,0,0,8,8,16,8,8,16,155,163,0,1,1,3.59259,0.222222,26.4815,80.6088,27,4
West Indies,176,217.33,7.15909,0.3125,225.278,7.57386,0.380682,629,MN Samuels,0,0,0,0,0,0,0,0,8,8,16,8,8,16,155,163,0,1,1,3.74757,0.23301,31.6214,74.5821,103,4
West Indies,176,217.33,7.15909,0.3125,225.278,7.57386,0.380682,629,J Charles,0,0,0,0,0,0,0,0,8,8,16,8,8,16,155,163,0,1,1,3.82353,0.147059,28.2353,81.2183,34,4
Australia,228,239.627,7.69737,0.372807,232.079,7.23246,0.337719,630,SR Watson,0,0,0,0,0,0,0,0,20,13,33,20,13,33,0,220,0,0,1,4.71318,0.286822,37.7907,90.0943,129,4
Australia,228,239.627,7.69737,0.372807,232.079,7.23246,0.337719,630,DA Warner,0,0,0,0,0,0,0,0,20,13,33,20,13,33,0,220,0,0,1,4.20312,0.265625,35.2031,87.7336,64,4
West Indies,176,217.33,7.15909,0.3125,225.278,7.57386,0.380682,630,KOA Powell,0,0,0,0,0,0,0,0,8,10,18,8,10,18,221,220,1,1,1,3.59259,0.222222,26.4815,80.6088,27,4
West Indies,176,217.33,7.15909,0.3125,225.278,7.57386,0.380682,630,J Charles,0,0,0,0,0,0,0,0,8,10,18,8,10,18,221,220,1,1,1,3.82353,0.147059,28.2353,81.2183,34,4
Australia,228,239.627,7.69737,0.372807,232.079,7.23246,0.337719,631,SR Watson,0,0,0,0,0,0,0,0,18,11,29,18,11,29,0,281,1,0,1,4.71318,0.286822,37.7907,90.0943,129,4
Australia,228,239.627,7.69737,0.372807,232.079,7.23246,0.337719,631,DA Warner,0,0,0,0,0,0,0,0,18,11,29,18,11,29,0,281,1,0,1,4.20312,0.265625,35.2031,87.7336,64,4
West Indies,176,217.33,7.15909,0.3125,225.278,7.57386,0.380682,631,J Charles,0,0,0,0,0,0,0,0,4,1,5,4,1,5,282,251,2,1,1,3.82353,0.147059,28.2353,81.2183,34,4
West Indies,176,217.33,7.15909,0.3125,225.278,7.57386,0.380682,631,MN Samuels,0,0,0,0,0,0,0,0,4,1,5,4,1,5,282,251,2,1,1,3.74757,0.23301,31.6214,74.5821,103,4
West Indies,176,217.33,7.15909,0.3125,225.278,7.57386,0.380682,631,AB Barath,0,0,0,0,0,0,0,0,4,1,5,4,1,5,282,251,2,1,1,2.76923,0.0769231,21.6154,56.4257,13,3
West Indies,176,217.33,7.15909,0.3125,225.278,7.57386,0.380682,631,DM Bravo,0,0,0,0,0,0,0,0,4,1,5,4,1,5,282,251,2,1,1,3,0.226667,28.52,67.4551,75,4
New Zealand,184,233.745,7.39674,0.36413,227.951,7.30435,0.353261,637,RJ Nicol,0,0,0,0,0,0,0,0,4,8,12,4,8,12,0,190,3,0,1,3.3,0.2,29.25,73.4003,20,4
New Zealand,184,233.745,7.39674,0.36413,227.951,7.30435,0.353261,637,MJ Guptill,0,0,0,0,0,0,0,0,4,8,12,4,8,12,0,190,3,0,1,4.8087,0.313043,38.1217,82.7482,115,4
New Zealand,184,233.745,7.39674,0.36413,227.951,7.30435,0.353261,637,DR Flynn,0,0,0,0,0,0,0,0,4,8,12,4,8,12,0,190,3,0,1,2,0,16.7,67.6113,10,1
West Indies,176,217.33,7.15909,0.3125,225.278,7.57386,0.380682,637,LMP Simmons,0,0,0,0,0,0,0,0,4,4,8,4,4,8,191,136,6,1,1,3.3125,0.28125,30.5938,71.4338,64,4
West Indies,176,217.33,7.15909,0.3125,225.278,7.57386,0.380682,637,CH Gayle,0,0,0,0,0,0,0,0,4,4,8,4,4,8,191,136,6,1,1,4.58621,0.206897,31.1293,89.4255,116,4
West Indies,176,217.33,7.15909,0.3125,225.278,7.57386,0.380682,637,DR Smith,0,0,0,0,0,0,0,0,4,4,8,4,4,8,191,136,6,1,1,2.5,0.12,17.96,84.5574,50,1
West Indies,176,217.33,7.15909,0.3125,225.278,7.57386,0.380682,638,LMP Simmons,0,0,0,0,0,0,0,0,18,5,23,18,5,23,0,315,5,1,1,3.3125,0.28125,30.5938,71.4338,64,4
West Indies,176,217.33,7.15909,0.3125,225.278,7.57386,0.380682,638,CH Gayle,0,0,0,0,0,0,0,0,18,5,23,18,5,23,0,315,5,1,1,4.58621,0.206897,31.1293,89.4255,116,4
West Indies,176,217.33,7.15909,0.3125,225.278,7.57386,0.380682,638,DR Smith,0,0,0,0,0,0,0,0,18,5,23,18,5,23,0,315,5,1,1,2.5,0.12,17.96,84.5574,50,1
New Zealand,184,233.745,7.39674,0.36413,227.951,7.30435,0.353261,638,RJ Nicol,0,0,0,0,0,0,0,0,12,7,19,12,7,19,316,260,1,0,1,3.3,0.2,29.25,73.4003,20,4
New Zealand,184,233.745,7.39674,0.36413,227.951,7.30435,0.353261,638,MJ Guptill,0,0,0,0,0,0,0,0,12,7,19,12,7,19,316,260,1,0,1,4.8087,0.313043,38.1217,82.7482,115,4
New Zealand,184,233.745,7.39674,0.36413,227.951,7.30435,0.353261,639,RJ Nicol,0,0,0,0,0,0,0,0,18,6,24,18,6,24,0,249,0,0,1,3.3,0.2,29.25,73.4003,20,4
New Zealand,184,233.745,7.39674,0.36413,227.951,7.30435,0.353261,639,MJ Guptill,0,0,0,0,0,0,0,0,18,6,24,18,6,24,0,249,0,0,1,4.8087,0.313043,38.1217,82.7482,115,4
West Indies,176,217.33,7.15909,0.3125,225.278,7.57386,0.380682,639,J Charles,0,0,0,0,0,0,0,0,16,6,22,16,6,22,250,161,0,1,1,3.82353,0.147059,28.2353,81.2183,34,4
West Indies,176,217.33,7.15909,0.3125,225.278,7.57386,0.380682,639,CH Gayle,0,0,0,0,0,0,0,0,16,6,22,16,6,22,250,161,0,1,1,4.58621,0.206897,31.1293,89.4255,116,4
West Indies,176,217.33,7.15909,0.3125,225.278,7.57386,0.380682,639,DR Smith,0,0,0,0,0,0,0,0,16,6,22,16,6,22,250,161,0,1,1,2.5,0.12,17.96,84.5574,50,1
West Indies,176,217.33,7.15909,0.3125,225.278,7.57386,0.380682,640,J Charles,0,0,0,0,0,0,0,0,14,6,20,14,6,20,0,241,4,1,1,3.82353,0.147059,28.2353,81.2183,34,4
West Indies,176,217.33,7.15909,0.3125,225.278,7.57386,0.380682,640,CH Gayle,0,0,0,0,0,0,0,0,14,6,20,14,6,20,0,241,4,1,1,4.58621,0.206897,31.1293,89.4255,116,4
West Indies,176,217.33,7.15909,0.3125,225.278,7.57386,0.380682,640,DR Smith,0,0,0,0,0,0,0,0,14,6,20,14,6,20,0,241,4,1,1,2.5,0.12,17.96,84.5574,50,1
New Zealand,184,233.745,7.39674,0.36413,227.951,7.30435,0.353261,640,RJ Nicol,0,0,0,0,0,0,0,0,22,8,30,22,8,30,242,221,1,0,1,3.3,0.2,29.25,73.4003,20,4
New Zealand,184,233.745,7.39674,0.36413,227.951,7.30435,0.353261,640,BB McCullum,0,0,0,0,0,0,0,0,22,8,30,22,8,30,242,221,1,0,1,3.98611,0.201389,29.9028,98.4004,144,0
New Zealand,184,233.745,7.39674,0.36413,227.951,7.30435,0.353261,640,MJ Guptill,0,0,0,0,0,0,0,0,22,8,30,22,8,30,242,221,1,0,1,4.8087,0.313043,38.1217,82.7482,115,4
Sri Lanka,244,223.373,7.09016,0.344262,227.578,7.47541,0.385246,641,DPMD Jayawardene,0,0,0,0,0,0,0,0,0,7,7,0,7,7,0,135,1,1,1,3.20833,0.244792,31.6979,79.1109,192,4
Sri Lanka,244,223.373,7.09016,0.344262,227.578,7.47541,0.385246,641,TM Dilshan,0,0,0,0,0,0,0,0,0,7,7,0,7,7,0,135,1,1,1,4.60199,0.273632,38.3632,86.0219,201,4
Sri Lanka,244,223.373,7.09016,0.344262,227.578,7.47541,0.385246,641,KC Sangakkara,0,0,0,0,0,0,0,0,0,7,7,0,7,7,0,135,1,1,1,4.33659,0.360976,41.9854,80.6276,205,4
Pakistan,211,222.621,7.38389,0.393365,235.517,7.54976,0.336493,641,Mohammad Hafeez,0,0,0,0,0,0,0,0,12,3,15,12,3,15,136,135,2,0,1,4.04511,0.255639,34.3534,78.0625,133,4
Pakistan,211,222.621,7.38389,0.393365,235.517,7.54976,0.336493,641,Azhar Ali,0,0,0,0,0,0,0,0,12,3,15,12,3,15,136,135,2,0,1,3.83333,0.3,38.5333,73.6775,30,4
Pakistan,211,222.621,7.38389,0.393365,235.517,7.54976,0.336493,641,Younis Khan,0,0,0,0,0,0,0,0,12,3,15,12,3,15,136,135,2,0,1,2.64655,0.215517,28.5,73.2713,116,4
Sri Lanka,244,223.373,7.09016,0.344262,227.578,7.47541,0.385246,642,WU Tharanga,0,0,0,0,0,0,0,0,16,7,23,16,7,23,0,280,2,1,1,3.93985,0.263158,32.9699,71.6035,133,4
Sri Lanka,244,223.373,7.09016,0.344262,227.578,7.47541,0.385246,642,TM Dilshan,0,0,0,0,0,0,0,0,16,7,23,16,7,23,0,280,2,1,1,4.60199,0.273632,38.3632,86.0219,201,4
Pakistan,211,222.621,7.38389,0.393365,235.517,7.54976,0.336493,642,Mohammad Hafeez,0,0,0,0,0,0,0,0,20,6,26,20,6,26,281,204,0,0,1,4.04511,0.255639,34.3534,78.0625,133,4
Pakistan,211,222.621,7.38389,0.393365,235.517,7.54976,0.336493,642,Azhar Ali,0,0,0,0,0,0,0,0,20,6,26,20,6,26,281,204,0,0,1,3.83333,0.3,38.5333,73.6775,30,4
Sri Lanka,244,223.373,7.09016,0.344262,227.578,7.47541,0.385246,643,WU Tharanga,0,0,0,0,0,0,0,0,8,9,17,8,9,17,0,243,6,1,1,3.93985,0.263158,32.9699,71.6035,133,4
Sri Lanka,244,223.373,7.09016,0.344262,227.578,7.47541,0.385246,643,TM Dilshan,0,0,0,0,0,0,0,0,8,9,17,8,9,17,0,243,6,1,1,4.60199,0.273632,38.3632,86.0219,201,4
Sri Lanka,244,223.373,7.09016,0.344262,227.578,7.47541,0.385246,643,KC Sangakkara,0,0,0,0,0,0,0,0,8,9,17,8,9,17,0,243,6,1,1,4.33659,0.360976,41.9854,80.6276,205,4
Pakistan,211,222.621,7.38389,0.393365,235.517,7.54976,0.336493,643,Mohammad Hafeez,0,0,0,0,0,0,0,0,8,5,13,8,5,13,244,199,4,0,1,4.04511,0.255639,34.3534,78.0625,133,4
Pakistan,211,222.621,7.38389,0.393365,235.517,7.54976,0.336493,643,Asad Shafiq,0,0,0,0,0,0,0,0,8,5,13,8,5,13,244,199,4,0,1,2.07843,0.176471,24.7843,67.1269,51,4
Pakistan,211,222.621,7.38389,0.393365,235.517,7.54976,0.336493,643,Azhar Ali,0,0,0,0,0,0,0,0,8,5,13,8,5,13,244,199,4,0,1,3.83333,0.3,38.5333,73.6775,30,4
Pakistan,211,222.621,7.38389,0.393365,235.517,7.54976,0.336493,644,Imran Farhat,0,0,0,0,0,0,0,0,8,10,18,8,10,18,0,247,1,0,1,3.03333,0.266667,27.0333,62.9658,30,4
Pakistan,211,222.621,7.38389,0.393365,235.517,7.54976,0.336493,644,Mohammad Hafeez,0,0,0,0,0,0,0,0,8,10,18,8,10,18,0,247,1,0,1,4.04511,0.255639,34.3534,78.0625,133,4
Sri Lanka,244,223.373,7.09016,0.344262,227.578,7.47541,0.385246,644,WU Tharanga,0,0,0,0,0,0,0,0,4,8,12,4,8,12,248,248,6,1,1,3.93985,0.263158,32.9699,71.6035,133,4
Sri Lanka,244,223.373,7.09016,0.344262,227.578,7.47541,0.385246,644,TM Dilshan,0,0,0,0,0,0,0,0,4,8,12,4,8,12,248,248,6,1,1,4.60199,0.273632,38.3632,86.0219,201,4
India,259,242.378,7.15058,0.339768,244.568,7.12741,0.30888,645,G Gambhir,0,0,0,0,0,0,0,0,8,8,16,8,8,16,0,314,2,0,1,3.99145,0.333333,37.4701,84.1944,117,4
India,259,242.378,7.15058,0.339768,244.568,7.12741,0.30888,645,V Sehwag,0,0,0,0,0,0,0,0,8,8,16,8,8,16,0,314,2,0,1,5.88636,0.238636,38.8295,108.649,88,0
India,259,242.378,7.15058,0.339768,244.568,7.12741,0.30888,645,V Kohli,0,0,0,0,0,0,0,0,8,8,16,8,8,16,0,314,2,0,1,4.66456,0.379747,44.9937,88.3325,158,4
Sri Lanka,244,223.373,7.09016,0.344262,227.578,7.47541,0.385246,645,WU Tharanga,0,0,0,0,0,0,0,0,8,4,12,8,4,12,315,293,10,1,1,3.93985,0.263158,32.9699,71.6035,133,4
Sri Lanka,244,223.373,7.09016,0.344262,227.578,7.47541,0.385246,645,TM Dilshan,0,0,0,0,0,0,0,0,8,4,12,8,4,12,315,293,10,1,1,4.60199,0.273632,38.3632,86.0219,201,4
Sri Lanka,244,223.373,7.09016,0.344262,227.578,7.47541,0.385246,645,KC Sangakkara,0,0,0,0,0,0,0,0,8,4,12,8,4,12,315,293,10,1,1,4.33659,0.360976,41.9854,80.6276,205,4
India,259,242.378,7.15058,0.339768,244.568,7.12741,0.30888,646,G Gambhir,0,0,0,0,0,0,0,0,16,12,28,16,12,28,0,138,5,0,1,3.99145,0.333333,37.4701,84.1944,117,4
India,259,242.378,7.15058,0.339768,244.568,7.12741,0.30888,646,V Sehwag,0,0,0,0,0,0,0,0,16,12,28,16,12,28,0,138,5,0,1,5.88636,0.238636,38.8295,108.649,88,0
India,259,242.378,7.15058,0.339768,244.568,7.12741,0.30888,646,V Kohli,0,0,0,0,0,0,0,0,16,12,28,16,12,28,0,138,5,0,1,4.66456,0.379747,44.9937,88.3325,158,4
Sri Lanka,244,223.373,7.09016,0.344262,227.578,7.47541,0.385246,646,WU Tharanga,0,0,0,0,0,0,0,0,8,9,17,8,9,17,139,139,7,1,1,3.93985,0.263158,32.9699,71.6035,133,4
Sri Lanka,244,223.373,7.09016,0.344262,227.578,7.47541,0.385246,646,TM Dilshan,0,0,0,0,0,0,0,0,8,9,17,8,9,17,139,139,7,1,1,4.60199,0.273632,38.3632,86.0219,201,4
Sri Lanka,244,223.373,7.09016,0.344262,227.578,7.47541,0.385246,647,WU Tharanga,0,0,0,0,0,0,0,0,4,10,14,4,10,14,0,286,5,1,1,3.93985,0.263158,32.9699,71.6035,133,4
Sri Lanka,244,223.373,7.09016,0.344262,227.578,7.47541,0.385246,647,TM Dilshan,0,0,0,0,0,0,0,0,4,10,14,4,10,14,0,286,5,1,1,4.60199,0.273632,38.3632,86.0219,201,4
Sri Lanka,244,223.373,7.09016,0.344262,227.578,7.47541,0.385246,647,KC Sangakkara,0,0,0,0,0,0,0,0,4,10,14,4,10,14,0,286,5,1,1,4.33659,0.360976,41.9854,80.6276,205,4
Sri Lanka,244,223.373,7.09016,0.344262,227.578,7.47541,0.385246,647,LD Chandimal,0,0,0,0,0,0,0,0,4,10,14,4,10,14,0,286,5,1,1,2.18478,0.184783,25.7391,73.8615,92,4
India,259,242.378,7.15058,0.339768,244.568,7.12741,0.30888,647,G Gambhir,0,0,0,0,0,0,0,0,16,8,24,16,8,24,287,288,4,0,1,3.99145,0.333333,37.4701,84.1944,117,4
India,259,242.378,7.15058,0.339768,244.568,7.12741,0.30888,647,V Sehwag,0,0,0,0,0,0,0,0,16,8,24,16,8,24,287,288,4,0,1,5.88636,0.238636,38.8295,108.649,88,0
India,259,242.378,7.15058,0.339768,244.568,7.12741,0.30888,647,V Kohli,0,0,0,0,0,0,0,0,16,8,24,16,8,24,287,288,4,0,1,4.66456,0.379747,44.9937,88.3325,158,4
Sri Lanka,244,223.373,7.09016,0.344262,227.578,7.47541,0.385246,648,WU Tharanga,0,0,0,0,0,0,0,0,12,6,18,12,6,18,0,251,4,1,1,3.93985,0.263158,32.9699,71.6035,133,4
Sri Lanka,244,223.373,7.09016,0.344262,227.578,7.47541,0.385246,648,TM Dilshan,0,0,0,0,0,0,0,0,12,6,18,12,6,18,0,251,4,1,1,4.60199,0.273632,38.3632,86.0219,201,4
India,259,242.378,7.15058,0.339768,244.568,7.12741,0.30888,648,G Gambhir,0,0,0,0,0,0,0,0,16,7,23,16,7,23,252,255,4,0,1,3.99145,0.333333,37.4701,84.1944,117,4
India,259,242.378,7.15058,0.339768,244.568,7.12741,0.30888,648,V Kohli,0,0,0,0,0,0,0,0,16,7,23,16,7,23,252,255,4,0,1,4.66456,0.379747,44.9937,88.3325,158,4
India,259,242.378,7.15058,0.339768,244.568,7.12741,0.30888,648,V Sehwag,0,0,0,0,0,0,0,0,16,7,23,16,7,23,252,255,4,0,1,5.88636,0.238636,38.8295,108.649,88,0
England,221,237.176,7.17647,0.289593,230.633,7.45701,0.384615,649,AN Cook,0,0,0,0,0,0,0,0,12,9,21,12,9,21,0,325,0,0,1,4.17045,0.272727,35.75,75.5524,88,4
England,221,237.176,7.17647,0.289593,230.633,7.45701,0.384615,649,IR Bell,0,0,0,0,0,0,0,0,12,9,21,12,9,21,0,325,0,0,1,3.63433,0.246269,35.3806,75.6623,134,4
India,259,242.378,7.15058,0.339768,244.568,7.12741,0.30888,649,AM Rahane,0,0,0,0,0,0,0,0,32,6,38,32,6,38,326,316,0,1,1,3.55738,0.262295,32.2295,78.0159,61,4
India,259,242.378,7.15058,0.339768,244.568,7.12741,0.30888,649,G Gambhir,0,0,0,0,0,0,0,0,32,6,38,32,6,38,326,316,0,1,1,3.99145,0.333333,37.4701,84.1944,117,4
India,259,242.378,7.15058,0.339768,244.568,7.12741,0.30888,650,AM Rahane,0,0,0,0,0,0,0,0,4,9,13,4,9,13,0,285,6,1,1,3.55738,0.262295,32.2295,78.0159,61,4
India,259,242.378,7.15058,0.339768,244.568,7.12741,0.30888,650,G Gambhir,0,0,0,0,0,0,0,0,4,9,13,4,9,13,0,285,6,1,1,3.99145,0.333333,37.4701,84.1944,117,4
India,259,242.378,7.15058,0.339768,244.568,7.12741,0.30888,650,Yuvraj Singh,0,0,0,0,0,0,0,0,4,9,13,4,9,13,0,285,6,1,1,4.05833,0.258333,32.525,83.8093,120,4
India,259,242.378,7.15058,0.339768,244.568,7.12741,0.30888,650,V Kohli,0,0,0,0,0,0,0,0,4,9,13,4,9,13,0,285,6,1,1,4.66456,0.379747,44.9937,88.3325,158,4
England,221,237.176,7.17647,0.289593,230.633,7.45701,0.384615,650,AN Cook,0,0,0,0,0,0,0,0,12,7,19,12,7,19,286,158,4,0,1,4.17045,0.272727,35.75,75.5524,88,4
England,221,237.176,7.17647,0.289593,230.633,7.45701,0.384615,650,IR Bell,0,0,0,0,0,0,0,0,12,7,19,12,7,19,286,158,4,0,1,3.63433,0.246269,35.3806,75.6623,134,4
England,221,237.176,7.17647,0.289593,230.633,7.45701,0.384615,650,KP Pietersen,0,0,0,0,0,0,0,0,12,7,19,12,7,19,286,158,4,0,1,3.69892,0.236559,33.4946,82.2117,93,4
England,221,237.176,7.17647,0.289593,230.633,7.45701,0.384615,651,AN Cook,0,0,0,0,0,0,0,0,8,4,12,8,4,12,0,155,1,0,1,4.17045,0.272727,35.75,75.5524,88,4
England,221,237.176,7.17647,0.289593,230.633,7.45701,0.384615,651,IR Bell,0,0,0,0,0,0,0,0,8,4,12,8,4,12,0,155,1,0,1,3.63433,0.246269,35.3806,75.6623,134,4
India,259,242.378,7.15058,0.339768,244.568,7.12741,0.30888,651,G Gambhir,0,0,0,0,0,0,0,0,8,8,16,8,8,16,156,157,3,1,1,3.99145,0.333333,37.4701,84.1944,117,4
India,259,242.378,7.15058,0.339768,244.568,7.12741,0.30888,651,AM Rahane,0,0,0,0,0,0,0,0,8,8,16,8,8,16,156,157,3,1,1,3.55738,0.262295,32.2295,78.0159,61,4
India,259,242.378,7.15058,0.339768,244.568,7.12741,0.30888,651,V Kohli,0,0,0,0,0,0,0,0,8,8,16,8,8,16,156,157,3,1,1,4.66456,0.379747,44.9937,88.3325,158,4
England,221,237.176,7.17647,0.289593,230.633,7.45701,0.384615,652,AN Cook,0,0,0,0,0,0,0,0,4,3,7,4,3,7,0,257,5,0,1,4.17045,0.272727,35.75,75.5524,88,4
England,221,237.176,7.17647,0.289593,230.633,7.45701,0.384615,652,IR Bell,0,0,0,0,0,0,0,0,4,3,7,4,3,7,0,257,5,0,1,3.63433,0.246269,35.3806,75.6623,134,4
India,259,242.378,7.15058,0.339768,244.568,7.12741,0.30888,652,G Gambhir,0,0,0,0,0,0,0,0,16,3,19,16,3,19,258,258,1,1,1,3.99145,0.333333,37.4701,84.1944,117,4
India,259,242.378,7.15058,0.339768,244.568,7.12741,0.30888,652,RG Sharma,0,0,0,0,0,0,0,0,16,3,19,16,3,19,258,258,1,1,1,3.82836,0.268657,35.9179,83.083,134,4
India,259,242.378,7.15058,0.339768,244.568,7.12741,0.30888,653,G Gambhir,0,0,0,0,0,0,0,0,12,1,13,12,1,13,0,226,1,1,1,3.99145,0.333333,37.4701,84.1944,117,4
India,259,242.378,7.15058,0.339768,244.568,7.12741,0.30888,653,RG Sharma,0,0,0,0,0,0,0,0,12,1,13,12,1,13,0,226,1,1,1,3.82836,0.268657,35.9179,83.083,134,4
India,259,242.378,7.15058,0.339768,244.568,7.12741,0.30888,653,V Kohli,0,0,0,0,0,0,0,0,12,1,13,12,1,13,0,226,1,1,1,4.66456,0.379747,44.9937,88.3325,158,4
India,259,242.378,7.15058,0.339768,244.568,7.12741,0.30888,653,Yuvraj Singh,0,0,0,0,0,0,0,0,12,1,13,12,1,13,0,226,1,1,1,4.05833,0.258333,32.525,83.8093,120,4
England,221,237.176,7.17647,0.289593,230.633,7.45701,0.384615,653,AN Cook,0,0,0,0,0,0,0,0,12,2,14,12,2,14,227,227,2,0,1,4.17045,0.272727,35.75,75.5524,88,4
England,221,237.176,7.17647,0.289593,230.633,7.45701,0.384615,653,IR Bell,0,0,0,0,0,0,0,0,12,2,14,12,2,14,227,227,2,0,1,3.63433,0.246269,35.3806,75.6623,134,4
England,221,237.176,7.17647,0.289593,230.633,7.45701,0.384615,654,AN Cook,0,0,0,0,0,0,0,0,12,9,21,12,9,21,0,227,1,1,1,4.17045,0.272727,35.75,75.5524,88,4
England,221,237.176,7.17647,0.289593,230.633,7.45701,0.384615,654,IR Bell,0,0,0,0,0,0,0,0,12,9,21,12,9,21,0,227,1,1,1,3.63433,0.246269,35.3806,75.6623,134,4
New Zealand,184,233.745,7.39674,0.36413,227.951,7.30435,0.353261,654,L Ronchi,0,0,0,0,0,0,0,0,16,5,21,16,5,21,228,231,5,0,1,2.92157,0.0784314,22.1961,115.392,51,0
New Zealand,184,233.745,7.39674,0.36413,227.951,7.30435,0.353261,654,KS Williamson,0,0,0,0,0,0,0,0,16,5,21,16,5,21,228,231,5,0,1,4.31707,0.390244,43.0488,82.8833,82,4
New Zealand,184,233.745,7.39674,0.36413,227.951,7.30435,0.353261,654,LRPL Taylor,0,0,0,0,0,0,0,0,16,5,21,16,5,21,228,231,5,0,1,3.68382,0.301471,36.7206,79.3959,136,4
New Zealand,184,233.745,7.39674,0.36413,227.951,7.30435,0.353261,654,MJ Guptill,0,0,0,0,0,0,0,0,16,5,21,16,5,21,228,231,5,0,1,4.8087,0.313043,38.1217,82.7482,115,4
New Zealand,184,233.745,7.39674,0.36413,227.951,7.30435,0.353261,655,MJ Guptill,0,0,0,0,0,0,0,0,4,8,12,4,8,12,0,359,3,0,1,4.8087,0.313043,38.1217,82.7482,115,4
New Zealand,184,233.745,7.39674,0.36413,227.951,7.30435,0.353261,655,L Ronchi,0,0,0,0,0,0,0,0,4,8,12,4,8,12,0,359,3,0,1,2.92157,0.0784314,22.1961,115.392,51,0
New Zealand,184,233.745,7.39674,0.36413,227.951,7.30435,0.353261,655,KS Williamson,0,0,0,0,0,0,0,0,4,8,12,4,8,12,0,359,3,0,1,4.31707,0.390244,43.0488,82.8833,82,4
England,221,237.176,7.17647,0.289593,230.633,7.45701,0.384615,655,AN Cook,0,0,0,0,0,0,0,0,12,12,24,12,12,24,360,273,2,1,1,4.17045,0.272727,35.75,75.5524,88,4
England,221,237.176,7.17647,0.289593,230.633,7.45701,0.384615,655,IR Bell,0,0,0,0,0,0,0,0,12,12,24,12,12,24,360,273,2,1,1,3.63433,0.246269,35.3806,75.6623,134,4
England,221,237.176,7.17647,0.289593,230.633,7.45701,0.384615,656,AN Cook,0,0,0,0,0,0,0,0,0,3,3,0,3,3,0,287,1,1,1,4.17045,0.272727,35.75,75.5524,88,4
England,221,237.176,7.17647,0.289593,230.633,7.45701,0.384615,656,IR Bell,0,0,0,0,0,0,0,0,0,3,3,0,3,3,0,287,1,1,1,3.63433,0.246269,35.3806,75.6623,134,4
England,221,237.176,7.17647,0.289593,230.633,7.45701,0.384615,656,IJL Trott,0,0,0,0,0,0,0,0,0,3,3,0,3,3,0,287,1,1,1,3.3871,0.403226,43.7903,75.2494,62,4
New Zealand,184,233.745,7.39674,0.36413,227.951,7.30435,0.353261,656,L Ronchi,0,0,0,0,0,0,0,0,20,10,30,20,10,30,288,253,3,0,1,2.92157,0.0784314,22.1961,115.392,51,0
New Zealand,184,233.745,7.39674,0.36413,227.951,7.30435,0.353261,656,MJ Guptill,0,0,0,0,0,0,0,0,20,10,30,20,10,30,288,253,3,0,1,4.8087,0.313043,38.1217,82.7482,115,4
Ireland,55,219.527,7.65455,0.290909,202.727,7.56364,0.4,657,WTS Porterfield,0,0,0,0,0,0,0,0,24,3,27,24,3,27,0,269,6,1,1,2.6,0.142857,24.6857,56.2866,35,3
Ireland,55,219.527,7.65455,0.290909,202.727,7.56364,0.4,657,PR Stirling,0,0,0,0,0,0,0,0,24,3,27,24,3,27,0,269,6,1,1,3.47826,0.173913,24.2174,88.1329,23,0
Ireland,55,219.527,7.65455,0.290909,202.727,7.56364,0.4,657,EC Joyce,0,0,0,0,0,0,0,0,24,3,27,24,3,27,0,269,6,1,1,3.08571,0.2,28.3429,68.6505,35,4
England,221,237.176,7.17647,0.289593,230.633,7.45701,0.384615,657,MA Carberry,0,0,0,0,0,0,0,0,12,5,17,12,5,17,270,274,0,0,1,2.8,0.2,22.6,63.4831,5,1
England,221,237.176,7.17647,0.289593,230.633,7.45701,0.384615,657,LJ Wright,0,0,0,0,0,0,0,0,12,5,17,12,5,17,270,274,0,0,1,1.92105,0.0263158,17.2368,81.875,38,1
England,221,237.176,7.17647,0.289593,230.633,7.45701,0.384615,657,JWA Taylor,0,0,0,0,0,0,0,0,12,5,17,12,5,17,270,274,0,0,1,3.375,0.333333,35.9167,79.8888,24,4
Australia,228,239.627,7.69737,0.372807,232.079,7.23246,0.337719,658,AJ Finch,0,0,0,0,0,0,0,0,8,3,11,8,3,11,0,227,4,0,1,4.52941,0.313725,37.2549,83.4431,51,4
Australia,228,239.627,7.69737,0.372807,232.079,7.23246,0.337719,658,SR Watson,0,0,0,0,0,0,0,0,8,3,11,8,3,11,0,227,4,0,1,4.71318,0.286822,37.7907,90.0943,129,4
Australia,228,239.627,7.69737,0.372807,232.079,7.23246,0.337719,658,SE Marsh,0,0,0,0,0,0,0,0,8,3,11,8,3,11,0,227,4,0,1,3.66667,0.291667,35.5417,74.7918,48,4
England,221,237.176,7.17647,0.289593,230.633,7.45701,0.384615,658,MA Carberry,0,0,0,0,0,0,0,0,8,6,14,8,6,14,228,231,2,1,1,2.8,0.2,22.6,63.4831,5,1
England,221,237.176,7.17647,0.289593,230.633,7.45701,0.384615,658,KP Pietersen,0,0,0,0,0,0,0,0,8,6,14,8,6,14,228,231,2,1,1,3.69892,0.236559,33.4946,82.2117,93,4
England,221,237.176,7.17647,0.289593,230.633,7.45701,0.384615,658,IJL Trott,0,0,0,0,0,0,0,0,8,6,14,8,6,14,228,231,2,1,1,3.3871,0.403226,43.7903,75.2494,62,4
England,221,237.176,7.17647,0.289593,230.633,7.45701,0.384615,658,JE Root,0,0,0,0,0,0,0,0,8,6,14,8,6,14,228,231,2,1,1,3.68852,0.327869,41.6721,83.3443,61,4
England,221,237.176,7.17647,0.289593,230.633,7.45701,0.384615,658,EJG Morgan,0,0,0,0,0,0,0,0,8,6,14,8,6,14,228,231,2,1,1,3.19549,0.233083,30.0526,86.9291,133,4
Australia,228,239.627,7.69737,0.372807,232.079,7.23246,0.337719,659,PJ Hughes,0,0,0,0,0,0,0,0,12,8,20,12,8,20,0,298,3,0,1,4.52381,0.285714,38.7619,74.7475,21,4
Australia,228,239.627,7.69737,0.372807,232.079,7.23246,0.337719,659,AJ Finch,0,0,0,0,0,0,0,0,12,8,20,12,8,20,0,298,3,0,1,4.52941,0.313725,37.2549,83.4431,51,4
Australia,228,239.627,7.69737,0.372807,232.079,7.23246,0.337719,659,SR Watson,0,0,0,0,0,0,0,0,12,8,20,12,8,20,0,298,3,0,1,4.71318,0.286822,37.7907,90.0943,129,4
England,221,237.176,7.17647,0.289593,230.633,7.45701,0.384615,659,MA Carberry,0,0,0,0,0,0,0,0,12,10,22,12,10,22,299,249,0,1,1,2.8,0.2,22.6,63.4831,5,1
England,221,237.176,7.17647,0.289593,230.633,7.45701,0.384615,659,KP Pietersen,0,0,0,0,0,0,0,0,12,10,22,12,10,22,299,249,0,1,1,3.69892,0.236559,33.4946,82.2117,93,4
England,221,237.176,7.17647,0.289593,230.633,7.45701,0.384615,659,JE Root,0,0,0,0,0,0,0,0,12,10,22,12,10,22,299,249,0,1,1,3.68852,0.327869,41.6721,83.3443,61,4
South Africa,190,234.274,7.4,0.373684,232.363,7.33158,0.342105,660,CA Ingram,0,0,0,0,0,0,0,0,4,9,13,4,9,13,0,175,3,0,1,3,0.178571,27.1786,81.3904,28,4
South Africa,190,234.274,7.4,0.373684,232.363,7.33158,0.342105,660,RJ Peterson,0,0,0,0,0,0,0,0,4,9,13,4,9,13,0,175,3,0,1,1.62069,0.0344828,15.7931,83.5766,29,1
South Africa,190,234.274,7.4,0.373684,232.363,7.33158,0.342105,660,HM Amla,0,0,0,0,0,0,0,0,4,9,13,4,9,13,0,175,3,0,1,5.20168,0.403361,48.7899,86.9292,119,4
South Africa,190,234.274,7.4,0.373684,232.363,7.33158,0.342105,660,F du Plessis,0,0,0,0,0,0,0,0,4,9,13,4,9,13,0,175,3,0,1,3.45122,0.292683,34.9268,83.135,82,4
England,221,237.176,7.17647,0.289593,230.633,7.45701,0.384615,660,AN Cook,0,0,0,0,0,0,0,0,0,12,12,0,12,12,176,179,2,1,1,4.17045,0.272727,35.75,75.5524,88,4
England,221,237.176,7.17647,0.289593,230.633,7.45701,0.384615,660,IR Bell,0,0,0,0,0,0,0,0,0,12,12,0,12,12,176,179,2,1,1,3.63433,0.246269,35.3806,75.6623,134,4
Sri Lanka,244,223.373,7.09016,0.344262,227.578,7.47541,0.385246,661,MDKJ Perera,0,0,0,0,0,0,0,0,12,6,18,12,6,18,0,181,0,0,1,3.30435,0.195652,25.7391,90.5199,46,0
Sri Lanka,244,223.373,7.09016,0.344262,227.578,7.47541,0.385246,661,TM Dilshan,0,0,0,0,0,0,0,0,12,6,18,12,6,18,0,181,0,0,1,4.60199,0.273632,38.3632,86.0219,201,4
Sri Lanka,244,223.373,7.09016,0.344262,227.578,7.47541,0.385246,661,KC Sangakkara,0,0,0,0,0,0,0,0,12,6,18,12,6,18,0,181,0,0,1,4.33659,0.360976,41.9854,80.6276,205,4
Sri Lanka,244,223.373,7.09016,0.344262,227.578,7.47541,0.385246,661,HDRL Thirimanne,0,0,0,0,0,0,0,0,12,6,18,12,6,18,0,181,0,0,1,2.77778,0.246914,31.5802,71.4725,81,4
India,259,242.378,7.15058,0.339768,244.568,7.12741,0.30888,661,RG Sharma,0,0,0,0,0,0,0,0,16,3,19,16,3,19,182,182,2,0,1,3.82836,0.268657,35.9179,83.083,134,4
India,259,242.378,7.15058,0.339768,244.568,7.12741,0.30888,661,S Dhawan,0,0,0,0,0,0,0,0,16,3,19,16,3,19,182,182,2,0,1,5.65217,0.362319,43.2174,88.9088,69,4
India,259,242.378,7.15058,0.339768,244.568,7.12741,0.30888,662,RG Sharma,0,0,0,0,0,0,0,0,4,21,25,4,21,25,0,129,0,0,1,3.82836,0.268657,35.9179,83.083,134,4
India,259,242.378,7.15058,0.339768,244.568,7.12741,0.30888,662,S Dhawan,0,0,0,0,0,0,0,0,4,21,25,4,21,25,0,129,0,0,1,5.65217,0.362319,43.2174,88.9088,69,4
India,259,242.378,7.15058,0.339768,244.568,7.12741,0.30888,662,V Kohli,0,0,0,0,0,0,0,0,4,21,25,4,21,25,0,129,0,0,1,4.66456,0.379747,44.9937,88.3325,158,4
England,221,237.176,7.17647,0.289593,230.633,7.45701,0.384615,662,AN Cook,0,0,0,0,0,0,0,0,8,19,27,8,19,27,130,124,0,1,1,4.17045,0.272727,35.75,75.5524,88,4
England,221,237.176,7.17647,0.289593,230.633,7.45701,0.384615,662,IR Bell,0,0,0,0,0,0,0,0,8,19,27,8,19,27,130,124,0,1,1,3.63433,0.246269,35.3806,75.6623,134,4
England,221,237.176,7.17647,0.289593,230.633,7.45701,0.384615,662,IJL Trott,0,0,0,0,0,0,0,0,8,19,27,8,19,27,130,124,0,1,1,3.3871,0.403226,43.7903,75.2494,62,4
South Africa,190,234.274,7.4,0.373684,232.363,7.33158,0.342105,663,HM Amla,0,0,0,0,0,0,0,0,4,15,19,4,15,19,0,208,6,1,1,5.20168,0.403361,48.7899,86.9292,119,4
South Africa,190,234.274,7.4,0.373684,232.363,7.33158,0.342105,663,GC Smith,0,0,0,0,0,0,0,0,4,15,19,4,15,19,0,208,6,1,1,3.97,0.29,33.57,79.6819,100,4
South Africa,190,234.274,7.4,0.373684,232.363,7.33158,0.342105,663,CA Ingram,0,0,0,0,0,0,0,0,4,15,19,4,15,19,0,208,6,1,1,3,0.178571,27.1786,81.3904,28,4
New Zealand,184,233.745,7.39674,0.36413,227.951,7.30435,0.353261,663,RJ Nicol,0,0,0,0,0,0,0,0,8,1,9,8,1,9,209,209,1,0,1,3.3,0.2,29.25,73.4003,20,4
New Zealand,184,233.745,7.39674,0.36413,227.951,7.30435,0.353261,663,BJ Watling,0,0,0,0,0,0,0,0,8,1,9,8,1,9,209,209,1,0,1,3,0.263158,27.7895,66.9202,19,4
New Zealand,184,233.745,7.39674,0.36413,227.951,7.30435,0.353261,663,KS Williamson,0,0,0,0,0,0,0,0,8,1,9,8,1,9,209,209,1,0,1,4.31707,0.390244,43.0488,82.8833,82,4
New Zealand,184,233.745,7.39674,0.36413,227.951,7.30435,0.353261,664,MJ Guptill,0,0,0,0,0,0,0,0,4,5,9,4,5,9,0,279,0,0,1,4.8087,0.313043,38.1217,82.7482,115,4
New Zealand,184,233.745,7.39674,0.36413,227.951,7.30435,0.353261,664,BJ Watling,0,0,0,0,0,0,0,0,4,5,9,4,5,9,0,279,0,0,1,3,0.263158,27.7895,66.9202,19,4
New Zealand,184,233.745,7.39674,0.36413,227.951,7.30435,0.353261,664,KS Williamson,0,0,0,0,0,0,0,0,4,5,9,4,5,9,0,279,0,0,1,4.31707,0.390244,43.0488,82.8833,82,4
South Africa,190,234.274,7.4,0.373684,232.363,7.33158,0.342105,664,Q de Kock,0,0,0,0,0,0,0,0,0,10,10,0,10,10,280,252,1,1,1,5.12963,0.240741,39.1111,91.2311,54,4
South Africa,190,234.274,7.4,0.373684,232.363,7.33158,0.342105,664,GC Smith,0,0,0,0,0,0,0,0,0,10,10,0,10,10,280,252,1,1,1,3.97,0.29,33.57,79.6819,100,4
New Zealand,184,233.745,7.39674,0.36413,227.951,7.30435,0.353261,665,MJ Guptill,0,0,0,0,0,0,0,0,8,5,13,8,5,13,0,260,2,0,1,4.8087,0.313043,38.1217,82.7482,115,4
New Zealand,184,233.745,7.39674,0.36413,227.951,7.30435,0.353261,665,BJ Watling,0,0,0,0,0,0,0,0,8,5,13,8,5,13,0,260,2,0,1,3,0.263158,27.7895,66.9202,19,4
South Africa,190,234.274,7.4,0.373684,232.363,7.33158,0.342105,665,Q de Kock,0,0,0,0,0,0,0,0,8,9,17,8,9,17,261,264,1,1,1,5.12963,0.240741,39.1111,91.2311,54,4
South Africa,190,234.274,7.4,0.373684,232.363,7.33158,0.342105,665,GC Smith,0,0,0,0,0,0,0,0,8,9,17,8,9,17,261,264,1,1,1,3.97,0.29,33.57,79.6819,100,4
South Africa,190,234.274,7.4,0.373684,232.363,7.33158,0.342105,666,GC Smith,0,0,0,0,0,0,0,0,8,6,14,8,6,14,0,315,1,1,1,3.97,0.29,33.57,79.6819,100,4
South Africa,190,234.274,7.4,0.373684,232.363,7.33158,0.342105,666,HM Amla,0,0,0,0,0,0,0,0,8,6,14,8,6,14,0,315,1,1,1,5.20168,0.403361,48.7899,86.9292,119,4
Pakistan,211,222.621,7.38389,0.393365,235.517,7.54976,0.336493,666,Mohammad Hafeez,0,0,0,0,0,0,0,0,20,8,28,20,8,28,316,190,0,0,1,4.04511,0.255639,34.3534,78.0625,133,4
Pakistan,211,222.621,7.38389,0.393365,235.517,7.54976,0.336493,666,Nasir Jamshed,0,0,0,0,0,0,0,0,20,8,28,20,8,28,316,190,0,0,1,3.63043,0.23913,30.2174,73.8184,46,4
South Africa,190,234.274,7.4,0.373684,232.363,7.33158,0.342105,667,GC Smith,0,0,0,0,0,0,0,0,4,5,9,4,5,9,0,343,2,1,1,3.97,0.29,33.57,79.6819,100,4
South Africa,190,234.274,7.4,0.373684,232.363,7.33158,0.342105,667,HM Amla,0,0,0,0,0,0,0,0,4,5,9,4,5,9,0,343,2,1,1,5.20168,0.403361,48.7899,86.9292,119,4
South Africa,190,234.274,7.4,0.373684,232.363,7.33158,0.342105,667,CA Ingram,0,0,0,0,0,0,0,0,4,5,9,4,5,9,0,343,2,1,1,3,0.178571,27.1786,81.3904,28,4
Pakistan,211,222.621,7.38389,0.393365,235.517,7.54976,0.336493,667,Nasir Jamshed,0,0,0,0,0,0,0,0,18,7,25,18,7,25,344,309,0,0,1,3.63043,0.23913,30.2174,73.8184,46,4
Pakistan,211,222.621,7.38389,0.393365,235.517,7.54976,0.336493,667,Mohammad Hafeez,0,0,0,0,0,0,0,0,18,7,25,18,7,25,344,309,0,0,1,4.04511,0.255639,34.3534,78.0625,133,4
Pakistan,211,222.621,7.38389,0.393365,235.517,7.54976,0.336493,667,Kamran Akmal,0,0,0,0,0,0,0,0,18,7,25,18,7,25,344,309,0,0,1,3.01124,0.11236,23.0787,81.4433,89,4
South Africa,190,234.274,7.4,0.373684,232.363,7.33158,0.342105,668,HM Amla,0,0,0,0,0,0,0,0,12,6,18,12,6,18,0,234,1,1,1,5.20168,0.403361,48.7899,86.9292,119,4
South Africa,190,234.274,7.4,0.373684,232.363,7.33158,0.342105,668,CA Ingram,0,0,0,0,0,0,0,0,12,6,18,12,6,18,0,234,1,1,1,3,0.178571,27.1786,81.3904,28,4
South Africa,190,234.274,7.4,0.373684,232.363,7.33158,0.342105,668,AB de Villiers,0,0,0,0,0,0,0,0,12,6,18,12,6,18,0,234,1,1,1,5.04969,0.403727,47.2174,98.8428,161,4
South Africa,190,234.274,7.4,0.373684,232.363,7.33158,0.342105,668,GC Smith,0,0,0,0,0,0,0,0,12,6,18,12,6,18,0,234,1,1,1,3.97,0.29,33.57,79.6819,100,4
Pakistan,211,222.621,7.38389,0.393365,235.517,7.54976,0.336493,668,Imran Farhat,0,0,0,0,0,0,0,0,12,4,16,12,4,16,235,236,1,0,1,3.03333,0.266667,27.0333,62.9658,30,4
Pakistan,211,222.621,7.38389,0.393365,235.517,7.54976,0.336493,668,Mohammad Hafeez,0,0,0,0,0,0,0,0,12,4,16,12,4,16,235,236,1,0,1,4.04511,0.255639,34.3534,78.0625,133,4
Pakistan,211,222.621,7.38389,0.393365,235.517,7.54976,0.336493,668,Kamran Akmal,0,0,0,0,0,0,0,0,12,4,16,12,4,16,235,236,1,0,1,3.01124,0.11236,23.0787,81.4433,89,4
Pakistan,211,222.621,7.38389,0.393365,235.517,7.54976,0.336493,669,Imran Farhat,0,0,0,0,0,0,0,0,12,3,15,12,3,15,0,205,0,0,1,3.03333,0.266667,27.0333,62.9658,30,4
Pakistan,211,222.621,7.38389,0.393365,235.517,7.54976,0.336493,669,Mohammad Hafeez,0,0,0,0,0,0,0,0,12,3,15,12,3,15,0,205,0,0,1,4.04511,0.255639,34.3534,78.0625,133,4
Pakistan,211,222.621,7.38389,0.393365,235.517,7.54976,0.336493,669,Kamran Akmal,0,0,0,0,0,0,0,0,12,3,15,12,3,15,0,205,0,0,1,3.01124,0.11236,23.0787,81.4433,89,4
South Africa,190,234.274,7.4,0.373684,232.363,7.33158,0.342105,669,HM Amla,0,0,0,0,0,0,0,0,4,4,8,4,4,8,206,208,2,1,1,5.20168,0.403361,48.7899,86.9292,119,4
South Africa,190,234.274,7.4,0.373684,232.363,7.33158,0.342105,669,Q de Kock,0,0,0,0,0,0,0,0,4,4,8,4,4,8,206,208,2,1,1,5.12963,0.240741,39.1111,91.2311,54,4
England,221,237.176,7.17647,0.289593,230.633,7.45701,0.384615,670,AN Cook,0,0,0,0,0,0,0,0,12,6,18,12,6,18,0,258,0,0,1,4.17045,0.272727,35.75,75.5524,88,4
England,221,237.176,7.17647,0.289593,230.633,7.45701,0.384615,670,IR Bell,0,0,0,0,0,0,0,0,12,6,18,12,6,18,0,258,0,0,1,3.63433,0.246269,35.3806,75.6623,134,4
England,221,237.176,7.17647,0.289593,230.633,7.45701,0.384615,670,IJL Trott,0,0,0,0,0,0,0,0,12,6,18,12,6,18,0,258,0,0,1,3.3871,0.403226,43.7903,75.2494,62,4
New Zealand,184,233.745,7.39674,0.36413,227.951,7.30435,0.353261,670,BJ Watling,0,0,0,0,0,0,0,0,4,4,8,4,4,8,259,259,1,1,1,3,0.263158,27.7895,66.9202,19,4
New Zealand,184,233.745,7.39674,0.36413,227.951,7.30435,0.353261,670,MJ Guptill,0,0,0,0,0,0,0,0,4,4,8,4,4,8,259,259,1,1,1,4.8087,0.313043,38.1217,82.7482,115,4
New Zealand,184,233.745,7.39674,0.36413,227.951,7.30435,0.353261,670,KS Williamson,0,0,0,0,0,0,0,0,4,4,8,4,4,8,259,259,1,1,1,4.31707,0.390244,43.0488,82.8833,82,4
New Zealand,184,233.745,7.39674,0.36413,227.951,7.30435,0.353261,671,BJ Watling,0,0,0,0,0,0,0,0,4,7,11,4,7,11,0,269,0,1,1,3,0.263158,27.7895,66.9202,19,4
New Zealand,184,233.745,7.39674,0.36413,227.951,7.30435,0.353261,671,HD Rutherford,0,0,0,0,0,0,0,0,4,7,11,4,7,11,0,269,0,1,1,0.5,0,3.5,25,4,3
England,221,237.176,7.17647,0.289593,230.633,7.45701,0.384615,671,AN Cook,0,0,0,0,0,0,0,0,12,4,16,12,4,16,270,270,1,0,1,4.17045,0.272727,35.75,75.5524,88,4
England,221,237.176,7.17647,0.289593,230.633,7.45701,0.384615,671,IR Bell,0,0,0,0,0,0,0,0,12,4,16,12,4,16,270,270,1,0,1,3.63433,0.246269,35.3806,75.6623,134,4
New Zealand,184,233.745,7.39674,0.36413,227.951,7.30435,0.353261,672,BJ Watling,0,0,0,0,0,0,0,0,4,6,10,4,6,10,0,185,1,1,1,3,0.263158,27.7895,66.9202,19,4
New Zealand,184,233.745,7.39674,0.36413,227.951,7.30435,0.353261,672,KS Williamson,0,0,0,0,0,0,0,0,4,6,10,4,6,10,0,185,1,1,1,4.31707,0.390244,43.0488,82.8833,82,4
New Zealand,184,233.745,7.39674,0.36413,227.951,7.30435,0.353261,672,HD Rutherford,0,0,0,0,0,0,0,0,4,6,10,4,6,10,0,185,1,1,1,0.5,0,3.5,25,4,3
England,221,237.176,7.17647,0.289593,230.633,7.45701,0.384615,672,AN Cook,0,0,0,0,0,0,0,0,22,8,30,22,8,30,186,186,3,0,1,4.17045,0.272727,35.75,75.5524,88,4
England,221,237.176,7.17647,0.289593,230.633,7.45701,0.384615,672,IR Bell,0,0,0,0,0,0,0,0,22,8,30,22,8,30,186,186,3,0,1,3.63433,0.246269,35.3806,75.6623,134,4
Pakistan,211,222.621,7.38389,0.393365,235.517,7.54976,0.336493,673,Mohammad Hafeez,0,0,0,0,0,0,0,0,4,11,15,4,11,15,0,198,5,0,1,4.04511,0.255639,34.3534,78.0625,133,4
Pakistan,211,222.621,7.38389,0.393365,235.517,7.54976,0.336493,673,Nasir Jamshed,0,0,0,0,0,0,0,0,4,11,15,4,11,15,0,198,5,0,1,3.63043,0.23913,30.2174,73.8184,46,4
Pakistan,211,222.621,7.38389,0.393365,235.517,7.54976,0.336493,673,Azhar Ali,0,0,0,0,0,0,0,0,4,11,15,4,11,15,0,198,5,0,1,3.83333,0.3,38.5333,73.6775,30,4
Australia,228,239.627,7.69737,0.372807,232.079,7.23246,0.337719,673,DA Warner,0,0,0,0,0,0,0,0,8,9,17,8,9,17,199,199,4,0,1,4.20312,0.265625,35.2031,87.7336,64,4
Australia,228,239.627,7.69737,0.372807,232.079,7.23246,0.337719,673,MS Wade,0,0,0,0,0,0,0,0,8,9,17,8,9,17,199,199,4,0,1,1.86275,0.117647,20.3333,78.2642,51,1
Australia,228,239.627,7.69737,0.372807,232.079,7.23246,0.337719,673,MJ Clarke,0,0,0,0,0,0,0,0,8,9,17,8,9,17,199,199,4,0,1,3.10294,0.301471,35.9265,74.0303,136,4
Australia,228,239.627,7.69737,0.372807,232.079,7.23246,0.337719,674,MS Wade,0,0,0,0,0,0,0,0,12,8,20,12,8,20,0,248,7,0,1,1.86275,0.117647,20.3333,78.2642,51,1
Australia,228,239.627,7.69737,0.372807,232.079,7.23246,0.337719,674,DA Warner,0,0,0,0,0,0,0,0,12,8,20,12,8,20,0,248,7,0,1,4.20312,0.265625,35.2031,87.7336,64,4
Australia,228,239.627,7.69737,0.372807,232.079,7.23246,0.337719,674,MJ Clarke,0,0,0,0,0,0,0,0,12,8,20,12,8,20,0,248,7,0,1,3.10294,0.301471,35.9265,74.0303,136,4
Pakistan,211,222.621,7.38389,0.393365,235.517,7.54976,0.336493,674,Mohammad Hafeez,0,0,0,0,0,0,0,0,16,10,26,16,10,26,249,249,3,0,1,4.04511,0.255639,34.3534,78.0625,133,4
Pakistan,211,222.621,7.38389,0.393365,235.517,7.54976,0.336493,674,Nasir Jamshed,0,0,0,0,0,0,0,0,16,10,26,16,10,26,249,249,3,0,1,3.63043,0.23913,30.2174,73.8184,46,4
Pakistan,211,222.621,7.38389,0.393365,235.517,7.54976,0.336493,675,Mohammad Hafeez,0,0,0,0,0,0,0,0,16,8,24,16,8,24,0,244,2,0,1,4.04511,0.255639,34.3534,78.0625,133,4
Pakistan,211,222.621,7.38389,0.393365,235.517,7.54976,0.336493,675,Nasir Jamshed,0,0,0,0,0,0,0,0,16,8,24,16,8,24,0,244,2,0,1,3.63043,0.23913,30.2174,73.8184,46,4
Australia,228,239.627,7.69737,0.372807,232.079,7.23246,0.337719,675,DA Warner,0,0,0,0,0,0,0,0,18,8,26,18,8,26,245,250,0,0,1,4.20312,0.265625,35.2031,87.7336,64,4
Australia,228,239.627,7.69737,0.372807,232.079,7.23246,0.337719,675,DJ Hussey,0,0,0,0,0,0,0,0,18,8,26,18,8,26,245,250,0,0,1,2.54386,0.245614,29.2105,87.8628,57,4
Australia,228,239.627,7.69737,0.372807,232.079,7.23246,0.337719,676,AJ Finch,0,0,0,0,0,0,0,0,8,8,16,8,8,16,0,305,1,1,1,4.52941,0.313725,37.2549,83.4431,51,4
Australia,228,239.627,7.69737,0.372807,232.079,7.23246,0.337719,676,PJ Hughes,0,0,0,0,0,0,0,0,8,8,16,8,8,16,0,305,1,1,1,4.52381,0.285714,38.7619,74.7475,21,4
Sri Lanka,244,223.373,7.09016,0.344262,227.578,7.47541,0.385246,676,WU Tharanga,0,0,0,0,0,0,0,0,8,5,13,8,5,13,306,198,3,0,1,3.93985,0.263158,32.9699,71.6035,133,4
Sri Lanka,244,223.373,7.09016,0.344262,227.578,7.47541,0.385246,676,TM Dilshan,0,0,0,0,0,0,0,0,8,5,13,8,5,13,306,198,3,0,1,4.60199,0.273632,38.3632,86.0219,201,4
Sri Lanka,244,223.373,7.09016,0.344262,227.578,7.47541,0.385246,676,DPMD Jayawardene,0,0,0,0,0,0,0,0,8,5,13,8,5,13,306,198,3,0,1,3.20833,0.244792,31.6979,79.1109,192,4
Australia,228,239.627,7.69737,0.372807,232.079,7.23246,0.337719,677,AJ Finch,0,0,0,0,0,0,0,0,0,9,9,0,9,9,0,170,0,1,1,4.52941,0.313725,37.2549,83.4431,51,4
Australia,228,239.627,7.69737,0.372807,232.079,7.23246,0.337719,677,PJ Hughes,0,0,0,0,0,0,0,0,0,9,9,0,9,9,0,170,0,1,1,4.52381,0.285714,38.7619,74.7475,21,4
Australia,228,239.627,7.69737,0.372807,232.079,7.23246,0.337719,677,GJ Bailey,0,0,0,0,0,0,0,0,0,9,9,0,9,9,0,170,0,1,1,3.34921,0.301587,36.3492,84.658,63,4
Sri Lanka,244,223.373,7.09016,0.344262,227.578,7.47541,0.385246,677,WU Tharanga,0,0,0,0,0,0,0,0,4,3,7,4,3,7,171,172,1,0,1,3.93985,0.263158,32.9699,71.6035,133,4
Sri Lanka,244,223.373,7.09016,0.344262,227.578,7.47541,0.385246,677,HDRL Thirimanne,0,0,0,0,0,0,0,0,4,3,7,4,3,7,171,172,1,0,1,2.77778,0.246914,31.5802,71.4725,81,4
Sri Lanka,244,223.373,7.09016,0.344262,227.578,7.47541,0.385246,677,TM Dilshan,0,0,0,0,0,0,0,0,4,3,7,4,3,7,171,172,1,0,1,4.60199,0.273632,38.3632,86.0219,201,4
Australia,228,239.627,7.69737,0.372807,232.079,7.23246,0.337719,678,DA Warner,0,0,0,0,0,0,0,0,0,12,12,0,12,12,0,74,1,1,1,4.20312,0.265625,35.2031,87.7336,64,4
Australia,228,239.627,7.69737,0.372807,232.079,7.23246,0.337719,678,PJ Hughes,0,0,0,0,0,0,0,0,0,12,12,0,12,12,0,74,1,1,1,4.52381,0.285714,38.7619,74.7475,21,4
Australia,228,239.627,7.69737,0.372807,232.079,7.23246,0.337719,678,MJ Clarke,0,0,0,0,0,0,0,0,0,12,12,0,12,12,0,74,1,1,1,3.10294,0.301471,35.9265,74.0303,136,4
Sri Lanka,244,223.373,7.09016,0.344262,227.578,7.47541,0.385246,678,DPMD Jayawardene,0,0,0,0,0,0,0,0,4,7,11,4,7,11,75,75,2,0,1,3.20833,0.244792,31.6979,79.1109,192,4
Sri Lanka,244,223.373,7.09016,0.344262,227.578,7.47541,0.385246,678,TM Dilshan,0,0,0,0,0,0,0,0,4,7,11,4,7,11,75,75,2,0,1,4.60199,0.273632,38.3632,86.0219,201,4
Sri Lanka,244,223.373,7.09016,0.344262,227.578,7.47541,0.385246,678,HDRL Thirimanne,0,0,0,0,0,0,0,0,4,7,11,4,7,11,75,75,2,0,1,2.77778,0.246914,31.5802,71.4725,81,4
Australia,228,239.627,7.69737,0.372807,232.079,7.23246,0.337719,679,MS Wade,0,0,0,0,0,0,0,0,12,8,20,12,8,20,0,247,0,1,1,1.86275,0.117647,20.3333,78.2642,51,1
Australia,228,239.627,7.69737,0.372807,232.079,7.23246,0.337719,679,DA Warner,0,0,0,0,0,0,0,0,12,8,20,12,8,20,0,247,0,1,1,4.20312,0.265625,35.2031,87.7336,64,4
Sri Lanka,244,223.373,7.09016,0.344262,227.578,7.47541,0.385246,679,DPMD Jayawardene,0,0,0,0,0,0,0,0,16,8,24,16,8,24,248,215,1,0,1,3.20833,0.244792,31.6979,79.1109,192,4
Sri Lanka,244,223.373,7.09016,0.344262,227.578,7.47541,0.385246,679,TM Dilshan,0,0,0,0,0,0,0,0,16,8,24,16,8,24,248,215,1,0,1,4.60199,0.273632,38.3632,86.0219,201,4
West Indies,176,217.33,7.15909,0.3125,225.278,7.57386,0.380682,680,CH Gayle,0,0,0,0,0,0,0,0,8,3,11,8,3,11,0,70,3,0,1,4.58621,0.206897,31.1293,89.4255,116,4
West Indies,176,217.33,7.15909,0.3125,225.278,7.57386,0.380682,680,KOA Powell,0,0,0,0,0,0,0,0,8,3,11,8,3,11,0,70,3,0,1,3.59259,0.222222,26.4815,80.6088,27,4
West Indies,176,217.33,7.15909,0.3125,225.278,7.57386,0.380682,680,RR Sarwan,0,0,0,0,0,0,0,0,8,3,11,8,3,11,0,70,3,0,1,2.8254,0.222222,29.1429,69.1005,63,4
Australia,228,239.627,7.69737,0.372807,232.079,7.23246,0.337719,680,GJ Maxwell,0,0,0,0,0,0,0,0,36,7,43,36,7,43,71,71,1,1,1,3.79245,0.226415,28.2264,119.68,53,0
Australia,228,239.627,7.69737,0.372807,232.079,7.23246,0.337719,680,AJ Finch,0,0,0,0,0,0,0,0,36,7,43,36,7,43,71,71,1,1,1,4.52941,0.313725,37.2549,83.4431,51,4
Australia,228,239.627,7.69737,0.372807,232.079,7.23246,0.337719,680,UT Khawaja,0,0,0,0,0,0,0,0,36,7,43,36,7,43,71,71,1,1,1,2.8,0.2,21.6,84.375,5,4
Australia,228,239.627,7.69737,0.372807,232.079,7.23246,0.337719,681,AJ Finch,0,0,0,0,0,0,0,0,12,6,18,12,6,18,0,266,2,1,1,4.52941,0.313725,37.2549,83.4431,51,4
Australia,228,239.627,7.69737,0.372807,232.079,7.23246,0.337719,681,UT Khawaja,0,0,0,0,0,0,0,0,12,6,18,12,6,18,0,266,2,1,1,2.8,0.2,21.6,84.375,5,4
Australia,228,239.627,7.69737,0.372807,232.079,7.23246,0.337719,681,PJ Hughes,0,0,0,0,0,0,0,0,12,6,18,12,6,18,0,266,2,1,1,4.52381,0.285714,38.7619,74.7475,21,4
West Indies,176,217.33,7.15909,0.3125,225.278,7.57386,0.380682,681,CH Gayle,0,0,0,0,0,0,0,0,4,8,12,4,8,12,267,212,8,0,1,4.58621,0.206897,31.1293,89.4255,116,4
West Indies,176,217.33,7.15909,0.3125,225.278,7.57386,0.380682,681,KOA Powell,0,0,0,0,0,0,0,0,4,8,12,4,8,12,267,212,8,0,1,3.59259,0.222222,26.4815,80.6088,27,4
West Indies,176,217.33,7.15909,0.3125,225.278,7.57386,0.380682,681,RR Sarwan,0,0,0,0,0,0,0,0,4,8,12,4,8,12,267,212,8,0,1,2.8254,0.222222,29.1429,69.1005,63,4
West Indies,176,217.33,7.15909,0.3125,225.278,7.57386,0.380682,681,DM Bravo,0,0,0,0,0,0,0,0,4,8,12,4,8,12,267,212,8,0,1,3,0.226667,28.52,67.4551,75,4
Australia,228,239.627,7.69737,0.372807,232.079,7.23246,0.337719,682,SR Watson,0,0,0,0,0,0,0,0,12,7,19,12,7,19,0,329,1,1,1,4.71318,0.286822,37.7907,90.0943,129,4
Australia,228,239.627,7.69737,0.372807,232.079,7.23246,0.337719,682,AJ Finch,0,0,0,0,0,0,0,0,12,7,19,12,7,19,0,329,1,1,1,4.52941,0.313725,37.2549,83.4431,51,4
West Indies,176,217.33,7.15909,0.3125,225.278,7.57386,0.380682,682,KOA Powell,0,0,0,0,0,0,0,0,16,3,19,16,3,19,330,290,0,0,1,3.59259,0.222222,26.4815,80.6088,27,4
West Indies,176,217.33,7.15909,0.3125,225.278,7.57386,0.380682,682,DC Thomas,0,0,0,0,0,0,0,0,16,3,19,16,3,19,330,290,0,0,1,1.11111,0,12.4444,61.3699,18,1
West Indies,176,217.33,7.15909,0.3125,225.278,7.57386,0.380682,683,KOA Powell,0,0,0,0,0,0,0,0,0,6,6,0,6,6,0,220,2,0,1,3.59259,0.222222,26.4815,80.6088,27,4
West Indies,176,217.33,7.15909,0.3125,225.278,7.57386,0.380682,683,J Charles,0,0,0,0,0,0,0,0,0,6,6,0,6,6,0,220,2,0,1,3.82353,0.147059,28.2353,81.2183,34,4
West Indies,176,217.33,7.15909,0.3125,225.278,7.57386,0.380682,683,DM Bravo,0,0,0,0,0,0,0,0,0,6,6,0,6,6,0,220,2,0,1,3,0.226667,28.52,67.4551,75,4
Australia,228,239.627,7.69737,0.372807,232.079,7.23246,0.337719,683,SR Watson,0,0,0,0,0,0,0,0,8,8,16,8,8,16,221,221,10,1,1,4.71318,0.286822,37.7907,90.0943,129,4
Australia,228,239.627,7.69737,0.372807,232.079,7.23246,0.337719,683,AJ Finch,0,0,0,0,0,0,0,0,8,8,16,8,8,16,221,221,10,1,1,4.52941,0.313725,37.2549,83.4431,51,4
Australia,228,239.627,7.69737,0.372807,232.079,7.23246,0.337719,684,SR Watson,0,0,0,0,0,0,0,0,4,3,7,4,3,7,0,274,2,1,1,4.71318,0.286822,37.7907,90.0943,129,4
Australia,228,239.627,7.69737,0.372807,232.079,7.23246,0.337719,684,PJ Hughes,0,0,0,0,0,0,0,0,4,3,7,4,3,7,0,274,2,1,1,4.52381,0.285714,38.7619,74.7475,21,4
Australia,228,239.627,7.69737,0.372807,232.079,7.23246,0.337719,684,AJ Finch,0,0,0,0,0,0,0,0,4,3,7,4,3,7,0,274,2,1,1,4.52941,0.313725,37.2549,83.4431,51,4
Australia,228,239.627,7.69737,0.372807,232.079,7.23246,0.337719,684,SE Marsh,0,0,0,0,0,0,0,0,4,3,7,4,3,7,0,274,2,1,1,3.66667,0.291667,35.5417,74.7918,48,4
West Indies,176,217.33,7.15909,0.3125,225.278,7.57386,0.380682,684,J Charles,0,0,0,0,0,0,0,0,4,8,12,4,8,12,275,257,3,0,1,3.82353,0.147059,28.2353,81.2183,34,4
West Indies,176,217.33,7.15909,0.3125,225.278,7.57386,0.380682,684,KOA Powell,0,0,0,0,0,0,0,0,4,8,12,4,8,12,275,257,3,0,1,3.59259,0.222222,26.4815,80.6088,27,4
West Indies,176,217.33,7.15909,0.3125,225.278,7.57386,0.380682,684,DM Bravo,0,0,0,0,0,0,0,0,4,8,12,4,8,12,275,257,3,0,1,3,0.226667,28.52,67.4551,75,4
Pakistan,211,222.621,7.38389,0.393365,235.517,7.54976,0.336493,685,Imran Farhat,0,0,0,0,0,0,0,0,8,4,12,8,4,12,0,170,2,0,1,3.03333,0.266667,27.0333,62.9658,30,4
Pakistan,211,222.621,7.38389,0.393365,235.517,7.54976,0.336493,685,Nasir Jamshed,0,0,0,0,0,0,0,0,8,4,12,8,4,12,0,170,2,0,1,3.63043,0.23913,30.2174,73.8184,46,4
Pakistan,211,222.621,7.38389,0.393365,235.517,7.54976,0.336493,685,Mohammad Hafeez,0,0,0,0,0,0,0,0,8,4,12,8,4,12,0,170,2,0,1,4.04511,0.255639,34.3534,78.0625,133,4
Pakistan,211,222.621,7.38389,0.393365,235.517,7.54976,0.336493,685,Asad Shafiq,0,0,0,0,0,0,0,0,8,4,12,8,4,12,0,170,2,0,1,2.07843,0.176471,24.7843,67.1269,51,4
West Indies,176,217.33,7.15909,0.3125,225.278,7.57386,0.380682,685,CH Gayle,0,0,0,0,0,0,0,0,12,5,17,12,5,17,171,172,0,0,1,4.58621,0.206897,31.1293,89.4255,116,4
West Indies,176,217.33,7.15909,0.3125,225.278,7.57386,0.380682,685,J Charles,0,0,0,0,0,0,0,0,12,5,17,12,5,17,171,172,0,0,1,3.82353,0.147059,28.2353,81.2183,34,4
West Indies,176,217.33,7.15909,0.3125,225.278,7.57386,0.380682,685,DM Bravo,0,0,0,0,0,0,0,0,12,5,17,12,5,17,171,172,0,0,1,3,0.226667,28.52,67.4551,75,4
West Indies,176,217.33,7.15909,0.3125,225.278,7.57386,0.380682,685,MN Samuels,0,0,0,0,0,0,0,0,12,5,17,12,5,17,171,172,0,0,1,3.74757,0.23301,31.6214,74.5821,103,4
England,221,237.176,7.17647,0.289593,230.633,7.45701,0.384615,686,AN Cook,0,0,0,0,0,0,0,0,12,13,25,12,13,25,0,269,2,1,1,4.17045,0.272727,35.75,75.5524,88,4
England,221,237.176,7.17647,0.289593,230.633,7.45701,0.384615,686,IR Bell,0,0,0,0,0,0,0,0,12,13,25,12,13,25,0,269,2,1,1,3.63433,0.246269,35.3806,75.6623,134,4
Australia,228,239.627,7.69737,0.372807,232.079,7.23246,0.337719,686,DA Warner,0,0,0,0,0,0,0,0,4,12,16,4,12,16,270,221,1,0,1,4.20312,0.265625,35.2031,87.7336,64,4
Australia,228,239.627,7.69737,0.372807,232.079,7.23246,0.337719,686,SR Watson,0,0,0,0,0,0,0,0,4,12,16,4,12,16,270,221,1,0,1,4.71318,0.286822,37.7907,90.0943,129,4
Sri Lanka,244,223.373,7.09016,0.344262,227.578,7.47541,0.385246,687,MDKJ Perera,0,0,0,0,0,0,0,0,12,10,22,12,10,22,0,138,1,0,1,3.30435,0.195652,25.7391,90.5199,46,0
Sri Lanka,244,223.373,7.09016,0.344262,227.578,7.47541,0.385246,687,KC Sangakkara,0,0,0,0,0,0,0,0,12,10,22,12,10,22,0,138,1,0,1,4.33659,0.360976,41.9854,80.6276,205,4
Sri Lanka,244,223.373,7.09016,0.344262,227.578,7.47541,0.385246,687,TM Dilshan,0,0,0,0,0,0,0,0,12,10,22,12,10,22,0,138,1,0,1,4.60199,0.273632,38.3632,86.0219,201,4
New Zealand,184,233.745,7.39674,0.36413,227.951,7.30435,0.353261,687,MJ Guptill,0,0,0,0,0,0,0,0,8,9,17,8,9,17,139,139,0,0,1,4.8087,0.313043,38.1217,82.7482,115,4
New Zealand,184,233.745,7.39674,0.36413,227.951,7.30435,0.353261,687,L Ronchi,0,0,0,0,0,0,0,0,8,9,17,8,9,17,139,139,0,0,1,2.92157,0.0784314,22.1961,115.392,51,0
New Zealand,184,233.745,7.39674,0.36413,227.951,7.30435,0.353261,687,KS Williamson,0,0,0,0,0,0,0,0,8,9,17,8,9,17,139,139,0,0,1,4.31707,0.390244,43.0488,82.8833,82,4
South Africa,190,234.274,7.4,0.373684,232.363,7.33158,0.342105,688,CA Ingram,0,0,0,0,0,0,0,0,4,10,14,4,10,14,0,234,1,0,1,3,0.178571,27.1786,81.3904,28,4
South Africa,190,234.274,7.4,0.373684,232.363,7.33158,0.342105,688,HM Amla,0,0,0,0,0,0,0,0,4,10,14,4,10,14,0,234,1,0,1,5.20168,0.403361,48.7899,86.9292,119,4
Pakistan,211,222.621,7.38389,0.393365,235.517,7.54976,0.336493,688,Imran Farhat,0,0,0,0,0,0,0,0,0,9,9,0,9,9,235,167,1,0,1,3.03333,0.266667,27.0333,62.9658,30,4
Pakistan,211,222.621,7.38389,0.393365,235.517,7.54976,0.336493,688,Nasir Jamshed,0,0,0,0,0,0,0,0,0,9,9,0,9,9,235,167,1,0,1,3.63043,0.23913,30.2174,73.8184,46,4
Pakistan,211,222.621,7.38389,0.393365,235.517,7.54976,0.336493,688,Mohammad Hafeez,0,0,0,0,0,0,0,0,0,9,9,0,9,9,235,167,1,0,1,4.04511,0.255639,34.3534,78.0625,133,4
West Indies,176,217.33,7.15909,0.3125,225.278,7.57386,0.380682,689,CH Gayle,0,0,0,0,0,0,0,0,16,8,24,16,8,24,0,233,1,0,1,4.58621,0.206897,31.1293,89.4255,116,4
West Indies,176,217.33,7.15909,0.3125,225.278,7.57386,0.380682,689,J Charles,0,0,0,0,0,0,0,0,16,8,24,16,8,24,0,233,1,0,1,3.82353,0.147059,28.2353,81.2183,34,4
India,259,242.378,7.15058,0.339768,244.568,7.12741,0.30888,689,RG Sharma,0,0,0,0,0,0,0,0,16,15,31,16,15,31,234,236,1,0,1,3.82836,0.268657,35.9179,83.083,134,4
India,259,242.378,7.15058,0.339768,244.568,7.12741,0.30888,689,S Dhawan,0,0,0,0,0,0,0,0,16,15,31,16,15,31,234,236,1,0,1,5.65217,0.362319,43.2174,88.9088,69,4
England,221,237.176,7.17647,0.289593,230.633,7.45701,0.384615,690,AN Cook,0,0,0,0,0,0,0,0,12,4,16,12,4,16,0,293,5,1,1,4.17045,0.272727,35.75,75.5524,88,4
England,221,237.176,7.17647,0.289593,230.633,7.45701,0.384615,690,IR Bell,0,0,0,0,0,0,0,0,12,4,16,12,4,16,0,293,5,1,1,3.63433,0.246269,35.3806,75.6623,134,4
Sri Lanka,244,223.373,7.09016,0.344262,227.578,7.47541,0.385246,690,MDKJ Perera,0,0,0,0,0,0,0,0,16,7,23,16,7,23,294,297,2,0,1,3.30435,0.195652,25.7391,90.5199,46,0
Sri Lanka,244,223.373,7.09016,0.344262,227.578,7.47541,0.385246,690,TM Dilshan,0,0,0,0,0,0,0,0,16,7,23,16,7,23,294,297,2,0,1,4.60199,0.273632,38.3632,86.0219,201,4
Sri Lanka,244,223.373,7.09016,0.344262,227.578,7.47541,0.385246,690,KC Sangakkara,0,0,0,0,0,0,0,0,16,7,23,16,7,23,294,297,2,0,1,4.33659,0.360976,41.9854,80.6276,205,4
South Africa,190,234.274,7.4,0.373684,232.363,7.33158,0.342105,691,CA Ingram,0,0,0,0,0,0,0,0,12,12,24,12,12,24,0,230,4,0,1,3,0.178571,27.1786,81.3904,28,4
South Africa,190,234.274,7.4,0.373684,232.363,7.33158,0.342105,691,HM Amla,0,0,0,0,0,0,0,0,12,12,24,12,12,24,0,230,4,0,1,5.20168,0.403361,48.7899,86.9292,119,4
West Indies,176,217.33,7.15909,0.3125,225.278,7.57386,0.380682,691,CH Gayle,0,0,0,0,0,0,0,0,12,11,23,12,11,23,231,190,0,0,1,4.58621,0.206897,31.1293,89.4255,116,4
West Indies,176,217.33,7.15909,0.3125,225.278,7.57386,0.380682,691,J Charles,0,0,0,0,0,0,0,0,12,11,23,12,11,23,231,190,0,0,1,3.82353,0.147059,28.2353,81.2183,34,4
Pakistan,211,222.621,7.38389,0.393365,235.517,7.54976,0.336493,692,Nasir Jamshed,0,0,0,0,0,0,0,0,0,6,6,0,6,6,0,165,1,0,1,3.63043,0.23913,30.2174,73.8184,46,4
Pakistan,211,222.621,7.38389,0.393365,235.517,7.54976,0.336493,692,Kamran Akmal,0,0,0,0,0,0,0,0,0,6,6,0,6,6,0,165,1,0,1,3.01124,0.11236,23.0787,81.4433,89,4
Pakistan,211,222.621,7.38389,0.393365,235.517,7.54976,0.336493,692,Mohammad Hafeez,0,0,0,0,0,0,0,0,0,6,6,0,6,6,0,165,1,0,1,4.04511,0.255639,34.3534,78.0625,133,4
India,259,242.378,7.15058,0.339768,244.568,7.12741,0.30888,692,RG Sharma,0,0,0,0,0,0,0,0,12,9,21,12,9,21,166,102,1,0,1,3.82836,0.268657,35.9179,83.083,134,4
India,259,242.378,7.15058,0.339768,244.568,7.12741,0.30888,692,S Dhawan,0,0,0,0,0,0,0,0,12,9,21,12,9,21,166,102,1,0,1,5.65217,0.362319,43.2174,88.9088,69,4
England,221,237.176,7.17647,0.289593,230.633,7.45701,0.384615,693,AN Cook,0,0,0,0,0,0,0,0,16,16,32,16,16,32,0,169,1,1,1,4.17045,0.272727,35.75,75.5524,88,4
England,221,237.176,7.17647,0.289593,230.633,7.45701,0.384615,693,IR Bell,0,0,0,0,0,0,0,0,16,16,32,16,16,32,0,169,1,1,1,3.63433,0.246269,35.3806,75.6623,134,4
England,221,237.176,7.17647,0.289593,230.633,7.45701,0.384615,693,IJL Trott,0,0,0,0,0,0,0,0,16,16,32,16,16,32,0,169,1,1,1,3.3871,0.403226,43.7903,75.2494,62,4
England,221,237.176,7.17647,0.289593,230.633,7.45701,0.384615,693,JE Root,0,0,0,0,0,0,0,0,16,16,32,16,16,32,0,169,1,1,1,3.68852,0.327869,41.6721,83.3443,61,4
New Zealand,184,233.745,7.39674,0.36413,227.951,7.30435,0.353261,693,MJ Guptill,0,0,0,0,0,0,0,0,4,10,14,4,10,14,170,159,3,0,1,4.8087,0.313043,38.1217,82.7482,115,4
New Zealand,184,233.745,7.39674,0.36413,227.951,7.30435,0.353261,693,L Ronchi,0,0,0,0,0,0,0,0,4,10,14,4,10,14,170,159,3,0,1,2.92157,0.0784314,22.1961,115.392,51,0
New Zealand,184,233.745,7.39674,0.36413,227.951,7.30435,0.353261,693,KS Williamson,0,0,0,0,0,0,0,0,4,10,14,4,10,14,170,159,3,0,1,4.31707,0.390244,43.0488,82.8833,82,4
New Zealand,184,233.745,7.39674,0.36413,227.951,7.30435,0.353261,693,LRPL Taylor,0,0,0,0,0,0,0,0,4,10,14,4,10,14,170,159,3,0,1,3.68382,0.301471,36.7206,79.3959,136,4
New Zealand,184,233.745,7.39674,0.36413,227.951,7.30435,0.353261,694,RJ Nicol,0,0,0,0,0,0,0,0,4,5,9,4,5,9,0,250,3,0,1,3.3,0.2,29.25,73.4003,20,4
New Zealand,184,233.745,7.39674,0.36413,227.951,7.30435,0.353261,694,TWM Latham,0,0,0,0,0,0,0,0,4,5,9,4,5,9,0,250,3,0,1,2.76471,0.147059,25.3529,75.2182,34,4
Sri Lanka,244,223.373,7.09016,0.344262,227.578,7.47541,0.385246,694,WU Tharanga,0,0,0,0,0,0,0,0,16,8,24,16,8,24,251,118,1,1,1,3.93985,0.263158,32.9699,71.6035,133,4
Sri Lanka,244,223.373,7.09016,0.344262,227.578,7.47541,0.385246,694,TM Dilshan,0,0,0,0,0,0,0,0,16,8,24,16,8,24,251,118,1,1,1,4.60199,0.273632,38.3632,86.0219,201,4
Sri Lanka,244,223.373,7.09016,0.344262,227.578,7.47541,0.385246,694,KC Sangakkara,0,0,0,0,0,0,0,0,16,8,24,16,8,24,251,118,1,1,1,4.33659,0.360976,41.9854,80.6276,205,4
New Zealand,184,233.745,7.39674,0.36413,227.951,7.30435,0.353261,695,RJ Nicol,0,0,0,0,0,0,0,0,0,11,11,0,11,11,0,188,1,0,1,3.3,0.2,29.25,73.4003,20,4
New Zealand,184,233.745,7.39674,0.36413,227.951,7.30435,0.353261,695,BJ Watling,0,0,0,0,0,0,0,0,0,11,11,0,11,11,0,188,1,0,1,3,0.263158,27.7895,66.9202,19,4
New Zealand,184,233.745,7.39674,0.36413,227.951,7.30435,0.353261,695,BB McCullum,0,0,0,0,0,0,0,0,0,11,11,0,11,11,0,188,1,0,1,3.98611,0.201389,29.9028,98.4004,144,0
Sri Lanka,244,223.373,7.09016,0.344262,227.578,7.47541,0.385246,695,WU Tharanga,0,0,0,0,0,0,0,0,20,6,26,20,6,26,189,200,4,1,1,3.93985,0.263158,32.9699,71.6035,133,4
Sri Lanka,244,223.373,7.09016,0.344262,227.578,7.47541,0.385246,695,TM Dilshan,0,0,0,0,0,0,0,0,20,6,26,20,6,26,189,200,4,1,1,4.60199,0.273632,38.3632,86.0219,201,4
Sri Lanka,244,223.373,7.09016,0.344262,227.578,7.47541,0.385246,695,KC Sangakkara,0,0,0,0,0,0,0,0,20,6,26,20,6,26,189,200,4,1,1,4.33659,0.360976,41.9854,80.6276,205,4
New Zealand,184,233.745,7.39674,0.36413,227.951,7.30435,0.353261,696,RJ Nicol,0,0,0,0,0,0,0,0,8,5,13,8,5,13,0,131,0,0,1,3.3,0.2,29.25,73.4003,20,4
New Zealand,184,233.745,7.39674,0.36413,227.951,7.30435,0.353261,696,BJ Watling,0,0,0,0,0,0,0,0,8,5,13,8,5,13,0,131,0,0,1,3,0.263158,27.7895,66.9202,19,4
Sri Lanka,244,223.373,7.09016,0.344262,227.578,7.47541,0.385246,696,WU Tharanga,0,0,0,0,0,0,0,0,8,10,18,8,10,18,132,131,3,1,1,3.93985,0.263158,32.9699,71.6035,133,4
Sri Lanka,244,223.373,7.09016,0.344262,227.578,7.47541,0.385246,696,LD Chandimal,0,0,0,0,0,0,0,0,8,10,18,8,10,18,132,131,3,1,1,2.18478,0.184783,25.7391,73.8615,92,4
West Indies,176,217.33,7.15909,0.3125,225.278,7.57386,0.380682,697,LMP Simmons,0,0,0,0,0,0,0,0,18,3,21,18,3,21,0,199,0,0,1,3.3125,0.28125,30.5938,71.4338,64,4
West Indies,176,217.33,7.15909,0.3125,225.278,7.57386,0.380682,697,CH Gayle,0,0,0,0,0,0,0,0,18,3,21,18,3,21,0,199,0,0,1,4.58621,0.206897,31.1293,89.4255,116,4
Bangladesh,160,218.438,7.70625,0.4,211.106,7.05,0.325,697,Tamim Iqbal,0,0,0,0,0,0,0,0,14,4,18,14,4,18,200,201,3,1,1,4.05344,0.274809,31.8015,76.8068,131,4
Bangladesh,160,218.438,7.70625,0.4,211.106,7.05,0.325,697,Anamul Haque,0,0,0,0,0,0,0,0,14,4,18,14,4,18,200,201,3,1,1,4.12,0.24,36.8,69.6442,25,4
Bangladesh,160,218.438,7.70625,0.4,211.106,7.05,0.325,698,Tamim Iqbal,0,0,0,0,0,0,0,0,8,5,13,8,5,13,0,292,3,1,1,4.05344,0.274809,31.8015,76.8068,131,4
Bangladesh,160,218.438,7.70625,0.4,211.106,7.05,0.325,698,Anamul Haque,0,0,0,0,0,0,0,0,8,5,13,8,5,13,0,292,3,1,1,4.12,0.24,36.8,69.6442,25,4
Bangladesh,160,218.438,7.70625,0.4,211.106,7.05,0.325,698,Naeem Islam,0,0,0,0,0,0,0,0,8,5,13,8,5,13,0,292,3,1,1,1.88889,0.111111,18.6889,67.496,45,1
West Indies,176,217.33,7.15909,0.3125,225.278,7.57386,0.380682,698,LMP Simmons,0,0,0,0,0,0,0,0,10,4,14,10,4,14,293,132,2,0,1,3.3125,0.28125,30.5938,71.4338,64,4
West Indies,176,217.33,7.15909,0.3125,225.278,7.57386,0.380682,698,CH Gayle,0,0,0,0,0,0,0,0,10,4,14,10,4,14,293,132,2,0,1,4.58621,0.206897,31.1293,89.4255,116,4
West Indies,176,217.33,7.15909,0.3125,225.278,7.57386,0.380682,698,DM Bravo,0,0,0,0,0,0,0,0,10,4,14,10,4,14,293,132,2,0,1,3,0.226667,28.52,67.4551,75,4
Bangladesh,160,218.438,7.70625,0.4,211.106,7.05,0.325,699,Tamim Iqbal,0,0,0,0,0,0,0,0,4,9,13,4,9,13,0,227,2,1,1,4.05344,0.274809,31.8015,76.8068,131,4
Bangladesh,160,218.438,7.70625,0.4,211.106,7.05,0.325,699,Anamul Haque,0,0,0,0,0,0,0,0,4,9,13,4,9,13,0,227,2,1,1,4.12,0.24,36.8,69.6442,25,4
West Indies,176,217.33,7.15909,0.3125,225.278,7.57386,0.380682,699,CH Gayle,0,0,0,0,0,0,0,0,14,4,18,14,4,18,228,228,0,0,1,4.58621,0.206897,31.1293,89.4255,116,4
West Indies,176,217.33,7.15909,0.3125,225.278,7.57386,0.380682,699,KOA Powell,0,0,0,0,0,0,0,0,14,4,18,14,4,18,228,228,0,0,1,3.59259,0.222222,26.4815,80.6088,27,4
West Indies,176,217.33,7.15909,0.3125,225.278,7.57386,0.380682,699,MN Samuels,0,0,0,0,0,0,0,0,14,4,18,14,4,18,228,228,0,0,1,3.74757,0.23301,31.6214,74.5821,103,4
West Indies,176,217.33,7.15909,0.3125,225.278,7.57386,0.380682,700,CH Gayle,0,0,0,0,0,0,0,0,8,5,13,8,5,13,0,211,4,0,1,4.58621,0.206897,31.1293,89.4255,116,4
West Indies,176,217.33,7.15909,0.3125,225.278,7.57386,0.380682,700,KOA Powell,0,0,0,0,0,0,0,0,8,5,13,8,5,13,0,211,4,0,1,3.59259,0.222222,26.4815,80.6088,27,4
Bangladesh,160,218.438,7.70625,0.4,211.106,7.05,0.325,700,Tamim Iqbal,0,0,0,0,0,0,0,0,0,7,7,0,7,7,212,136,5,1,1,4.05344,0.274809,31.8015,76.8068,131,4
Bangladesh,160,218.438,7.70625,0.4,211.106,7.05,0.325,700,Anamul Haque,0,0,0,0,0,0,0,0,0,7,7,0,7,7,212,136,5,1,1,4.12,0.24,36.8,69.6442,25,4
Bangladesh,160,218.438,7.70625,0.4,211.106,7.05,0.325,700,Naeem Islam,0,0,0,0,0,0,0,0,0,7,7,0,7,7,212,136,5,1,1,1.88889,0.111111,18.6889,67.496,45,1
Bangladesh,160,218.438,7.70625,0.4,211.106,7.05,0.325,700,Mushfiqur Rahim,0,0,0,0,0,0,0,0,0,7,7,0,7,7,212,136,5,1,1,2.61111,0.18254,27.7778,75.2526,126,4
Bangladesh,160,218.438,7.70625,0.4,211.106,7.05,0.325,700,Nasir Hossain,0,0,0,0,0,0,0,0,0,7,7,0,7,7,212,136,5,1,1,2.75,0.159091,27.0455,79.3863,44,4
Bangladesh,160,218.438,7.70625,0.4,211.106,7.05,0.325,700,Mominul Haque,0,0,0,0,0,0,0,0,0,7,7,0,7,7,212,136,5,1,1,2.57143,0.0952381,23.3333,73.4633,21,4
West Indies,176,217.33,7.15909,0.3125,225.278,7.57386,0.380682,701,KOA Powell,0,0,0,0,0,0,0,0,8,6,14,8,6,14,0,217,3,0,1,3.59259,0.222222,26.4815,80.6088,27,4
West Indies,176,217.33,7.15909,0.3125,225.278,7.57386,0.380682,701,CH Gayle,0,0,0,0,0,0,0,0,8,6,14,8,6,14,0,217,3,0,1,4.58621,0.206897,31.1293,89.4255,116,4
West Indies,176,217.33,7.15909,0.3125,225.278,7.57386,0.380682,701,MN Samuels,0,0,0,0,0,0,0,0,8,6,14,8,6,14,0,217,3,0,1,3.74757,0.23301,31.6214,74.5821,103,4
Bangladesh,160,218.438,7.70625,0.4,211.106,7.05,0.325,701,Tamim Iqbal,0,0,0,0,0,0,0,0,20,2,22,20,2,22,218,221,0,1,1,4.05344,0.274809,31.8015,76.8068,131,4
Bangladesh,160,218.438,7.70625,0.4,211.106,7.05,0.325,701,Anamul Haque,0,0,0,0,0,0,0,0,20,2,22,20,2,22,218,221,0,1,1,4.12,0.24,36.8,69.6442,25,4
Bangladesh,160,218.438,7.70625,0.4,211.106,7.05,0.325,701,Jahurul Islam,0,0,0,0,0,0,0,0,20,2,22,20,2,22,218,221,0,1,1,2.18182,0.0909091,20.5455,69.5385,11,1
Bangladesh,160,218.438,7.70625,0.4,211.106,7.05,0.325,701,Mushfiqur Rahim,0,0,0,0,0,0,0,0,20,2,22,20,2,22,218,221,0,1,1,2.61111,0.18254,27.7778,75.2526,126,4
India,259,242.378,7.15058,0.339768,244.568,7.12741,0.30888,702,G Gambhir,0,0,0,0,0,0,0,0,8,6,14,8,6,14,0,227,5,1,1,3.99145,0.333333,37.4701,84.1944,117,4
India,259,242.378,7.15058,0.339768,244.568,7.12741,0.30888,702,V Sehwag,0,0,0,0,0,0,0,0,8,6,14,8,6,14,0,227,5,1,1,5.88636,0.238636,38.8295,108.649,88,0
India,259,242.378,7.15058,0.339768,244.568,7.12741,0.30888,702,V Kohli,0,0,0,0,0,0,0,0,8,6,14,8,6,14,0,227,5,1,1,4.66456,0.379747,44.9937,88.3325,158,4
India,259,242.378,7.15058,0.339768,244.568,7.12741,0.30888,702,Yuvraj Singh,0,0,0,0,0,0,0,0,8,6,14,8,6,14,0,227,5,1,1,4.05833,0.258333,32.525,83.8093,120,4
Pakistan,211,222.621,7.38389,0.393365,235.517,7.54976,0.336493,702,Mohammad Hafeez,0,0,0,0,0,0,0,0,0,4,4,0,4,4,228,228,4,0,1,4.04511,0.255639,34.3534,78.0625,133,4
Pakistan,211,222.621,7.38389,0.393365,235.517,7.54976,0.336493,702,Azhar Ali,0,0,0,0,0,0,0,0,0,4,4,0,4,4,228,228,4,0,1,3.83333,0.3,38.5333,73.6775,30,4
Pakistan,211,222.621,7.38389,0.393365,235.517,7.54976,0.336493,702,Nasir Jamshed,0,0,0,0,0,0,0,0,0,4,4,0,4,4,228,228,4,0,1,3.63043,0.23913,30.2174,73.8184,46,4
India,259,242.378,7.15058,0.339768,244.568,7.12741,0.30888,703,G Gambhir,0,0,0,0,0,0,0,0,12,10,22,12,10,22,0,167,2,1,1,3.99145,0.333333,37.4701,84.1944,117,4
India,259,242.378,7.15058,0.339768,244.568,7.12741,0.30888,703,AM Rahane,0,0,0,0,0,0,0,0,12,10,22,12,10,22,0,167,2,1,1,3.55738,0.262295,32.2295,78.0159,61,4
India,259,242.378,7.15058,0.339768,244.568,7.12741,0.30888,703,V Kohli,0,0,0,0,0,0,0,0,12,10,22,12,10,22,0,167,2,1,1,4.66456,0.379747,44.9937,88.3325,158,4
Pakistan,211,222.621,7.38389,0.393365,235.517,7.54976,0.336493,703,Nasir Jamshed,0,0,0,0,0,0,0,0,4,4,8,4,4,8,168,157,1,0,1,3.63043,0.23913,30.2174,73.8184,46,4
Pakistan,211,222.621,7.38389,0.393365,235.517,7.54976,0.336493,703,Kamran Akmal,0,0,0,0,0,0,0,0,4,4,8,4,4,8,168,157,1,0,1,3.01124,0.11236,23.0787,81.4433,89,4
Pakistan,211,222.621,7.38389,0.393365,235.517,7.54976,0.336493,703,Younis Khan,0,0,0,0,0,0,0,0,4,4,8,4,4,8,168,157,1,0,1,2.64655,0.215517,28.5,73.2713,116,4
West Indies,176,217.33,7.15909,0.3125,225.278,7.57386,0.380682,705,J Charles,0,0,0,0,0,0,0,0,8,12,20,8,12,20,0,337,1,1,1,3.82353,0.147059,28.2353,81.2183,34,4
West Indies,176,217.33,7.15909,0.3125,225.278,7.57386,0.380682,705,KOA Powell,0,0,0,0,0,0,0,0,8,12,20,8,12,20,0,337,1,1,1,3.59259,0.222222,26.4815,80.6088,27,4
Zimbabwe,142,212.077,7.5,0.380282,227.704,6.97887,0.316901,705,V Sibanda,0,0,0,0,0,0,0,0,14,4,18,14,4,18,338,181,4,0,1,2.9697,0.181818,23.5152,63.5545,66,1
Zimbabwe,142,212.077,7.5,0.380282,227.704,6.97887,0.316901,705,CJ Chibhabha,0,0,0,0,0,0,0,0,14,4,18,14,4,18,338,181,4,0,1,2.56716,0.149254,23.5373,64.7373,67,1
Zimbabwe,142,212.077,7.5,0.380282,227.704,6.97887,0.316901,705,H Masakadza,0,0,0,0,0,0,0,0,14,4,18,14,4,18,338,181,4,0,1,3.11215,0.186916,26.972,70.0485,107,4
Zimbabwe,142,212.077,7.5,0.380282,227.704,6.97887,0.316901,706,TMK Mawoyo,0,0,0,0,0,0,0,0,0,10,10,0,10,10,0,211,0,0,1,0.571429,0,8.28571,34.9398,7,3
Zimbabwe,142,212.077,7.5,0.380282,227.704,6.97887,0.316901,706,V Sibanda,0,0,0,0,0,0,0,0,0,10,10,0,10,10,0,211,0,0,1,2.9697,0.181818,23.5152,63.5545,66,1
West Indies,176,217.33,7.15909,0.3125,225.278,7.57386,0.380682,706,KOA Powell,0,0,0,0,0,0,0,0,8,9,17,8,9,17,212,215,1,1,1,3.59259,0.222222,26.4815,80.6088,27,4
West Indies,176,217.33,7.15909,0.3125,225.278,7.57386,0.380682,706,RR Sarwan,0,0,0,0,0,0,0,0,8,9,17,8,9,17,212,215,1,1,1,2.8254,0.222222,29.1429,69.1005,63,4
Sri Lanka,244,223.373,7.09016,0.344262,227.578,7.47541,0.385246,707,WU Tharanga,0,0,0,0,0,0,0,0,12,8,20,12,8,20,0,208,0,0,1,3.93985,0.263158,32.9699,71.6035,133,4
Sri Lanka,244,223.373,7.09016,0.344262,227.578,7.47541,0.385246,707,DPMD Jayawardene,0,0,0,0,0,0,0,0,12,8,20,12,8,20,0,208,0,0,1,3.20833,0.244792,31.6979,79.1109,192,4
West Indies,176,217.33,7.15909,0.3125,225.278,7.57386,0.380682,707,CH Gayle,0,0,0,0,0,0,0,0,8,4,12,8,4,12,209,209,4,1,1,4.58621,0.206897,31.1293,89.4255,116,4
West Indies,176,217.33,7.15909,0.3125,225.278,7.57386,0.380682,707,J Charles,0,0,0,0,0,0,0,0,8,4,12,8,4,12,209,209,4,1,1,3.82353,0.147059,28.2353,81.2183,34,4
India,259,242.378,7.15058,0.339768,244.568,7.12741,0.30888,708,RG Sharma,0,0,0,0,0,0,0,0,14,9,23,14,9,23,0,229,2,0,1,3.82836,0.268657,35.9179,83.083,134,4
India,259,242.378,7.15058,0.339768,244.568,7.12741,0.30888,708,S Dhawan,0,0,0,0,0,0,0,0,14,9,23,14,9,23,0,229,2,0,1,5.65217,0.362319,43.2174,88.9088,69,4
India,259,242.378,7.15058,0.339768,244.568,7.12741,0.30888,708,V Kohli,0,0,0,0,0,0,0,0,14,9,23,14,9,23,0,229,2,0,1,4.66456,0.379747,44.9937,88.3325,158,4
West Indies,176,217.33,7.15909,0.3125,225.278,7.57386,0.380682,708,CH Gayle,0,0,0,0,0,0,0,0,20,4,24,20,4,24,230,230,2,1,1,4.58621,0.206897,31.1293,89.4255,116,4
West Indies,176,217.33,7.15909,0.3125,225.278,7.57386,0.380682,708,J Charles,0,0,0,0,0,0,0,0,20,4,24,20,4,24,230,230,2,1,1,3.82353,0.147059,28.2353,81.2183,34,4
West Indies,176,217.33,7.15909,0.3125,225.278,7.57386,0.380682,708,DS Smith,0,0,0,0,0,0,0,0,20,4,24,20,4,24,230,230,2,1,1,2.61765,0.147059,23.5588,71.2,34,4
West Indies,176,217.33,7.15909,0.3125,225.278,7.57386,0.380682,708,MN Samuels,0,0,0,0,0,0,0,0,20,4,24,20,4,24,230,230,2,1,1,3.74757,0.23301,31.6214,74.5821,103,4
West Indies,176,217.33,7.15909,0.3125,225.278,7.57386,0.380682,708,DM Bravo,0,0,0,0,0,0,0,0,20,4,24,20,4,24,230,230,2,1,1,3,0.226667,28.52,67.4551,75,4
Sri Lanka,244,223.373,7.09016,0.344262,227.578,7.47541,0.385246,709,WU Tharanga,0,0,0,0,0,0,0,0,4,11,15,4,11,15,0,348,1,0,1,3.93985,0.263158,32.9699,71.6035,133,4
Sri Lanka,244,223.373,7.09016,0.344262,227.578,7.47541,0.385246,709,DPMD Jayawardene,0,0,0,0,0,0,0,0,4,11,15,4,11,15,0,348,1,0,1,3.20833,0.244792,31.6979,79.1109,192,4
India,259,242.378,7.15058,0.339768,244.568,7.12741,0.30888,709,RG Sharma,0,0,0,0,0,0,0,0,4,8,12,4,8,12,349,187,1,0,1,3.82836,0.268657,35.9179,83.083,134,4
India,259,242.378,7.15058,0.339768,244.568,7.12741,0.30888,709,S Dhawan,0,0,0,0,0,0,0,0,4,8,12,4,8,12,349,187,1,0,1,5.65217,0.362319,43.2174,88.9088,69,4
India,259,242.378,7.15058,0.339768,244.568,7.12741,0.30888,709,M Vijay,0,0,0,0,0,0,0,0,4,8,12,4,8,12,349,187,1,0,1,2.25,0.0625,21.1875,65.6977,16,1
India,259,242.378,7.15058,0.339768,244.568,7.12741,0.30888,710,RG Sharma,0,0,0,0,0,0,0,0,16,6,22,16,6,22,0,311,0,0,1,3.82836,0.268657,35.9179,83.083,134,4
India,259,242.378,7.15058,0.339768,244.568,7.12741,0.30888,710,S Dhawan,0,0,0,0,0,0,0,0,16,6,22,16,6,22,0,311,0,0,1,5.65217,0.362319,43.2174,88.9088,69,4
West Indies,176,217.33,7.15909,0.3125,225.278,7.57386,0.380682,710,CH Gayle,0,0,0,0,0,0,0,0,16,5,21,16,5,21,312,171,4,1,1,4.58621,0.206897,31.1293,89.4255,116,4
West Indies,176,217.33,7.15909,0.3125,225.278,7.57386,0.380682,710,J Charles,0,0,0,0,0,0,0,0,16,5,21,16,5,21,312,171,4,1,1,3.82353,0.147059,28.2353,81.2183,34,4
West Indies,176,217.33,7.15909,0.3125,225.278,7.57386,0.380682,710,DM Bravo,0,0,0,0,0,0,0,0,16,5,21,16,5,21,312,171,4,1,1,3,0.226667,28.52,67.4551,75,4
Sri Lanka,244,223.373,7.09016,0.344262,227.578,7.47541,0.385246,711,WU Tharanga,0,0,0,0,0,0,0,0,8,8,16,8,8,16,0,219,5,0,1,3.93985,0.263158,32.9699,71.6035,133,4
Sri Lanka,244,223.373,7.09016,0.344262,227.578,7.47541,0.385246,711,DPMD Jayawardene,0,0,0,0,0,0,0,0,8,8,16,8,8,16,0,219,5,0,1,3.20833,0.244792,31.6979,79.1109,192,4
Sri Lanka,244,223.373,7.09016,0.344262,227.578,7.47541,0.385246,711,LD Chandimal,0,0,0,0,0,0,0,0,8,8,16,8,8,16,0,219,5,0,1,2.18478,0.184783,25.7391,73.8615,92,4
Sri Lanka,244,223.373,7.09016,0.344262,227.578,7.47541,0.385246,711,KC Sangakkara,0,0,0,0,0,0,0,0,8,8,16,8,8,16,0,219,5,0,1,4.33659,0.360976,41.9854,80.6276,205,4
West Indies,176,217.33,7.15909,0.3125,225.278,7.57386,0.380682,711,CH Gayle,0,0,0,0,0,0,0,0,16,8,24,16,8,24,220,190,1,1,1,4.58621,0.206897,31.1293,89.4255,116,4
West Indies,176,217.33,7.15909,0.3125,225.278,7.57386,0.380682,711,J Charles,0,0,0,0,0,0,0,0,16,8,24,16,8,24,220,190,1,1,1,3.82353,0.147059,28.2353,81.2183,34,4
West Indies,176,217.33,7.15909,0.3125,225.278,7.57386,0.380682,711,DS Smith,0,0,0,0,0,0,0,0,16,8,24,16,8,24,220,190,1,1,1,2.61765,0.147059,23.5588,71.2,34,4
Sri Lanka,244,223.373,7.09016,0.344262,227.578,7.47541,0.385246,712,WU Tharanga,0,0,0,0,0,0,0,0,8,7,15,8,7,15,0,201,6,0,1,3.93985,0.263158,32.9699,71.6035,133,4
Sri Lanka,244,223.373,7.09016,0.344262,227.578,7.47541,0.385246,712,DPMD Jayawardene,0,0,0,0,0,0,0,0,8,7,15,8,7,15,0,201,6,0,1,3.20833,0.244792,31.6979,79.1109,192,4
India,259,242.378,7.15058,0.339768,244.568,7.12741,0.30888,712,RG Sharma,0,0,0,0,0,0,0,0,4,10,14,4,10,14,202,203,2,0,1,3.82836,0.268657,35.9179,83.083,134,4
India,259,242.378,7.15058,0.339768,244.568,7.12741,0.30888,712,S Dhawan,0,0,0,0,0,0,0,0,4,10,14,4,10,14,202,203,2,0,1,5.65217,0.362319,43.2174,88.9088,69,4
Pakistan,211,222.621,7.38389,0.393365,235.517,7.54976,0.336493,714,Imran Farhat,0,0,0,0,0,0,0,0,0,6,6,0,6,6,0,266,2,0,1,3.03333,0.266667,27.0333,62.9658,30,4
Pakistan,211,222.621,7.38389,0.393365,235.517,7.54976,0.336493,714,Nasir Jamshed,0,0,0,0,0,0,0,0,0,6,6,0,6,6,0,266,2,0,1,3.63043,0.23913,30.2174,73.8184,46,4
Ireland,55,219.527,7.65455,0.290909,202.727,7.56364,0.4,714,WTS Porterfield,0,0,0,0,0,0,0,0,16,7,23,16,7,23,267,275,3,1,1,2.6,0.142857,24.6857,56.2866,35,3
Ireland,55,219.527,7.65455,0.290909,202.727,7.56364,0.4,714,PR Stirling,0,0,0,0,0,0,0,0,16,7,23,16,7,23,267,275,3,1,1,3.47826,0.173913,24.2174,88.1329,23,0
Ireland,55,219.527,7.65455,0.290909,202.727,7.56364,0.4,715,WTS Porterfield,0,0,0,0,0,0,0,0,8,4,12,8,4,12,0,229,2,1,1,2.6,0.142857,24.6857,56.2866,35,3
Ireland,55,219.527,7.65455,0.290909,202.727,7.56364,0.4,715,PR Stirling,0,0,0,0,0,0,0,0,8,4,12,8,4,12,0,229,2,1,1,3.47826,0.173913,24.2174,88.1329,23,0
Ireland,55,219.527,7.65455,0.290909,202.727,7.56364,0.4,715,EC Joyce,0,0,0,0,0,0,0,0,8,4,12,8,4,12,0,229,2,1,1,3.08571,0.2,28.3429,68.6505,35,4
Ireland,55,219.527,7.65455,0.290909,202.727,7.56364,0.4,715,NJ O'Brien,0,0,0,0,0,0,0,0,8,4,12,8,4,12,0,229,2,1,1,2.55882,0.176471,25.5882,69.378,34,4
Pakistan,211,222.621,7.38389,0.393365,235.517,7.54976,0.336493,715,Imran Farhat,0,0,0,0,0,0,0,0,0,5,5,0,5,5,230,230,3,0,1,3.03333,0.266667,27.0333,62.9658,30,4
Pakistan,211,222.621,7.38389,0.393365,235.517,7.54976,0.336493,715,Nasir Jamshed,0,0,0,0,0,0,0,0,0,5,5,0,5,5,230,230,3,0,1,3.63043,0.23913,30.2174,73.8184,46,4
Bangladesh,160,218.438,7.70625,0.4,211.106,7.05,0.325,716,Tamim Iqbal,0,0,0,0,0,0,0,0,4,15,19,4,15,19,0,259,6,0,1,4.05344,0.274809,31.8015,76.8068,131,4
Bangladesh,160,218.438,7.70625,0.4,211.106,7.05,0.325,716,Anamul Haque,0,0,0,0,0,0,0,0,4,15,19,4,15,19,0,259,6,0,1,4.12,0.24,36.8,69.6442,25,4
Sri Lanka,244,223.373,7.09016,0.344262,227.578,7.47541,0.385246,716,MDKJ Perera,0,0,0,0,0,0,0,0,48,9,57,48,9,57,260,238,3,1,1,3.30435,0.195652,25.7391,90.5199,46,0
Sri Lanka,244,223.373,7.09016,0.344262,227.578,7.47541,0.385246,716,TM Dilshan,0,0,0,0,0,0,0,0,48,9,57,48,9,57,260,238,3,1,1,4.60199,0.273632,38.3632,86.0219,201,4
Sri Lanka,244,223.373,7.09016,0.344262,227.578,7.47541,0.385246,717,MDKJ Perera,0,0,0,0,0,0,0,0,26,10,36,26,10,36,0,302,0,1,1,3.30435,0.195652,25.7391,90.5199,46,0
Sri Lanka,244,223.373,7.09016,0.344262,227.578,7.47541,0.385246,717,TM Dilshan,0,0,0,0,0,0,0,0,26,10,36,26,10,36,0,302,0,1,1,4.60199,0.273632,38.3632,86.0219,201,4
Bangladesh,160,218.438,7.70625,0.4,211.106,7.05,0.325,717,Anamul Haque,0,0,0,0,0,0,0,0,20,7,27,20,7,27,303,184,11,0,1,4.12,0.24,36.8,69.6442,25,4
Bangladesh,160,218.438,7.70625,0.4,211.106,7.05,0.325,717,Mohammad Ashraful,0,0,0,0,0,0,0,0,20,7,27,20,7,27,303,184,11,0,1,2.17722,0.113924,19.4557,63.9085,79,1
Bangladesh,160,218.438,7.70625,0.4,211.106,7.05,0.325,718,Tamim Iqbal,0,0,0,0,0,0,0,0,8,10,18,8,10,18,0,269,3,0,1,4.05344,0.274809,31.8015,76.8068,131,4
Bangladesh,160,218.438,7.70625,0.4,211.106,7.05,0.325,718,Mohammad Ashraful,0,0,0,0,0,0,0,0,8,10,18,8,10,18,0,269,3,0,1,2.17722,0.113924,19.4557,63.9085,79,1
Zimbabwe,142,212.077,7.5,0.380282,227.704,6.97887,0.316901,718,H Masakadza,0,0,0,0,0,0,0,0,12,6,18,12,6,18,270,148,5,1,1,3.11215,0.186916,26.972,70.0485,107,4
Zimbabwe,142,212.077,7.5,0.380282,227.704,6.97887,0.316901,718,RW Chakabva,0,0,0,0,0,0,0,0,12,6,18,12,6,18,270,148,5,1,1,0.846154,0,13.2692,51.3393,26,3
Zimbabwe,142,212.077,7.5,0.380282,227.704,6.97887,0.316901,718,Sikandar Raza,0,0,0,0,0,0,0,0,12,6,18,12,6,18,270,148,5,1,1,3,0.131579,26.1842,81.1582,38,4
Zimbabwe,142,212.077,7.5,0.380282,227.704,6.97887,0.316901,718,BRM Taylor,0,0,0,0,0,0,0,0,12,6,18,12,6,18,270,148,5,1,1,3.3,0.26,33.56,76.3421,100,4
Bangladesh,160,218.438,7.70625,0.4,211.106,7.05,0.325,719,Tamim Iqbal,0,0,0,0,0,0,0,0,4,9,13,4,9,13,0,252,1,0,1,4.05344,0.274809,31.8015,76.8068,131,4
Bangladesh,160,218.438,7.70625,0.4,211.106,7.05,0.325,719,Mohammad Ashraful,0,0,0,0,0,0,0,0,4,9,13,4,9,13,0,252,1,0,1,2.17722,0.113924,19.4557,63.9085,79,1
Bangladesh,160,218.438,7.70625,0.4,211.106,7.05,0.325,719,Mominul Haque,0,0,0,0,0,0,0,0,4,9,13,4,9,13,0,252,1,0,1,2.57143,0.0952381,23.3333,73.4633,21,4
Zimbabwe,142,212.077,7.5,0.380282,227.704,6.97887,0.316901,719,H Masakadza,0,0,0,0,0,0,0,0,20,10,30,20,10,30,253,253,5,1,1,3.11215,0.186916,26.972,70.0485,107,4
Zimbabwe,142,212.077,7.5,0.380282,227.704,6.97887,0.316901,719,V Sibanda,0,0,0,0,0,0,0,0,20,10,30,20,10,30,253,253,5,1,1,2.9697,0.181818,23.5152,63.5545,66,1
Zimbabwe,142,212.077,7.5,0.380282,227.704,6.97887,0.316901,719,Sikandar Raza,0,0,0,0,0,0,0,0,20,10,30,20,10,30,253,253,5,1,1,3,0.131579,26.1842,81.1582,38,4
Bangladesh,160,218.438,7.70625,0.4,211.106,7.05,0.325,720,Tamim Iqbal,0,0,0,0,0,0,0,0,10,9,19,10,9,19,0,247,1,0,1,4.05344,0.274809,31.8015,76.8068,131,4
Bangladesh,160,218.438,7.70625,0.4,211.106,7.05,0.325,720,Mohammad Ashraful,0,0,0,0,0,0,0,0,10,9,19,10,9,19,0,247,1,0,1,2.17722,0.113924,19.4557,63.9085,79,1
Bangladesh,160,218.438,7.70625,0.4,211.106,7.05,0.325,720,Jahurul Islam,0,0,0,0,0,0,0,0,10,9,19,10,9,19,0,247,1,0,1,2.18182,0.0909091,20.5455,69.5385,11,1
Bangladesh,160,218.438,7.70625,0.4,211.106,7.05,0.325,720,Mushfiqur Rahim,0,0,0,0,0,0,0,0,10,9,19,10,9,19,0,247,1,0,1,2.61111,0.18254,27.7778,75.2526,126,4
Zimbabwe,142,212.077,7.5,0.380282,227.704,6.97887,0.316901,720,V Sibanda,0,0,0,0,0,0,0,0,8,10,18,8,10,18,248,251,2,1,1,2.9697,0.181818,23.5152,63.5545,66,1
Zimbabwe,142,212.077,7.5,0.380282,227.704,6.97887,0.316901,720,H Masakadza,0,0,0,0,0,0,0,0,8,10,18,8,10,18,248,251,2,1,1,3.11215,0.186916,26.972,70.0485,107,4
Sri Lanka,244,223.373,7.09016,0.344262,227.578,7.47541,0.385246,721,WU Tharanga,0,0,0,0,0,0,0,0,12,7,19,12,7,19,0,320,8,1,1,3.93985,0.263158,32.9699,71.6035,133,4
Sri Lanka,244,223.373,7.09016,0.344262,227.578,7.47541,0.385246,721,TM Dilshan,0,0,0,0,0,0,0,0,12,7,19,12,7,19,0,320,8,1,1,4.60199,0.273632,38.3632,86.0219,201,4
Sri Lanka,244,223.373,7.09016,0.344262,227.578,7.47541,0.385246,721,KC Sangakkara,0,0,0,0,0,0,0,0,12,7,19,12,7,19,0,320,8,1,1,4.33659,0.360976,41.9854,80.6276,205,4
South Africa,190,234.274,7.4,0.373684,232.363,7.33158,0.342105,721,CA Ingram,0,0,0,0,0,0,0,0,12,6,18,12,6,18,321,140,7,0,1,3,0.178571,27.1786,81.3904,28,4
South Africa,190,234.274,7.4,0.373684,232.363,7.33158,0.342105,721,JP Duminy,0,0,0,0,0,0,0,0,12,6,18,12,6,18,321,140,7,0,1,2.3252,0.186992,29.9675,80.2351,123,4
South Africa,190,234.274,7.4,0.373684,232.363,7.33158,0.342105,721,AN Petersen,0,0,0,0,0,0,0,0,12,6,18,12,6,18,321,140,7,0,1,3.11111,0.222222,27.6667,81.6393,18,4
Sri Lanka,244,223.373,7.09016,0.344262,227.578,7.47541,0.385246,722,WU Tharanga,0,0,0,0,0,0,0,0,4,7,11,4,7,11,0,223,3,1,1,3.93985,0.263158,32.9699,71.6035,133,4
Sri Lanka,244,223.373,7.09016,0.344262,227.578,7.47541,0.385246,722,TM Dilshan,0,0,0,0,0,0,0,0,4,7,11,4,7,11,0,223,3,1,1,4.60199,0.273632,38.3632,86.0219,201,4
Sri Lanka,244,223.373,7.09016,0.344262,227.578,7.47541,0.385246,722,KC Sangakkara,0,0,0,0,0,0,0,0,4,7,11,4,7,11,0,223,3,1,1,4.33659,0.360976,41.9854,80.6276,205,4
South Africa,190,234.274,7.4,0.373684,232.363,7.33158,0.342105,722,AN Petersen,0,0,0,0,0,0,0,0,12,16,28,12,16,28,224,104,2,0,1,3.11111,0.222222,27.6667,81.6393,18,4
South Africa,190,234.274,7.4,0.373684,232.363,7.33158,0.342105,722,RJ Peterson,0,0,0,0,0,0,0,0,12,16,28,12,16,28,224,104,2,0,1,1.62069,0.0344828,15.7931,83.5766,29,1
South Africa,190,234.274,7.4,0.373684,232.363,7.33158,0.342105,722,JP Duminy,0,0,0,0,0,0,0,0,12,16,28,12,16,28,224,104,2,0,1,2.3252,0.186992,29.9675,80.2351,123,4
South Africa,190,234.274,7.4,0.373684,232.363,7.33158,0.342105,723,AN Petersen,0,0,0,0,0,0,0,0,8,6,14,8,6,14,0,223,1,0,1,3.11111,0.222222,27.6667,81.6393,18,4
South Africa,190,234.274,7.4,0.373684,232.363,7.33158,0.342105,723,Q de Kock,0,0,0,0,0,0,0,0,8,6,14,8,6,14,0,223,1,0,1,5.12963,0.240741,39.1111,91.2311,54,4
South Africa,190,234.274,7.4,0.373684,232.363,7.33158,0.342105,723,JP Duminy,0,0,0,0,0,0,0,0,8,6,14,8,6,14,0,223,1,0,1,2.3252,0.186992,29.9675,80.2351,123,4
Sri Lanka,244,223.373,7.09016,0.344262,227.578,7.47541,0.385246,723,WU Tharanga,0,0,0,0,0,0,0,0,8,3,11,8,3,11,224,167,4,1,1,3.93985,0.263158,32.9699,71.6035,133,4
Sri Lanka,244,223.373,7.09016,0.344262,227.578,7.47541,0.385246,723,TM Dilshan,0,0,0,0,0,0,0,0,8,3,11,8,3,11,224,167,4,1,1,4.60199,0.273632,38.3632,86.0219,201,4
Sri Lanka,244,223.373,7.09016,0.344262,227.578,7.47541,0.385246,723,KC Sangakkara,0,0,0,0,0,0,0,0,8,3,11,8,3,11,224,167,4,1,1,4.33659,0.360976,41.9854,80.6276,205,4
Sri Lanka,244,223.373,7.09016,0.344262,227.578,7.47541,0.385246,723,DPMD Jayawardene,0,0,0,0,0,0,0,0,8,3,11,8,3,11,224,167,4,1,1,3.20833,0.244792,31.6979,79.1109,192,4
South Africa,190,234.274,7.4,0.373684,232.363,7.33158,0.342105,724,HM Amla,0,0,0,0,0,0,0,0,24,6,30,24,6,30,0,238,0,0,1,5.20168,0.403361,48.7899,86.9292,119,4
South Africa,190,234.274,7.4,0.373684,232.363,7.33158,0.342105,724,Q de Kock,0,0,0,0,0,0,0,0,24,6,30,24,6,30,0,238,0,0,1,5.12963,0.240741,39.1111,91.2311,54,4
South Africa,190,234.274,7.4,0.373684,232.363,7.33158,0.342105,724,JP Duminy,0,0,0,0,0,0,0,0,24,6,30,24,6,30,0,238,0,0,1,2.3252,0.186992,29.9675,80.2351,123,4
Sri Lanka,244,223.373,7.09016,0.344262,227.578,7.47541,0.385246,724,TM Dilshan,0,0,0,0,0,0,0,0,4,7,11,4,7,11,239,239,5,1,1,4.60199,0.273632,38.3632,86.0219,201,4
Sri Lanka,244,223.373,7.09016,0.344262,227.578,7.47541,0.385246,724,DPMD Jayawardene,0,0,0,0,0,0,0,0,4,7,11,4,7,11,239,239,5,1,1,3.20833,0.244792,31.6979,79.1109,192,4
Sri Lanka,244,223.373,7.09016,0.344262,227.578,7.47541,0.385246,725,TM Dilshan,0,0,0,0,0,0,0,0,8,3,11,8,3,11,0,307,3,1,1,4.60199,0.273632,38.3632,86.0219,201,4
Sri Lanka,244,223.373,7.09016,0.344262,227.578,7.47541,0.385246,725,MDKJ Perera,0,0,0,0,0,0,0,0,8,3,11,8,3,11,0,307,3,1,1,3.30435,0.195652,25.7391,90.5199,46,0
Sri Lanka,244,223.373,7.09016,0.344262,227.578,7.47541,0.385246,725,HDRL Thirimanne,0,0,0,0,0,0,0,0,8,3,11,8,3,11,0,307,3,1,1,2.77778,0.246914,31.5802,71.4725,81,4
South Africa,190,234.274,7.4,0.373684,232.363,7.33158,0.342105,725,Q de Kock,0,0,0,0,0,0,0,0,24,8,32,24,8,32,308,179,0,0,1,5.12963,0.240741,39.1111,91.2311,54,4
South Africa,190,234.274,7.4,0.373684,232.363,7.33158,0.342105,725,HM Amla,0,0,0,0,0,0,0,0,24,8,32,24,8,32,308,179,0,0,1,5.20168,0.403361,48.7899,86.9292,119,4
England,221,237.176,7.17647,0.289593,230.633,7.45701,0.384615,726,AN Cook,0,0,0,0,0,0,0,0,8,10,18,8,10,18,0,269,1,0,1,4.17045,0.272727,35.75,75.5524,88,4
England,221,237.176,7.17647,0.289593,230.633,7.45701,0.384615,726,JE Root,0,0,0,0,0,0,0,0,8,10,18,8,10,18,0,269,1,0,1,3.68852,0.327869,41.6721,83.3443,61,4
England,221,237.176,7.17647,0.289593,230.633,7.45701,0.384615,726,IR Bell,0,0,0,0,0,0,0,0,8,10,18,8,10,18,0,269,1,0,1,3.63433,0.246269,35.3806,75.6623,134,4
Australia,228,239.627,7.69737,0.372807,232.079,7.23246,0.337719,726,AJ Finch,0,0,0,0,0,0,0,0,16,8,24,16,8,24,270,270,4,1,1,4.52941,0.313725,37.2549,83.4431,51,4
Australia,228,239.627,7.69737,0.372807,232.079,7.23246,0.337719,726,DA Warner,0,0,0,0,0,0,0,0,16,8,24,16,8,24,270,270,4,1,1,4.20312,0.265625,35.2031,87.7336,64,4
England,221,237.176,7.17647,0.289593,230.633,7.45701,0.384615,727,AN Cook,0,0,0,0,0,0,0,0,4,11,15,4,11,15,0,300,4,0,1,4.17045,0.272727,35.75,75.5524,88,4
England,221,237.176,7.17647,0.289593,230.633,7.45701,0.384615,727,IR Bell,0,0,0,0,0,0,0,0,4,11,15,4,11,15,0,300,4,0,1,3.63433,0.246269,35.3806,75.6623,134,4
Australia,228,239.627,7.69737,0.372807,232.079,7.23246,0.337719,727,DA Warner,0,0,0,0,0,0,0,0,16,14,30,16,14,30,301,301,1,1,1,4.20312,0.265625,35.2031,87.7336,64,4
Australia,228,239.627,7.69737,0.372807,232.079,7.23246,0.337719,727,AJ Finch,0,0,0,0,0,0,0,0,16,14,30,16,14,30,301,301,1,1,1,4.52941,0.313725,37.2549,83.4431,51,4
Australia,228,239.627,7.69737,0.372807,232.079,7.23246,0.337719,727,SE Marsh,0,0,0,0,0,0,0,0,16,14,30,16,14,30,301,301,1,1,1,3.66667,0.291667,35.5417,74.7918,48,4
England,221,237.176,7.17647,0.289593,230.633,7.45701,0.384615,728,AN Cook,0,0,0,0,0,0,0,0,22,8,30,22,8,30,0,243,0,0,1,4.17045,0.272727,35.75,75.5524,88,4
England,221,237.176,7.17647,0.289593,230.633,7.45701,0.384615,728,IR Bell,0,0,0,0,0,0,0,0,22,8,30,22,8,30,0,243,0,0,1,3.63433,0.246269,35.3806,75.6623,134,4
Australia,228,239.627,7.69737,0.372807,232.079,7.23246,0.337719,728,AJ Finch,0,0,0,0,0,0,0,0,12,15,27,12,15,27,244,244,3,1,1,4.52941,0.313725,37.2549,83.4431,51,4
Australia,228,239.627,7.69737,0.372807,232.079,7.23246,0.337719,728,DA Warner,0,0,0,0,0,0,0,0,12,15,27,12,15,27,244,244,3,1,1,4.20312,0.265625,35.2031,87.7336,64,4
England,221,237.176,7.17647,0.289593,230.633,7.45701,0.384615,729,AN Cook,0,0,0,0,0,0,0,0,8,12,20,8,12,20,0,316,4,0,1,4.17045,0.272727,35.75,75.5524,88,4
England,221,237.176,7.17647,0.289593,230.633,7.45701,0.384615,729,IR Bell,0,0,0,0,0,0,0,0,8,12,20,8,12,20,0,316,4,0,1,3.63433,0.246269,35.3806,75.6623,134,4
Australia,228,239.627,7.69737,0.372807,232.079,7.23246,0.337719,729,SE Marsh,0,0,0,0,0,0,0,0,28,11,39,28,11,39,317,259,1,1,1,3.66667,0.291667,35.5417,74.7918,48,4
Australia,228,239.627,7.69737,0.372807,232.079,7.23246,0.337719,729,AJ Finch,0,0,0,0,0,0,0,0,28,11,39,28,11,39,317,259,1,1,1,4.52941,0.313725,37.2549,83.4431,51,4
West Indies,176,217.33,7.15909,0.3125,225.278,7.57386,0.380682,730,DR Smith,0,0,0,0,0,0,0,0,10,9,19,10,9,19,0,269,0,1,1,2.5,0.12,17.96,84.5574,50,1
West Indies,176,217.33,7.15909,0.3125,225.278,7.57386,0.380682,730,KOA Powell,0,0,0,0,0,0,0,0,10,9,19,10,9,19,0,269,0,1,1,3.59259,0.222222,26.4815,80.6088,27,4
England,221,237.176,7.17647,0.289593,230.633,7.45701,0.384615,730,MJ Lumb,0,0,0,0,0,0,0,0,12,11,23,12,11,23,270,254,2,0,1,5,0.333333,55,80.0971,3,4
England,221,237.176,7.17647,0.289593,230.633,7.45701,0.384615,730,MM Ali,0,0,0,0,0,0,0,0,12,11,23,12,11,23,270,254,2,0,1,2.67647,0.117647,21.3824,94.5384,34,0
West Indies,176,217.33,7.15909,0.3125,225.278,7.57386,0.380682,731,DR Smith,0,0,0,0,0,0,0,0,8,12,20,8,12,20,0,159,0,1,1,2.5,0.12,17.96,84.5574,50,1
West Indies,176,217.33,7.15909,0.3125,225.278,7.57386,0.380682,731,KOA Powell,0,0,0,0,0,0,0,0,8,12,20,8,12,20,0,159,0,1,1,3.59259,0.222222,26.4815,80.6088,27,4
West Indies,176,217.33,7.15909,0.3125,225.278,7.57386,0.380682,731,KA Edwards,0,0,0,0,0,0,0,0,8,12,20,8,12,20,0,159,0,1,1,1.875,0.0625,20.6875,64.902,16,1
England,221,237.176,7.17647,0.289593,230.633,7.45701,0.384615,731,MJ Lumb,0,0,0,0,0,0,0,0,8,11,19,8,11,19,160,163,4,0,1,5,0.333333,55,80.0971,3,4
England,221,237.176,7.17647,0.289593,230.633,7.45701,0.384615,731,MM Ali,0,0,0,0,0,0,0,0,8,11,19,8,11,19,160,163,4,0,1,2.67647,0.117647,21.3824,94.5384,34,0
England,221,237.176,7.17647,0.289593,230.633,7.45701,0.384615,732,MJ Lumb,0,0,0,0,0,0,0,0,18,15,33,18,15,33,0,303,1,0,1,5,0.333333,55,80.0971,3,4
England,221,237.176,7.17647,0.289593,230.633,7.45701,0.384615,732,MM Ali,0,0,0,0,0,0,0,0,18,15,33,18,15,33,0,303,1,0,1,2.67647,0.117647,21.3824,94.5384,34,0
West Indies,176,217.33,7.15909,0.3125,225.278,7.57386,0.380682,732,KOA Powell,0,0,0,0,0,0,0,0,24,8,32,24,8,32,304,278,0,1,1,3.59259,0.222222,26.4815,80.6088,27,4
West Indies,176,217.33,7.15909,0.3125,225.278,7.57386,0.380682,732,DR Smith,0,0,0,0,0,0,0,0,24,8,32,24,8,32,304,278,0,1,1,2.5,0.12,17.96,84.5574,50,1
West Indies,176,217.33,7.15909,0.3125,225.278,7.57386,0.380682,732,LMP Simmons,0,0,0,0,0,0,0,0,24,8,32,24,8,32,304,278,0,1,1,3.3125,0.28125,30.5938,71.4338,64,4
West Indies,176,217.33,7.15909,0.3125,225.278,7.57386,0.380682,732,DM Bravo,0,0,0,0,0,0,0,0,24,8,32,24,8,32,304,278,0,1,1,3,0.226667,28.52,67.4551,75,4
Zimbabwe,142,212.077,7.5,0.380282,227.704,6.97887,0.316901,733,V Sibanda,0,0,0,0,0,0,0,0,4,5,9,4,5,9,0,228,0,1,1,2.9697,0.181818,23.5152,63.5545,66,1
Zimbabwe,142,212.077,7.5,0.380282,227.704,6.97887,0.316901,733,Sikandar Raza,0,0,0,0,0,0,0,0,4,5,9,4,5,9,0,228,0,1,1,3,0.131579,26.1842,81.1582,38,4
India,259,242.378,7.15058,0.339768,244.568,7.12741,0.30888,733,RG Sharma,0,0,0,0,0,0,0,0,12,6,18,12,6,18,229,230,1,0,1,3.82836,0.268657,35.9179,83.083,134,4
India,259,242.378,7.15058,0.339768,244.568,7.12741,0.30888,733,S Dhawan,0,0,0,0,0,0,0,0,12,6,18,12,6,18,229,230,1,0,1,5.65217,0.362319,43.2174,88.9088,69,4
India,259,242.378,7.15058,0.339768,244.568,7.12741,0.30888,734,RG Sharma,0,0,0,0,0,0,0,0,16,6,22,16,6,22,0,294,7,0,1,3.82836,0.268657,35.9179,83.083,134,4
India,259,242.378,7.15058,0.339768,244.568,7.12741,0.30888,734,V Kohli,0,0,0,0,0,0,0,0,16,6,22,16,6,22,0,294,7,0,1,4.66456,0.379747,44.9937,88.3325,158,4
India,259,242.378,7.15058,0.339768,244.568,7.12741,0.30888,734,S Dhawan,0,0,0,0,0,0,0,0,16,6,22,16,6,22,0,294,7,0,1,5.65217,0.362319,43.2174,88.9088,69,4
Zimbabwe,142,212.077,7.5,0.380282,227.704,6.97887,0.316901,734,V Sibanda,0,0,0,0,0,0,0,0,20,4,24,20,4,24,295,236,2,1,1,2.9697,0.181818,23.5152,63.5545,66,1
Zimbabwe,142,212.077,7.5,0.380282,227.704,6.97887,0.316901,734,Sikandar Raza,0,0,0,0,0,0,0,0,20,4,24,20,4,24,295,236,2,1,1,3,0.131579,26.1842,81.1582,38,4
Zimbabwe,142,212.077,7.5,0.380282,227.704,6.97887,0.316901,735,V Sibanda,0,0,0,0,0,0,0,0,12,5,17,12,5,17,0,183,5,1,1,2.9697,0.181818,23.5152,63.5545,66,1
Zimbabwe,142,212.077,7.5,0.380282,227.704,6.97887,0.316901,735,Sikandar Raza,0,0,0,0,0,0,0,0,12,5,17,12,5,17,0,183,5,1,1,3,0.131579,26.1842,81.1582,38,4
Zimbabwe,142,212.077,7.5,0.380282,227.704,6.97887,0.316901,735,H Masakadza,0,0,0,0,0,0,0,0,12,5,17,12,5,17,0,183,5,1,1,3.11215,0.186916,26.972,70.0485,107,4
Zimbabwe,142,212.077,7.5,0.380282,227.704,6.97887,0.316901,735,BRM Taylor,0,0,0,0,0,0,0,0,12,5,17,12,5,17,0,183,5,1,1,3.3,0.26,33.56,76.3421,100,4
India,259,242.378,7.15058,0.339768,244.568,7.12741,0.30888,735,RG Sharma,0,0,0,0,0,0,0,0,12,12,24,12,12,24,184,187,1,0,1,3.82836,0.268657,35.9179,83.083,134,4
India,259,242.378,7.15058,0.339768,244.568,7.12741,0.30888,735,S Dhawan,0,0,0,0,0,0,0,0,12,12,24,12,12,24,184,187,1,0,1,5.65217,0.362319,43.2174,88.9088,69,4
Zimbabwe,142,212.077,7.5,0.380282,227.704,6.97887,0.316901,736,V Sibanda,0,0,0,0,0,0,0,0,4,5,9,4,5,9,0,144,3,1,1,2.9697,0.181818,23.5152,63.5545,66,1
Zimbabwe,142,212.077,7.5,0.380282,227.704,6.97887,0.316901,736,Sikandar Raza,0,0,0,0,0,0,0,0,4,5,9,4,5,9,0,144,3,1,1,3,0.131579,26.1842,81.1582,38,4
India,259,242.378,7.15058,0.339768,244.568,7.12741,0.30888,736,CA Pujara,0,0,0,0,0,0,0,0,8,4,12,8,4,12,145,145,0,0,1,0.5,0,6,34.7826,4,3
India,259,242.378,7.15058,0.339768,244.568,7.12741,0.30888,736,RG Sharma,0,0,0,0,0,0,0,0,8,4,12,8,4,12,145,145,0,0,1,3.82836,0.268657,35.9179,83.083,134,4
Zimbabwe,142,212.077,7.5,0.380282,227.704,6.97887,0.316901,737,V Sibanda,0,0,0,0,0,0,0,0,12,6,18,12,6,18,0,163,1,1,1,2.9697,0.181818,23.5152,63.5545,66,1
Zimbabwe,142,212.077,7.5,0.380282,227.704,6.97887,0.316901,737,H Masakadza,0,0,0,0,0,0,0,0,12,6,18,12,6,18,0,163,1,1,1,3.11215,0.186916,26.972,70.0485,107,4
India,259,242.378,7.15058,0.339768,244.568,7.12741,0.30888,737,CA Pujara,0,0,0,0,0,0,0,0,20,9,29,20,9,29,164,167,2,0,1,0.5,0,6,34.7826,4,3
India,259,242.378,7.15058,0.339768,244.568,7.12741,0.30888,737,AM Rahane,0,0,0,0,0,0,0,0,20,9,29,20,9,29,164,167,2,0,1,3.55738,0.262295,32.2295,78.0159,61,4
India,259,242.378,7.15058,0.339768,244.568,7.12741,0.30888,737,S Dhawan,0,0,0,0,0,0,0,0,20,9,29,20,9,29,164,167,2,0,1,5.65217,0.362319,43.2174,88.9088,69,4
Pakistan,211,222.621,7.38389,0.393365,235.517,7.54976,0.336493,738,Nasir Jamshed,0,0,0,0,0,0,0,0,8,2,10,8,2,10,0,224,7,0,1,3.63043,0.23913,30.2174,73.8184,46,4
Pakistan,211,222.621,7.38389,0.393365,235.517,7.54976,0.336493,738,Ahmed Shehzad,0,0,0,0,0,0,0,0,8,2,10,8,2,10,0,224,7,0,1,3.67143,0.242857,33.2714,70.8118,70,4
Pakistan,211,222.621,7.38389,0.393365,235.517,7.54976,0.336493,738,Mohammad Hafeez,0,0,0,0,0,0,0,0,8,2,10,8,2,10,0,224,7,0,1,4.04511,0.255639,34.3534,78.0625,133,4
West Indies,176,217.33,7.15909,0.3125,225.278,7.57386,0.380682,738,CH Gayle,0,0,0,0,0,0,0,0,4,2,6,4,2,6,225,98,1,1,1,4.58621,0.206897,31.1293,89.4255,116,4
West Indies,176,217.33,7.15909,0.3125,225.278,7.57386,0.380682,738,J Charles,0,0,0,0,0,0,0,0,4,2,6,4,2,6,225,98,1,1,1,3.82353,0.147059,28.2353,81.2183,34,4
West Indies,176,217.33,7.15909,0.3125,225.278,7.57386,0.380682,738,DM Bravo,0,0,0,0,0,0,0,0,4,2,6,4,2,6,225,98,1,1,1,3,0.226667,28.52,67.4551,75,4
West Indies,176,217.33,7.15909,0.3125,225.278,7.57386,0.380682,738,MN Samuels,0,0,0,0,0,0,0,0,4,2,6,4,2,6,225,98,1,1,1,3.74757,0.23301,31.6214,74.5821,103,4
Pakistan,211,222.621,7.38389,0.393365,235.517,7.54976,0.336493,739,Ahmed Shehzad,0,0,0,0,0,0,0,0,8,6,14,8,6,14,0,229,1,0,1,3.67143,0.242857,33.2714,70.8118,70,4
Pakistan,211,222.621,7.38389,0.393365,235.517,7.54976,0.336493,739,Nasir Jamshed,0,0,0,0,0,0,0,0,8,6,14,8,6,14,0,229,1,0,1,3.63043,0.23913,30.2174,73.8184,46,4
West Indies,176,217.33,7.15909,0.3125,225.278,7.57386,0.380682,739,CH Gayle,0,0,0,0,0,0,0,0,8,9,17,8,9,17,230,229,2,1,1,4.58621,0.206897,31.1293,89.4255,116,4
West Indies,176,217.33,7.15909,0.3125,225.278,7.57386,0.380682,739,J Charles,0,0,0,0,0,0,0,0,8,9,17,8,9,17,230,229,2,1,1,3.82353,0.147059,28.2353,81.2183,34,4
West Indies,176,217.33,7.15909,0.3125,225.278,7.57386,0.380682,739,DM Bravo,0,0,0,0,0,0,0,0,8,9,17,8,9,17,230,229,2,1,1,3,0.226667,28.52,67.4551,75,4
West Indies,176,217.33,7.15909,0.3125,225.278,7.57386,0.380682,739,MN Samuels,0,0,0,0,0,0,0,0,8,9,17,8,9,17,230,229,2,1,1,3.74757,0.23301,31.6214,74.5821,103,4
West Indies,176,217.33,7.15909,0.3125,225.278,7.57386,0.380682,740,DS Smith,0,0,0,0,0,0,0,0,12,4,16,12,4,16,0,261,0,1,1,2.61765,0.147059,23.5588,71.2,34,4
West Indies,176,217.33,7.15909,0.3125,225.278,7.57386,0.380682,740,J Charles,0,0,0,0,0,0,0,0,12,4,16,12,4,16,0,261,0,1,1,3.82353,0.147059,28.2353,81.2183,34,4
Pakistan,211,222.621,7.38389,0.393365,235.517,7.54976,0.336493,740,Nasir Jamshed,0,0,0,0,0,0,0,0,8,14,22,8,14,22,262,189,1,0,1,3.63043,0.23913,30.2174,73.8184,46,4
Pakistan,211,222.621,7.38389,0.393365,235.517,7.54976,0.336493,740,Ahmed Shehzad,0,0,0,0,0,0,0,0,8,14,22,8,14,22,262,189,1,0,1,3.67143,0.242857,33.2714,70.8118,70,4
Pakistan,211,222.621,7.38389,0.393365,235.517,7.54976,0.336493,740,Mohammad Hafeez,0,0,0,0,0,0,0,0,8,14,22,8,14,22,262,189,1,0,1,4.04511,0.255639,34.3534,78.0625,133,4
West Indies,176,217.33,7.15909,0.3125,225.278,7.57386,0.380682,741,J Charles,0,0,0,0,0,0,0,0,4,9,13,4,9,13,0,242,5,1,1,3.82353,0.147059,28.2353,81.2183,34,4
West Indies,176,217.33,7.15909,0.3125,225.278,7.57386,0.380682,741,DS Smith,0,0,0,0,0,0,0,0,4,9,13,4,9,13,0,242,5,1,1,2.61765,0.147059,23.5588,71.2,34,4
Pakistan,211,222.621,7.38389,0.393365,235.517,7.54976,0.336493,741,Nasir Jamshed,0,0,0,0,0,0,0,0,18,7,25,18,7,25,243,243,0,0,1,3.63043,0.23913,30.2174,73.8184,46,4
Pakistan,211,222.621,7.38389,0.393365,235.517,7.54976,0.336493,741,Ahmed Shehzad,0,0,0,0,0,0,0,0,18,7,25,18,7,25,243,243,0,0,1,3.67143,0.242857,33.2714,70.8118,70,4
Australia,228,239.627,7.69737,0.372807,232.079,7.23246,0.337719,742,PJ Hughes,0,0,0,0,0,0,0,0,4,7,11,4,7,11,0,304,2,0,1,4.52381,0.285714,38.7619,74.7475,21,4
Australia,228,239.627,7.69737,0.372807,232.079,7.23246,0.337719,742,AJ Finch,0,0,0,0,0,0,0,0,4,7,11,4,7,11,0,304,2,0,1,4.52941,0.313725,37.2549,83.4431,51,4
India,259,242.378,7.15058,0.339768,244.568,7.12741,0.30888,742,S Dhawan,0,0,0,0,0,0,0,0,4,9,13,4,9,13,305,232,2,1,1,5.65217,0.362319,43.2174,88.9088,69,4
India,259,242.378,7.15058,0.339768,244.568,7.12741,0.30888,742,RG Sharma,0,0,0,0,0,0,0,0,4,9,13,4,9,13,305,232,2,1,1,3.82836,0.268657,35.9179,83.083,134,4
Australia,228,239.627,7.69737,0.372807,232.079,7.23246,0.337719,743,AJ Finch,0,0,0,0,0,0,0,0,16,5,21,16,5,21,0,359,2,0,1,4.52941,0.313725,37.2549,83.4431,51,4
Australia,228,239.627,7.69737,0.372807,232.079,7.23246,0.337719,743,PJ Hughes,0,0,0,0,0,0,0,0,16,5,21,16,5,21,0,359,2,0,1,4.52381,0.285714,38.7619,74.7475,21,4
India,259,242.378,7.15058,0.339768,244.568,7.12741,0.30888,743,RG Sharma,0,0,0,0,0,0,0,0,16,8,24,16,8,24,360,362,6,1,1,3.82836,0.268657,35.9179,83.083,134,4
India,259,242.378,7.15058,0.339768,244.568,7.12741,0.30888,743,S Dhawan,0,0,0,0,0,0,0,0,16,8,24,16,8,24,360,362,6,1,1,5.65217,0.362319,43.2174,88.9088,69,4
India,259,242.378,7.15058,0.339768,244.568,7.12741,0.30888,744,RG Sharma,0,0,0,0,0,0,0,0,20,2,22,20,2,22,0,303,7,1,1,3.82836,0.268657,35.9179,83.083,134,4
India,259,242.378,7.15058,0.339768,244.568,7.12741,0.30888,744,S Dhawan,0,0,0,0,0,0,0,0,20,2,22,20,2,22,0,303,7,1,1,5.65217,0.362319,43.2174,88.9088,69,4
India,259,242.378,7.15058,0.339768,244.568,7.12741,0.30888,744,V Kohli,0,0,0,0,0,0,0,0,20,2,22,20,2,22,0,303,7,1,1,4.66456,0.379747,44.9937,88.3325,158,4
Australia,228,239.627,7.69737,0.372807,232.079,7.23246,0.337719,744,PJ Hughes,0,0,0,0,0,0,0,0,16,5,21,16,5,21,304,304,8,0,1,4.52381,0.285714,38.7619,74.7475,21,4
Australia,228,239.627,7.69737,0.372807,232.079,7.23246,0.337719,744,AJ Finch,0,0,0,0,0,0,0,0,16,5,21,16,5,21,304,304,8,0,1,4.52941,0.313725,37.2549,83.4431,51,4
Australia,228,239.627,7.69737,0.372807,232.079,7.23246,0.337719,745,PJ Hughes,0,0,0,0,0,0,0,0,8,4,12,8,4,12,0,350,0,0,1,4.52381,0.285714,38.7619,74.7475,21,4
Australia,228,239.627,7.69737,0.372807,232.079,7.23246,0.337719,745,AJ Finch,0,0,0,0,0,0,0,0,8,4,12,8,4,12,0,350,0,0,1,4.52941,0.313725,37.2549,83.4431,51,4
India,259,242.378,7.15058,0.339768,244.568,7.12741,0.30888,745,RG Sharma,0,0,0,0,0,0,0,0,12,9,21,12,9,21,351,351,5,1,1,3.82836,0.268657,35.9179,83.083,134,4
India,259,242.378,7.15058,0.339768,244.568,7.12741,0.30888,745,S Dhawan,0,0,0,0,0,0,0,0,12,9,21,12,9,21,351,351,5,1,1,5.65217,0.362319,43.2174,88.9088,69,4
India,259,242.378,7.15058,0.339768,244.568,7.12741,0.30888,746,RG Sharma,0,0,0,0,0,0,0,0,20,8,28,20,8,28,0,383,5,1,1,3.82836,0.268657,35.9179,83.083,134,4
India,259,242.378,7.15058,0.339768,244.568,7.12741,0.30888,746,S Dhawan,0,0,0,0,0,0,0,0,20,8,28,20,8,28,0,383,5,1,1,5.65217,0.362319,43.2174,88.9088,69,4
Australia,228,239.627,7.69737,0.372807,232.079,7.23246,0.337719,746,AJ Finch,0,0,0,0,0,0,0,0,8,8,16,8,8,16,384,326,0,0,1,4.52941,0.313725,37.2549,83.4431,51,4
Australia,228,239.627,7.69737,0.372807,232.079,7.23246,0.337719,746,PJ Hughes,0,0,0,0,0,0,0,0,8,8,16,8,8,16,384,326,0,0,1,4.52381,0.285714,38.7619,74.7475,21,4
Australia,228,239.627,7.69737,0.372807,232.079,7.23246,0.337719,746,BJ Haddin,0,0,0,0,0,0,0,0,8,8,16,8,8,16,384,326,0,0,1,3.14737,0.147368,26.7789,81.382,95,4
South Africa,190,234.274,7.4,0.373684,232.363,7.33158,0.342105,747,HM Amla,0,0,0,0,0,0,0,0,16,8,24,16,8,24,0,358,0,1,1,5.20168,0.403361,48.7899,86.9292,119,4
South Africa,190,234.274,7.4,0.373684,232.363,7.33158,0.342105,747,Q de Kock,0,0,0,0,0,0,0,0,16,8,24,16,8,24,0,358,0,1,1,5.12963,0.240741,39.1111,91.2311,54,4
India,259,242.378,7.15058,0.339768,244.568,7.12741,0.30888,747,RG Sharma,0,0,0,0,0,0,0,0,12,2,14,12,2,14,359,217,0,0,1,3.82836,0.268657,35.9179,83.083,134,4
India,259,242.378,7.15058,0.339768,244.568,7.12741,0.30888,747,S Dhawan,0,0,0,0,0,0,0,0,12,2,14,12,2,14,359,217,0,0,1,5.65217,0.362319,43.2174,88.9088,69,4
South Africa,190,234.274,7.4,0.373684,232.363,7.33158,0.342105,748,CA Ingram,0,0,0,0,0,0,0,0,4,8,12,4,8,12,0,183,1,0,1,3,0.178571,27.1786,81.3904,28,4
South Africa,190,234.274,7.4,0.373684,232.363,7.33158,0.342105,748,JP Duminy,0,0,0,0,0,0,0,0,4,8,12,4,8,12,0,183,1,0,1,2.3252,0.186992,29.9675,80.2351,123,4
South Africa,190,234.274,7.4,0.373684,232.363,7.33158,0.342105,748,GC Smith,0,0,0,0,0,0,0,0,4,8,12,4,8,12,0,183,1,0,1,3.97,0.29,33.57,79.6819,100,4
Pakistan,211,222.621,7.38389,0.393365,235.517,7.54976,0.336493,748,Nasir Jamshed,0,0,0,0,0,0,0,0,0,3,3,0,3,3,184,182,1,0,1,3.63043,0.23913,30.2174,73.8184,46,4
Pakistan,211,222.621,7.38389,0.393365,235.517,7.54976,0.336493,748,Ahmed Shehzad,0,0,0,0,0,0,0,0,0,3,3,0,3,3,184,182,1,0,1,3.67143,0.242857,33.2714,70.8118,70,4
Pakistan,211,222.621,7.38389,0.393365,235.517,7.54976,0.336493,748,Mohammad Hafeez,0,0,0,0,0,0,0,0,0,3,3,0,3,3,184,182,1,0,1,4.04511,0.255639,34.3534,78.0625,133,4
Pakistan,211,222.621,7.38389,0.393365,235.517,7.54976,0.336493,749,Nasir Jamshed,0,0,0,0,0,0,0,0,0,8,8,0,8,8,0,209,0,0,1,3.63043,0.23913,30.2174,73.8184,46,4
Pakistan,211,222.621,7.38389,0.393365,235.517,7.54976,0.336493,749,Ahmed Shehzad,0,0,0,0,0,0,0,0,0,8,8,0,8,8,0,209,0,0,1,3.67143,0.242857,33.2714,70.8118,70,4
Pakistan,211,222.621,7.38389,0.393365,235.517,7.54976,0.336493,749,Mohammad Hafeez,0,0,0,0,0,0,0,0,0,8,8,0,8,8,0,209,0,0,1,4.04511,0.255639,34.3534,78.0625,133,4
South Africa,190,234.274,7.4,0.373684,232.363,7.33158,0.342105,749,GC Smith,0,0,0,0,0,0,0,0,16,9,25,16,9,25,210,143,2,0,1,3.97,0.29,33.57,79.6819,100,4
South Africa,190,234.274,7.4,0.373684,232.363,7.33158,0.342105,749,CA Ingram,0,0,0,0,0,0,0,0,16,9,25,16,9,25,210,143,2,0,1,3,0.178571,27.1786,81.3904,28,4
South Africa,190,234.274,7.4,0.373684,232.363,7.33158,0.342105,749,JP Duminy,0,0,0,0,0,0,0,0,16,9,25,16,9,25,210,143,2,0,1,2.3252,0.186992,29.9675,80.2351,123,4
South Africa,190,234.274,7.4,0.373684,232.363,7.33158,0.342105,750,HM Amla,0,0,0,0,0,0,0,0,12,9,21,12,9,21,0,259,1,0,1,5.20168,0.403361,48.7899,86.9292,119,4
South Africa,190,234.274,7.4,0.373684,232.363,7.33158,0.342105,750,Q de Kock,0,0,0,0,0,0,0,0,12,9,21,12,9,21,0,259,1,0,1,5.12963,0.240741,39.1111,91.2311,54,4
South Africa,190,234.274,7.4,0.373684,232.363,7.33158,0.342105,750,F du Plessis,0,0,0,0,0,0,0,0,12,9,21,12,9,21,0,259,1,0,1,3.45122,0.292683,34.9268,83.135,82,4
Pakistan,211,222.621,7.38389,0.393365,235.517,7.54976,0.336493,750,Mohammad Hafeez,0,0,0,0,0,0,0,0,32,3,35,32,3,35,260,191,2,0,1,4.04511,0.255639,34.3534,78.0625,133,4
Pakistan,211,222.621,7.38389,0.393365,235.517,7.54976,0.336493,750,Ahmed Shehzad,0,0,0,0,0,0,0,0,32,3,35,32,3,35,260,191,2,0,1,3.67143,0.242857,33.2714,70.8118,70,4
South Africa,190,234.274,7.4,0.373684,232.363,7.33158,0.342105,751,Q de Kock,0,0,0,0,0,0,0,0,20,9,29,20,9,29,0,266,0,0,1,5.12963,0.240741,39.1111,91.2311,54,4
South Africa,190,234.274,7.4,0.373684,232.363,7.33158,0.342105,751,HM Amla,0,0,0,0,0,0,0,0,20,9,29,20,9,29,0,266,0,0,1,5.20168,0.403361,48.7899,86.9292,119,4
Pakistan,211,222.621,7.38389,0.393365,235.517,7.54976,0.336493,751,Ahmed Shehzad,0,0,0,0,0,0,0,0,0,7,7,0,7,7,267,238,1,0,1,3.67143,0.242857,33.2714,70.8118,70,4
Pakistan,211,222.621,7.38389,0.393365,235.517,7.54976,0.336493,751,Mohammad Hafeez,0,0,0,0,0,0,0,0,0,7,7,0,7,7,267,238,1,0,1,4.04511,0.255639,34.3534,78.0625,133,4
South Africa,190,234.274,7.4,0.373684,232.363,7.33158,0.342105,752,HM Amla,0,0,0,0,0,0,0,0,16,9,25,16,9,25,0,268,3,0,1,5.20168,0.403361,48.7899,86.9292,119,4
South Africa,190,234.274,7.4,0.373684,232.363,7.33158,0.342105,752,Q de Kock,0,0,0,0,0,0,0,0,16,9,25,16,9,25,0,268,3,0,1,5.12963,0.240741,39.1111,91.2311,54,4
South Africa,190,234.274,7.4,0.373684,232.363,7.33158,0.342105,752,F du Plessis,0,0,0,0,0,0,0,0,16,9,25,16,9,25,0,268,3,0,1,3.45122,0.292683,34.9268,83.135,82,4
Pakistan,211,222.621,7.38389,0.393365,235.517,7.54976,0.336493,752,Mohammad Hafeez,0,0,0,0,0,0,0,0,4,4,8,4,4,8,269,151,0,0,1,4.04511,0.255639,34.3534,78.0625,133,4
Pakistan,211,222.621,7.38389,0.393365,235.517,7.54976,0.336493,752,Ahmed Shehzad,0,0,0,0,0,0,0,0,4,4,8,4,4,8,269,151,0,0,1,3.67143,0.242857,33.2714,70.8118,70,4
Pakistan,211,222.621,7.38389,0.393365,235.517,7.54976,0.336493,752,Umar Amin,0,0,0,0,0,0,0,0,4,4,8,4,4,8,269,151,0,0,1,2.14286,0.0714286,18.8571,67.3469,14,1
New Zealand,184,233.745,7.39674,0.36413,227.951,7.30435,0.353261,753,MJ Guptill,0,0,0,0,0,0,0,0,20,14,34,20,14,34,0,331,4,1,1,4.8087,0.313043,38.1217,82.7482,115,4
New Zealand,184,233.745,7.39674,0.36413,227.951,7.30435,0.353261,753,BB McCullum,0,0,0,0,0,0,0,0,20,14,34,20,14,34,0,331,4,1,1,3.98611,0.201389,29.9028,98.4004,144,0
Sri Lanka,244,223.373,7.09016,0.344262,227.578,7.47541,0.385246,753,HDRL Thirimanne,0,0,0,0,0,0,0,0,8,9,17,8,9,17,332,233,0,0,1,2.77778,0.246914,31.5802,71.4725,81,4
Sri Lanka,244,223.373,7.09016,0.344262,227.578,7.47541,0.385246,753,TM Dilshan,0,0,0,0,0,0,0,0,8,9,17,8,9,17,332,233,0,0,1,4.60199,0.273632,38.3632,86.0219,201,4
Australia,228,239.627,7.69737,0.372807,232.079,7.23246,0.337719,754,DA Warner,0,0,0,0,0,0,0,0,20,20,40,20,20,40,0,342,1,1,1,4.20312,0.265625,35.2031,87.7336,64,4
Australia,228,239.627,7.69737,0.372807,232.079,7.23246,0.337719,754,AJ Finch,0,0,0,0,0,0,0,0,20,20,40,20,20,40,0,342,1,1,1,4.52941,0.313725,37.2549,83.4431,51,4
England,221,237.176,7.17647,0.289593,230.633,7.45701,0.384615,754,MM Ali,0,0,0,0,0,0,0,0,20,6,26,20,6,26,343,231,3,0,1,2.67647,0.117647,21.3824,94.5384,34,0
England,221,237.176,7.17647,0.289593,230.633,7.45701,0.384615,754,IR Bell,0,0,0,0,0,0,0,0,20,6,26,20,6,26,343,231,3,0,1,3.63433,0.246269,35.3806,75.6623,134,4
England,221,237.176,7.17647,0.289593,230.633,7.45701,0.384615,754,GS Ballance,0,0,0,0,0,0,0,0,20,6,26,20,6,26,343,231,3,0,1,1.69231,0.153846,22,66.3573,13,1
South Africa,190,234.274,7.4,0.373684,232.363,7.33158,0.342105,755,Q de Kock,0,0,0,0,0,0,0,0,4,7,11,4,7,11,0,339,2,0,1,5.12963,0.240741,39.1111,91.2311,54,4
South Africa,190,234.274,7.4,0.373684,232.363,7.33158,0.342105,755,HM Amla,0,0,0,0,0,0,0,0,4,7,11,4,7,11,0,339,2,0,1,5.20168,0.403361,48.7899,86.9292,119,4
South Africa,190,234.274,7.4,0.373684,232.363,7.33158,0.342105,755,F du Plessis,0,0,0,0,0,0,0,0,4,7,11,4,7,11,0,339,2,0,1,3.45122,0.292683,34.9268,83.135,82,4
Zimbabwe,142,212.077,7.5,0.380282,227.704,6.97887,0.316901,755,CJ Chibhabha,0,0,0,0,0,0,0,0,20,3,23,20,3,23,340,277,9,0,1,2.56716,0.149254,23.5373,64.7373,67,1
Zimbabwe,142,212.077,7.5,0.380282,227.704,6.97887,0.316901,755,Sikandar Raza,0,0,0,0,0,0,0,0,20,3,23,20,3,23,340,277,9,0,1,3,0.131579,26.1842,81.1582,38,4
India,259,242.378,7.15058,0.339768,244.568,7.12741,0.30888,756,RG Sharma,0,0,0,0,0,0,0,0,12,8,20,12,8,20,0,300,1,0,1,3.82836,0.268657,35.9179,83.083,134,4
India,259,242.378,7.15058,0.339768,244.568,7.12741,0.30888,756,S Dhawan,0,0,0,0,0,0,0,0,12,8,20,12,8,20,0,300,1,0,1,5.65217,0.362319,43.2174,88.9088,69,4
Pakistan,211,222.621,7.38389,0.393365,235.517,7.54976,0.336493,756,Ahmed Shehzad,0,0,0,0,0,0,0,0,16,9,25,16,9,25,301,224,3,0,1,3.67143,0.242857,33.2714,70.8118,70,4
Pakistan,211,222.621,7.38389,0.393365,235.517,7.54976,0.336493,756,Younis Khan,0,0,0,0,0,0,0,0,16,9,25,16,9,25,301,224,3,0,1,2.64655,0.215517,28.5,73.2713,116,4
Pakistan,211,222.621,7.38389,0.393365,235.517,7.54976,0.336493,756,Haris Sohail,0,0,0,0,0,0,0,0,16,9,25,16,9,25,301,224,3,0,1,3.25,0.3,35.2,80.8266,20,4
England,221,237.176,7.17647,0.289593,230.633,7.45701,0.384615,760,IR Bell,0,0,0,0,0,0,0,0,20,8,28,20,8,28,0,123,3,0,1,3.63433,0.246269,35.3806,75.6623,134,4
England,221,237.176,7.17647,0.289593,230.633,7.45701,0.384615,760,MM Ali,0,0,0,0,0,0,0,0,20,8,28,20,8,28,0,123,3,0,1,2.67647,0.117647,21.3824,94.5384,34,0
England,221,237.176,7.17647,0.289593,230.633,7.45701,0.384615,760,GS Ballance,0,0,0,0,0,0,0,0,20,8,28,20,8,28,0,123,3,0,1,1.69231,0.153846,22,66.3573,13,1
New Zealand,184,233.745,7.39674,0.36413,227.951,7.30435,0.353261,760,MJ Guptill,0,0,0,0,0,0,0,0,54,7,61,54,7,61,124,125,6,1,1,4.8087,0.313043,38.1217,82.7482,115,4
New Zealand,184,233.745,7.39674,0.36413,227.951,7.30435,0.353261,760,BB McCullum,0,0,0,0,0,0,0,0,54,7,61,54,7,61,124,125,6,1,1,3.98611,0.201389,29.9028,98.4004,144,0
West Indies,176,217.33,7.15909,0.3125,225.278,7.57386,0.380682,761,DR Smith,0,0,0,0,0,0,0,0,8,8,16,8,8,16,0,310,1,0,1,2.5,0.12,17.96,84.5574,50,1
West Indies,176,217.33,7.15909,0.3125,225.278,7.57386,0.380682,761,CH Gayle,0,0,0,0,0,0,0,0,8,8,16,8,8,16,0,310,1,0,1,4.58621,0.206897,31.1293,89.4255,116,4
Pakistan,211,222.621,7.38389,0.393365,235.517,7.54976,0.336493,761,Nasir Jamshed,0,0,0,0,0,0,0,0,0,2,2,0,2,2,311,160,1,0,1,3.63043,0.23913,30.2174,73.8184,46,4
Pakistan,211,222.621,7.38389,0.393365,235.517,7.54976,0.336493,761,Ahmed Shehzad,0,0,0,0,0,0,0,0,0,2,2,0,2,2,311,160,1,0,1,3.67143,0.242857,33.2714,70.8118,70,4
Pakistan,211,222.621,7.38389,0.393365,235.517,7.54976,0.336493,761,Younis Khan,0,0,0,0,0,0,0,0,0,2,2,0,2,2,311,160,1,0,1,2.64655,0.215517,28.5,73.2713,116,4
Pakistan,211,222.621,7.38389,0.393365,235.517,7.54976,0.336493,761,Haris Sohail,0,0,0,0,0,0,0,0,0,2,2,0,2,2,311,160,1,0,1,3.25,0.3,35.2,80.8266,20,4
Pakistan,211,222.621,7.38389,0.393365,235.517,7.54976,0.336493,761,Sohaib Maqsood,0,0,0,0,0,0,0,0,0,2,2,0,2,2,311,160,1,0,1,2.86957,0.217391,29.4348,79.7409,23,4
Pakistan,211,222.621,7.38389,0.393365,235.517,7.54976,0.336493,761,Misbah-ul-Haq,0,0,0,0,0,0,0,0,0,2,2,0,2,2,311,160,1,0,1,2.95238,0.285714,34.9921,71.8195,126,4
India,259,242.378,7.15058,0.339768,244.568,7.12741,0.30888,763,RG Sharma,0,0,0,0,0,0,0,0,8,2,10,8,2,10,0,307,0,0,1,3.82836,0.268657,35.9179,83.083,134,4
India,259,242.378,7.15058,0.339768,244.568,7.12741,0.30888,763,S Dhawan,0,0,0,0,0,0,0,0,8,2,10,8,2,10,0,307,0,0,1,5.65217,0.362319,43.2174,88.9088,69,4
India,259,242.378,7.15058,0.339768,244.568,7.12741,0.30888,763,V Kohli,0,0,0,0,0,0,0,0,8,2,10,8,2,10,0,307,0,0,1,4.66456,0.379747,44.9937,88.3325,158,4
South Africa,190,234.274,7.4,0.373684,232.363,7.33158,0.342105,763,HM Amla,0,0,0,0,0,0,0,0,4,10,14,4,10,14,308,177,3,0,1,5.20168,0.403361,48.7899,86.9292,119,4
South Africa,190,234.274,7.4,0.373684,232.363,7.33158,0.342105,763,Q de Kock,0,0,0,0,0,0,0,0,4,10,14,4,10,14,308,177,3,0,1,5.12963,0.240741,39.1111,91.2311,54,4
South Africa,190,234.274,7.4,0.373684,232.363,7.33158,0.342105,763,F du Plessis,0,0,0,0,0,0,0,0,4,10,14,4,10,14,308,177,3,0,1,3.45122,0.292683,34.9268,83.135,82,4
West Indies,176,217.33,7.15909,0.3125,225.278,7.57386,0.380682,765,DR Smith,0,0,0,0,0,0,0,0,12,7,19,12,7,19,0,372,1,0,1,2.5,0.12,17.96,84.5574,50,1
West Indies,176,217.33,7.15909,0.3125,225.278,7.57386,0.380682,765,MN Samuels,0,0,0,0,0,0,0,0,12,7,19,12,7,19,0,372,1,0,1,3.74757,0.23301,31.6214,74.5821,103,4
West Indies,176,217.33,7.15909,0.3125,225.278,7.57386,0.380682,765,CH Gayle,0,0,0,0,0,0,0,0,12,7,19,12,7,19,0,372,1,0,1,4.58621,0.206897,31.1293,89.4255,116,4
Zimbabwe,142,212.077,7.5,0.380282,227.704,6.97887,0.316901,765,Sikandar Raza,0,0,0,0,0,0,0,0,12,12,24,12,12,24,373,289,2,0,1,3,0.131579,26.1842,81.1582,38,4
Zimbabwe,142,212.077,7.5,0.380282,227.704,6.97887,0.316901,765,RW Chakabva,0,0,0,0,0,0,0,0,12,12,24,12,12,24,373,289,2,0,1,0.846154,0,13.2692,51.3393,26,3
Zimbabwe,142,212.077,7.5,0.380282,227.704,6.97887,0.316901,765,H Masakadza,0,0,0,0,0,0,0,0,12,12,24,12,12,24,373,289,2,0,1,3.11215,0.186916,26.972,70.0485,107,4
Sri Lanka,244,223.373,7.09016,0.344262,227.578,7.47541,0.385246,767,HDRL Thirimanne,0,0,0,0,0,0,0,0,4,10,14,4,10,14,0,332,3,0,1,2.77778,0.246914,31.5802,71.4725,81,4
Sri Lanka,244,223.373,7.09016,0.344262,227.578,7.47541,0.385246,767,TM Dilshan,0,0,0,0,0,0,0,0,4,10,14,4,10,14,0,332,3,0,1,4.60199,0.273632,38.3632,86.0219,201,4
Bangladesh,160,218.438,7.70625,0.4,211.106,7.05,0.325,767,Tamim Iqbal,0,0,0,0,0,0,0,0,24,7,31,24,7,31,333,240,2,0,1,4.05344,0.274809,31.8015,76.8068,131,4
Bangladesh,160,218.438,7.70625,0.4,211.106,7.05,0.325,767,Soumya Sarkar,0,0,0,0,0,0,0,0,24,7,31,24,7,31,333,240,2,0,1,7.35714,0.357143,47.2857,99.1018,14,4
Bangladesh,160,218.438,7.70625,0.4,211.106,7.05,0.325,767,Anamul Haque,0,0,0,0,0,0,0,0,24,7,31,24,7,31,333,240,2,0,1,4.12,0.24,36.8,69.6442,25,4
South Africa,190,234.274,7.4,0.373684,232.363,7.33158,0.342105,768,Q de Kock,0,0,0,0,0,0,0,0,12,4,16,12,4,16,0,408,2,0,1,5.12963,0.240741,39.1111,91.2311,54,4
South Africa,190,234.274,7.4,0.373684,232.363,7.33158,0.342105,768,HM Amla,0,0,0,0,0,0,0,0,12,4,16,12,4,16,0,408,2,0,1,5.20168,0.403361,48.7899,86.9292,119,4
West Indies,176,217.33,7.15909,0.3125,225.278,7.57386,0.380682,768,DR Smith,0,0,0,0,0,0,0,0,6,7,13,6,7,13,409,151,7,0,1,2.5,0.12,17.96,84.5574,50,1
West Indies,176,217.33,7.15909,0.3125,225.278,7.57386,0.380682,768,CH Gayle,0,0,0,0,0,0,0,0,6,7,13,6,7,13,409,151,7,0,1,4.58621,0.206897,31.1293,89.4255,116,4
West Indies,176,217.33,7.15909,0.3125,225.278,7.57386,0.380682,768,MN Samuels,0,0,0,0,0,0,0,0,6,7,13,6,7,13,409,151,7,0,1,3.74757,0.23301,31.6214,74.5821,103,4
West Indies,176,217.33,7.15909,0.3125,225.278,7.57386,0.380682,768,JL Carter,0,0,0,0,0,0,0,0,6,7,13,6,7,13,409,151,7,0,1,1.63636,0,14.7273,55.8621,11,3
Australia,228,239.627,7.69737,0.372807,232.079,7.23246,0.337719,769,AJ Finch,0,0,0,0,0,0,0,0,28,13,41,28,13,41,0,151,7,0,1,4.52941,0.313725,37.2549,83.4431,51,4
Australia,228,239.627,7.69737,0.372807,232.079,7.23246,0.337719,769,DA Warner,0,0,0,0,0,0,0,0,28,13,41,28,13,41,0,151,7,0,1,4.20312,0.265625,35.2031,87.7336,64,4
Australia,228,239.627,7.69737,0.372807,232.079,7.23246,0.337719,769,SR Watson,0,0,0,0,0,0,0,0,28,13,41,28,13,41,0,151,7,0,1,4.71318,0.286822,37.7907,90.0943,129,4
New Zealand,184,233.745,7.39674,0.36413,227.951,7.30435,0.353261,769,MJ Guptill,0,0,0,0,0,0,0,0,42,5,47,42,5,47,152,152,3,1,1,4.8087,0.313043,38.1217,82.7482,115,4
New Zealand,184,233.745,7.39674,0.36413,227.951,7.30435,0.353261,769,BB McCullum,0,0,0,0,0,0,0,0,42,5,47,42,5,47,152,152,3,1,1,3.98611,0.201389,29.9028,98.4004,144,0
New Zealand,184,233.745,7.39674,0.36413,227.951,7.30435,0.353261,769,KS Williamson,0,0,0,0,0,0,0,0,42,5,47,42,5,47,152,152,3,1,1,4.31707,0.390244,43.0488,82.8833,82,4
England,221,237.176,7.17647,0.289593,230.633,7.45701,0.384615,771,MM Ali,0,0,0,0,0,0,0,0,32,4,36,32,4,36,0,309,6,0,1,2.67647,0.117647,21.3824,94.5384,34,0
England,221,237.176,7.17647,0.289593,230.633,7.45701,0.384615,771,IR Bell,0,0,0,0,0,0,0,0,32,4,36,32,4,36,0,309,6,0,1,3.63433,0.246269,35.3806,75.6623,134,4
Sri Lanka,244,223.373,7.09016,0.344262,227.578,7.47541,0.385246,771,HDRL Thirimanne,0,0,0,0,0,0,0,0,12,9,21,12,9,21,310,312,4,0,1,2.77778,0.246914,31.5802,71.4725,81,4
Sri Lanka,244,223.373,7.09016,0.344262,227.578,7.47541,0.385246,771,TM Dilshan,0,0,0,0,0,0,0,0,12,9,21,12,9,21,310,312,4,0,1,4.60199,0.273632,38.3632,86.0219,201,4
Pakistan,211,222.621,7.38389,0.393365,235.517,7.54976,0.336493,772,Nasir Jamshed,0,0,0,0,0,0,0,0,0,2,2,0,2,2,0,235,3,0,1,3.63043,0.23913,30.2174,73.8184,46,4
Pakistan,211,222.621,7.38389,0.393365,235.517,7.54976,0.336493,772,Ahmed Shehzad,0,0,0,0,0,0,0,0,0,2,2,0,2,2,0,235,3,0,1,3.67143,0.242857,33.2714,70.8118,70,4
Pakistan,211,222.621,7.38389,0.393365,235.517,7.54976,0.336493,772,Haris Sohail,0,0,0,0,0,0,0,0,0,2,2,0,2,2,0,235,3,0,1,3.25,0.3,35.2,80.8266,20,4
Pakistan,211,222.621,7.38389,0.393365,235.517,7.54976,0.336493,772,Misbah-ul-Haq,0,0,0,0,0,0,0,0,0,2,2,0,2,2,0,235,3,0,1,2.95238,0.285714,34.9921,71.8195,126,4
Zimbabwe,142,212.077,7.5,0.380282,227.704,6.97887,0.316901,772,CJ Chibhabha,0,0,0,0,0,0,0,0,8,6,14,8,6,14,236,215,1,0,1,2.56716,0.149254,23.5373,64.7373,67,1
Zimbabwe,142,212.077,7.5,0.380282,227.704,6.97887,0.316901,772,Sikandar Raza,0,0,0,0,0,0,0,0,8,6,14,8,6,14,236,215,1,0,1,3,0.131579,26.1842,81.1582,38,4
Zimbabwe,142,212.077,7.5,0.380282,227.704,6.97887,0.316901,772,H Masakadza,0,0,0,0,0,0,0,0,8,6,14,8,6,14,236,215,1,0,1,3.11215,0.186916,26.972,70.0485,107,4
South Africa,190,234.274,7.4,0.373684,232.363,7.33158,0.342105,773,HM Amla,0,0,0,0,0,0,0,0,12,7,19,12,7,19,0,411,6,0,1,5.20168,0.403361,48.7899,86.9292,119,4
South Africa,190,234.274,7.4,0.373684,232.363,7.33158,0.342105,773,Q de Kock,0,0,0,0,0,0,0,0,12,7,19,12,7,19,0,411,6,0,1,5.12963,0.240741,39.1111,91.2311,54,4
South Africa,190,234.274,7.4,0.373684,232.363,7.33158,0.342105,773,F du Plessis,0,0,0,0,0,0,0,0,12,7,19,12,7,19,0,411,6,0,1,3.45122,0.292683,34.9268,83.135,82,4
Ireland,55,219.527,7.65455,0.290909,202.727,7.56364,0.4,773,WTS Porterfield,0,0,0,0,0,0,0,0,20,5,25,20,5,25,412,210,0,0,1,2.6,0.142857,24.6857,56.2866,35,3
Ireland,55,219.527,7.65455,0.290909,202.727,7.56364,0.4,773,PR Stirling,0,0,0,0,0,0,0,0,20,5,25,20,5,25,412,210,0,0,1,3.47826,0.173913,24.2174,88.1329,23,0
Ireland,55,219.527,7.65455,0.290909,202.727,7.56364,0.4,773,EC Joyce,0,0,0,0,0,0,0,0,20,5,25,20,5,25,412,210,0,0,1,3.08571,0.2,28.3429,68.6505,35,4
Ireland,55,219.527,7.65455,0.290909,202.727,7.56364,0.4,773,A Balbirnie,0,0,0,0,0,0,0,0,20,5,25,20,5,25,412,210,0,0,1,3,0.222222,28.7778,81.1912,9,4
West Indies,176,217.33,7.15909,0.3125,225.278,7.57386,0.380682,776,DR Smith,0,0,0,0,0,0,0,0,4,2,6,4,2,6,0,182,2,0,1,2.5,0.12,17.96,84.5574,50,1
West Indies,176,217.33,7.15909,0.3125,225.278,7.57386,0.380682,776,CH Gayle,0,0,0,0,0,0,0,0,4,2,6,4,2,6,0,182,2,0,1,4.58621,0.206897,31.1293,89.4255,116,4
West Indies,176,217.33,7.15909,0.3125,225.278,7.57386,0.380682,776,MN Samuels,0,0,0,0,0,0,0,0,4,2,6,4,2,6,0,182,2,0,1,3.74757,0.23301,31.6214,74.5821,103,4
India,259,242.378,7.15058,0.339768,244.568,7.12741,0.30888,776,RG Sharma,0,0,0,0,0,0,0,0,4,8,12,4,8,12,183,185,0,0,1,3.82836,0.268657,35.9179,83.083,134,4
India,259,242.378,7.15058,0.339768,244.568,7.12741,0.30888,776,S Dhawan,0,0,0,0,0,0,0,0,4,8,12,4,8,12,183,185,0,0,1,5.65217,0.362319,43.2174,88.9088,69,4
India,259,242.378,7.15058,0.339768,244.568,7.12741,0.30888,776,V Kohli,0,0,0,0,0,0,0,0,4,8,12,4,8,12,183,185,0,0,1,4.66456,0.379747,44.9937,88.3325,158,4
Pakistan,211,222.621,7.38389,0.393365,235.517,7.54976,0.336493,777,Sarfraz Ahmed,0,0,0,0,0,0,0,0,12,4,16,12,4,16,0,222,1,0,1,2.04878,0.097561,25.4878,83.9357,41,4
Pakistan,211,222.621,7.38389,0.393365,235.517,7.54976,0.336493,777,Ahmed Shehzad,0,0,0,0,0,0,0,0,12,4,16,12,4,16,0,222,1,0,1,3.67143,0.242857,33.2714,70.8118,70,4
South Africa,190,234.274,7.4,0.373684,232.363,7.33158,0.342105,777,Q de Kock,0,0,0,0,0,0,0,0,16,5,21,16,5,21,223,202,2,0,1,5.12963,0.240741,39.1111,91.2311,54,4
South Africa,190,234.274,7.4,0.373684,232.363,7.33158,0.342105,777,F du Plessis,0,0,0,0,0,0,0,0,16,5,21,16,5,21,223,202,2,0,1,3.45122,0.292683,34.9268,83.135,82,4
South Africa,190,234.274,7.4,0.373684,232.363,7.33158,0.342105,777,HM Amla,0,0,0,0,0,0,0,0,16,5,21,16,5,21,223,202,2,0,1,5.20168,0.403361,48.7899,86.9292,119,4
Ireland,55,219.527,7.65455,0.290909,202.727,7.56364,0.4,778,WTS Porterfield,0,0,0,0,0,0,0,0,8,12,20,8,12,20,0,331,1,0,1,2.6,0.142857,24.6857,56.2866,35,3
Ireland,55,219.527,7.65455,0.290909,202.727,7.56364,0.4,778,PR Stirling,0,0,0,0,0,0,0,0,8,12,20,8,12,20,0,331,1,0,1,3.47826,0.173913,24.2174,88.1329,23,0
Ireland,55,219.527,7.65455,0.290909,202.727,7.56364,0.4,778,EC Joyce,0,0,0,0,0,0,0,0,8,12,20,8,12,20,0,331,1,0,1,3.08571,0.2,28.3429,68.6505,35,4
Zimbabwe,142,212.077,7.5,0.380282,227.704,6.97887,0.316901,778,CJ Chibhabha,0,0,0,0,0,0,0,0,12,5,17,12,5,17,332,326,1,0,1,2.56716,0.149254,23.5373,64.7373,67,1
Zimbabwe,142,212.077,7.5,0.380282,227.704,6.97887,0.316901,778,Sikandar Raza,0,0,0,0,0,0,0,0,12,5,17,12,5,17,332,326,1,0,1,3,0.131579,26.1842,81.1582,38,4
Australia,228,239.627,7.69737,0.372807,232.079,7.23246,0.337719,780,AJ Finch,0,0,0,0,0,0,0,0,12,11,23,12,11,23,0,376,1,1,1,4.52941,0.313725,37.2549,83.4431,51,4
Australia,228,239.627,7.69737,0.372807,232.079,7.23246,0.337719,780,DA Warner,0,0,0,0,0,0,0,0,12,11,23,12,11,23,0,376,1,1,1,4.20312,0.265625,35.2031,87.7336,64,4
Australia,228,239.627,7.69737,0.372807,232.079,7.23246,0.337719,780,SPD Smith,0,0,0,0,0,0,0,0,12,11,23,12,11,23,0,376,1,1,1,3.19298,0.22807,34.5614,87.0526,57,4
Sri Lanka,244,223.373,7.09016,0.344262,227.578,7.47541,0.385246,780,HDRL Thirimanne,0,0,0,0,0,0,0,0,4,14,18,4,14,18,377,312,0,0,1,2.77778,0.246914,31.5802,71.4725,81,4
Sri Lanka,244,223.373,7.09016,0.344262,227.578,7.47541,0.385246,780,TM Dilshan,0,0,0,0,0,0,0,0,4,14,18,4,14,18,377,312,0,0,1,4.60199,0.273632,38.3632,86.0219,201,4
Sri Lanka,244,223.373,7.09016,0.344262,227.578,7.47541,0.385246,780,KC Sangakkara,0,0,0,0,0,0,0,0,4,14,18,4,14,18,377,312,0,0,1,4.33659,0.360976,41.9854,80.6276,205,4
Bangladesh,160,218.438,7.70625,0.4,211.106,7.05,0.325,781,Tamim Iqbal,0,0,0,0,0,0,0,0,4,8,12,4,8,12,0,275,0,0,1,4.05344,0.274809,31.8015,76.8068,131,4
Bangladesh,160,218.438,7.70625,0.4,211.106,7.05,0.325,781,Imrul Kayes,0,0,0,0,0,0,0,0,4,8,12,4,8,12,0,275,0,0,1,3,0.207547,26.2642,63.6488,53,4
Bangladesh,160,218.438,7.70625,0.4,211.106,7.05,0.325,781,Soumya Sarkar,0,0,0,0,0,0,0,0,4,8,12,4,8,12,0,275,0,0,1,7.35714,0.357143,47.2857,99.1018,14,4
Bangladesh,160,218.438,7.70625,0.4,211.106,7.05,0.325,781,Mahmudullah,0,0,0,0,0,0,0,0,4,8,12,4,8,12,0,275,0,0,1,2.26531,0.153061,24.4286,70.9544,98,4
England,221,237.176,7.17647,0.289593,230.633,7.45701,0.384615,781,MM Ali,0,0,0,0,0,0,0,0,16,7,23,16,7,23,276,260,2,0,1,2.67647,0.117647,21.3824,94.5384,34,0
England,221,237.176,7.17647,0.289593,230.633,7.45701,0.384615,781,IR Bell,0,0,0,0,0,0,0,0,16,7,23,16,7,23,276,260,2,0,1,3.63433,0.246269,35.3806,75.6623,134,4
Ireland,55,219.527,7.65455,0.290909,202.727,7.56364,0.4,782,WTS Porterfield,0,0,0,0,0,0,0,0,24,6,30,24,6,30,0,259,3,0,1,2.6,0.142857,24.6857,56.2866,35,3
Ireland,55,219.527,7.65455,0.290909,202.727,7.56364,0.4,782,PR Stirling,0,0,0,0,0,0,0,0,24,6,30,24,6,30,0,259,3,0,1,3.47826,0.173913,24.2174,88.1329,23,0
India,259,242.378,7.15058,0.339768,244.568,7.12741,0.30888,782,RG Sharma,0,0,0,0,0,0,0,0,16,5,21,16,5,21,260,260,1,0,1,3.82836,0.268657,35.9179,83.083,134,4
India,259,242.378,7.15058,0.339768,244.568,7.12741,0.30888,782,S Dhawan,0,0,0,0,0,0,0,0,16,5,21,16,5,21,260,260,1,0,1,5.65217,0.362319,43.2174,88.9088,69,4
Bangladesh,160,218.438,7.70625,0.4,211.106,7.05,0.325,784,Tamim Iqbal,0,0,0,0,0,0,0,0,0,4,4,0,4,4,0,288,0,0,1,4.05344,0.274809,31.8015,76.8068,131,4
Bangladesh,160,218.438,7.70625,0.4,211.106,7.05,0.325,784,Imrul Kayes,0,0,0,0,0,0,0,0,0,4,4,0,4,4,0,288,0,0,1,3,0.207547,26.2642,63.6488,53,4
New Zealand,184,233.745,7.39674,0.36413,227.951,7.30435,0.353261,784,MJ Guptill,0,0,0,0,0,0,0,0,24,9,33,24,9,33,289,290,0,1,1,4.8087,0.313043,38.1217,82.7482,115,4
New Zealand,184,233.745,7.39674,0.36413,227.951,7.30435,0.353261,784,BB McCullum,0,0,0,0,0,0,0,0,24,9,33,24,9,33,289,290,0,1,1,3.98611,0.201389,29.9028,98.4004,144,0
New Zealand,184,233.745,7.39674,0.36413,227.951,7.30435,0.353261,784,KS Williamson,0,0,0,0,0,0,0,0,24,9,33,24,9,33,289,290,0,1,1,4.31707,0.390244,43.0488,82.8833,82,4
New Zealand,184,233.745,7.39674,0.36413,227.951,7.30435,0.353261,784,LRPL Taylor,0,0,0,0,0,0,0,0,24,9,33,24,9,33,289,290,0,1,1,3.68382,0.301471,36.7206,79.3959,136,4
Zimbabwe,142,212.077,7.5,0.380282,227.704,6.97887,0.316901,786,CJ Chibhabha,0,0,0,0,0,0,0,0,4,7,11,4,7,11,0,287,2,0,1,2.56716,0.149254,23.5373,64.7373,67,1
Zimbabwe,142,212.077,7.5,0.380282,227.704,6.97887,0.316901,786,H Masakadza,0,0,0,0,0,0,0,0,4,7,11,4,7,11,0,287,2,0,1,3.11215,0.186916,26.972,70.0485,107,4
Zimbabwe,142,212.077,7.5,0.380282,227.704,6.97887,0.316901,786,SF Mire,0,0,0,0,0,0,0,0,4,7,11,4,7,11,0,287,2,0,1,2.11111,0.222222,21,65.625,9,1
Zimbabwe,142,212.077,7.5,0.380282,227.704,6.97887,0.316901,786,BRM Taylor,0,0,0,0,0,0,0,0,4,7,11,4,7,11,0,287,2,0,1,3.3,0.26,33.56,76.3421,100,4
India,259,242.378,7.15058,0.339768,244.568,7.12741,0.30888,786,RG Sharma,0,0,0,0,0,0,0,0,12,7,19,12,7,19,288,288,1,0,1,3.82836,0.268657,35.9179,83.083,134,4
India,259,242.378,7.15058,0.339768,244.568,7.12741,0.30888,786,S Dhawan,0,0,0,0,0,0,0,0,12,7,19,12,7,19,288,288,1,0,1,5.65217,0.362319,43.2174,88.9088,69,4
Ireland,55,219.527,7.65455,0.290909,202.727,7.56364,0.4,789,WTS Porterfield,0,0,0,0,0,0,0,0,8,7,15,8,7,15,0,237,1,0,1,2.6,0.142857,24.6857,56.2866,35,3
Ireland,55,219.527,7.65455,0.290909,202.727,7.56364,0.4,789,PR Stirling,0,0,0,0,0,0,0,0,8,7,15,8,7,15,0,237,1,0,1,3.47826,0.173913,24.2174,88.1329,23,0
Ireland,55,219.527,7.65455,0.290909,202.727,7.56364,0.4,789,EC Joyce,0,0,0,0,0,0,0,0,8,7,15,8,7,15,0,237,1,0,1,3.08571,0.2,28.3429,68.6505,35,4
Pakistan,211,222.621,7.38389,0.393365,235.517,7.54976,0.336493,789,Ahmed Shehzad,0,0,0,0,0,0,0,0,4,10,14,4,10,14,238,241,3,0,1,3.67143,0.242857,33.2714,70.8118,70,4
Pakistan,211,222.621,7.38389,0.393365,235.517,7.54976,0.336493,789,Sarfraz Ahmed,0,0,0,0,0,0,0,0,4,10,14,4,10,14,238,241,3,0,1,2.04878,0.097561,25.4878,83.9357,41,4
Sri Lanka,244,223.373,7.09016,0.344262,227.578,7.47541,0.385246,790,MDKJ Perera,0,0,0,0,0,0,0,0,0,4,4,0,4,4,0,133,2,0,1,3.30435,0.195652,25.7391,90.5199,46,0
Sri Lanka,244,223.373,7.09016,0.344262,227.578,7.47541,0.385246,790,KC Sangakkara,0,0,0,0,0,0,0,0,0,4,4,0,4,4,0,133,2,0,1,4.33659,0.360976,41.9854,80.6276,205,4
Sri Lanka,244,223.373,7.09016,0.344262,227.578,7.47541,0.385246,790,TM Dilshan,0,0,0,0,0,0,0,0,0,4,4,0,4,4,0,133,2,0,1,4.60199,0.273632,38.3632,86.0219,201,4
Sri Lanka,244,223.373,7.09016,0.344262,227.578,7.47541,0.385246,790,HDRL Thirimanne,0,0,0,0,0,0,0,0,0,4,4,0,4,4,0,133,2,0,1,2.77778,0.246914,31.5802,71.4725,81,4
South Africa,190,234.274,7.4,0.373684,232.363,7.33158,0.342105,790,HM Amla,0,0,0,0,0,0,0,0,20,11,31,20,11,31,134,134,1,0,1,5.20168,0.403361,48.7899,86.9292,119,4
South Africa,190,234.274,7.4,0.373684,232.363,7.33158,0.342105,790,Q de Kock,0,0,0,0,0,0,0,0,20,11,31,20,11,31,134,134,1,0,1,5.12963,0.240741,39.1111,91.2311,54,4
India,259,242.378,7.15058,0.339768,244.568,7.12741,0.30888,791,RG Sharma,0,0,0,0,0,0,0,0,16,5,21,16,5,21,0,302,5,0,1,3.82836,0.268657,35.9179,83.083,134,4
India,259,242.378,7.15058,0.339768,244.568,7.12741,0.30888,791,S Dhawan,0,0,0,0,0,0,0,0,16,5,21,16,5,21,0,302,5,0,1,5.65217,0.362319,43.2174,88.9088,69,4
Bangladesh,160,218.438,7.70625,0.4,211.106,7.05,0.325,791,Tamim Iqbal,0,0,0,0,0,0,0,0,12,8,20,12,8,20,303,193,3,0,1,4.05344,0.274809,31.8015,76.8068,131,4
Bangladesh,160,218.438,7.70625,0.4,211.106,7.05,0.325,791,Imrul Kayes,0,0,0,0,0,0,0,0,12,8,20,12,8,20,303,193,3,0,1,3,0.207547,26.2642,63.6488,53,4
Pakistan,211,222.621,7.38389,0.393365,235.517,7.54976,0.336493,792,Ahmed Shehzad,0,0,0,0,0,0,0,0,8,11,19,8,11,19,0,213,5,0,1,3.67143,0.242857,33.2714,70.8118,70,4
Pakistan,211,222.621,7.38389,0.393365,235.517,7.54976,0.336493,792,Sarfraz Ahmed,0,0,0,0,0,0,0,0,8,11,19,8,11,19,0,213,5,0,1,2.04878,0.097561,25.4878,83.9357,41,4
Pakistan,211,222.621,7.38389,0.393365,235.517,7.54976,0.336493,792,Haris Sohail,0,0,0,0,0,0,0,0,8,11,19,8,11,19,0,213,5,0,1,3.25,0.3,35.2,80.8266,20,4
Australia,228,239.627,7.69737,0.372807,232.079,7.23246,0.337719,792,DA Warner,0,0,0,0,0,0,0,0,12,11,23,12,11,23,214,216,0,1,1,4.20312,0.265625,35.2031,87.7336,64,4
Australia,228,239.627,7.69737,0.372807,232.079,7.23246,0.337719,792,AJ Finch,0,0,0,0,0,0,0,0,12,11,23,12,11,23,214,216,0,1,1,4.52941,0.313725,37.2549,83.4431,51,4
Australia,228,239.627,7.69737,0.372807,232.079,7.23246,0.337719,792,SPD Smith,0,0,0,0,0,0,0,0,12,11,23,12,11,23,214,216,0,1,1,3.19298,0.22807,34.5614,87.0526,57,4
South Africa,190,234.274,7.4,0.373684,232.363,7.33158,0.342105,793,HM Amla,0,0,0,0,0,0,0,0,20,6,26,20,6,26,0,281,0,0,1,5.20168,0.403361,48.7899,86.9292,119,4
South Africa,190,234.274,7.4,0.373684,232.363,7.33158,0.342105,793,Q de Kock,0,0,0,0,0,0,0,0,20,6,26,20,6,26,0,281,0,0,1,5.12963,0.240741,39.1111,91.2311,54,4
South Africa,190,234.274,7.4,0.373684,232.363,7.33158,0.342105,793,F du Plessis,0,0,0,0,0,0,0,0,20,6,26,20,6,26,0,281,0,0,1,3.45122,0.292683,34.9268,83.135,82,4
New Zealand,184,233.745,7.39674,0.36413,227.951,7.30435,0.353261,793,MJ Guptill,0,0,0,0,0,0,0,0,60,5,65,60,5,65,282,299,6,1,1,4.8087,0.313043,38.1217,82.7482,115,4
New Zealand,184,233.745,7.39674,0.36413,227.951,7.30435,0.353261,793,BB McCullum,0,0,0,0,0,0,0,0,60,5,65,60,5,65,282,299,6,1,1,3.98611,0.201389,29.9028,98.4004,144,0
Australia,228,239.627,7.69737,0.372807,232.079,7.23246,0.337719,794,AJ Finch,0,0,0,0,0,0,0,0,18,11,29,18,11,29,0,328,2,1,1,4.52941,0.313725,37.2549,83.4431,51,4
Australia,228,239.627,7.69737,0.372807,232.079,7.23246,0.337719,794,DA Warner,0,0,0,0,0,0,0,0,18,11,29,18,11,29,0,328,2,1,1,4.20312,0.265625,35.2031,87.7336,64,4
Australia,228,239.627,7.69737,0.372807,232.079,7.23246,0.337719,794,SPD Smith,0,0,0,0,0,0,0,0,18,11,29,18,11,29,0,328,2,1,1,3.19298,0.22807,34.5614,87.0526,57,4
India,259,242.378,7.15058,0.339768,244.568,7.12741,0.30888,794,RG Sharma,0,0,0,0,0,0,0,0,8,10,18,8,10,18,329,233,2,0,1,3.82836,0.268657,35.9179,83.083,134,4
India,259,242.378,7.15058,0.339768,244.568,7.12741,0.30888,794,S Dhawan,0,0,0,0,0,0,0,0,8,10,18,8,10,18,329,233,2,0,1,5.65217,0.362319,43.2174,88.9088,69,4
New Zealand,184,233.745,7.39674,0.36413,227.951,7.30435,0.353261,795,MJ Guptill,0,0,0,0,0,0,0,0,10,4,14,10,4,14,0,183,4,0,1,4.8087,0.313043,38.1217,82.7482,115,4
New Zealand,184,233.745,7.39674,0.36413,227.951,7.30435,0.353261,795,BB McCullum,0,0,0,0,0,0,0,0,10,4,14,10,4,14,0,183,4,0,1,3.98611,0.201389,29.9028,98.4004,144,0
New Zealand,184,233.745,7.39674,0.36413,227.951,7.30435,0.353261,795,KS Williamson,0,0,0,0,0,0,0,0,10,4,14,10,4,14,0,183,4,0,1,4.31707,0.390244,43.0488,82.8833,82,4
Australia,228,239.627,7.69737,0.372807,232.079,7.23246,0.337719,795,DA Warner,0,0,0,0,0,0,0,0,16,13,29,16,13,29,184,186,4,1,1,4.20312,0.265625,35.2031,87.7336,64,4
Australia,228,239.627,7.69737,0.372807,232.079,7.23246,0.337719,795,AJ Finch,0,0,0,0,0,0,0,0,16,13,29,16,13,29,184,186,4,1,1,4.52941,0.313725,37.2549,83.4431,51,4
Australia,228,239.627,7.69737,0.372807,232.079,7.23246,0.337719,795,SPD Smith,0,0,0,0,0,0,0,0,16,13,29,16,13,29,184,186,4,1,1,3.19298,0.22807,34.5614,87.0526,57,4
Pakistan,211,222.621,7.38389,0.393365,235.517,7.54976,0.336493,796,Sharjeel Khan,0,0,0,0,0,0,0,0,22,8,30,22,8,30,0,322,2,0,1,2.6,0.1,16.9,81.25,10,1
Pakistan,211,222.621,7.38389,0.393365,235.517,7.54976,0.336493,796,Ahmed Shehzad,0,0,0,0,0,0,0,0,22,8,30,22,8,30,0,322,2,0,1,3.67143,0.242857,33.2714,70.8118,70,4
Sri Lanka,244,223.373,7.09016,0.344262,227.578,7.47541,0.385246,796,MDKJ Perera,0,0,0,0,0,0,0,0,4,16,20,4,16,20,323,311,1,0,1,3.30435,0.195652,25.7391,90.5199,46,0
Sri Lanka,244,223.373,7.09016,0.344262,227.578,7.47541,0.385246,796,TM Dilshan,0,0,0,0,0,0,0,0,4,16,20,4,16,20,323,311,1,0,1,4.60199,0.273632,38.3632,86.0219,201,4
Pakistan,211,222.621,7.38389,0.393365,235.517,7.54976,0.336493,797,Sharjeel Khan,0,0,0,0,0,0,0,0,4,14,18,4,14,18,0,284,5,0,1,2.6,0.1,16.9,81.25,10,1
Pakistan,211,222.621,7.38389,0.393365,235.517,7.54976,0.336493,797,Ahmed Shehzad,0,0,0,0,0,0,0,0,4,14,18,4,14,18,0,284,5,0,1,3.67143,0.242857,33.2714,70.8118,70,4
Pakistan,211,222.621,7.38389,0.393365,235.517,7.54976,0.336493,797,Mohammad Hafeez,0,0,0,0,0,0,0,0,4,14,18,4,14,18,0,284,5,0,1,4.04511,0.255639,34.3534,78.0625,133,4
Sri Lanka,244,223.373,7.09016,0.344262,227.578,7.47541,0.385246,797,MDKJ Perera,0,0,0,0,0,0,0,0,8,10,18,8,10,18,285,287,0,0,1,3.30435,0.195652,25.7391,90.5199,46,0
Sri Lanka,244,223.373,7.09016,0.344262,227.578,7.47541,0.385246,797,TM Dilshan,0,0,0,0,0,0,0,0,8,10,18,8,10,18,285,287,0,0,1,4.60199,0.273632,38.3632,86.0219,201,4
Pakistan,211,222.621,7.38389,0.393365,235.517,7.54976,0.336493,798,Sharjeel Khan,0,0,0,0,0,0,0,0,4,11,15,4,11,15,0,326,0,0,1,2.6,0.1,16.9,81.25,10,1
Pakistan,211,222.621,7.38389,0.393365,235.517,7.54976,0.336493,798,Ahmed Shehzad,0,0,0,0,0,0,0,0,4,11,15,4,11,15,0,326,0,0,1,3.67143,0.242857,33.2714,70.8118,70,4
Pakistan,211,222.621,7.38389,0.393365,235.517,7.54976,0.336493,798,Mohammad Hafeez,0,0,0,0,0,0,0,0,4,11,15,4,11,15,0,326,0,0,1,4.04511,0.255639,34.3534,78.0625,133,4
Sri Lanka,244,223.373,7.09016,0.344262,227.578,7.47541,0.385246,798,MDKJ Perera,0,0,0,0,0,0,0,0,16,10,26,16,10,26,327,213,0,0,1,3.30435,0.195652,25.7391,90.5199,46,0
Sri Lanka,244,223.373,7.09016,0.344262,227.578,7.47541,0.385246,798,TM Dilshan,0,0,0,0,0,0,0,0,16,10,26,16,10,26,327,213,0,0,1,4.60199,0.273632,38.3632,86.0219,201,4
Sri Lanka,244,223.373,7.09016,0.344262,227.578,7.47541,0.385246,798,FDM Karunaratne,0,0,0,0,0,0,0,0,16,10,26,16,10,26,327,213,0,0,1,0.8,0,10.7,64.8485,10,1
Sri Lanka,244,223.373,7.09016,0.344262,227.578,7.47541,0.385246,798,KC Sangakkara,0,0,0,0,0,0,0,0,16,10,26,16,10,26,327,213,0,0,1,4.33659,0.360976,41.9854,80.6276,205,4
Sri Lanka,244,223.373,7.09016,0.344262,227.578,7.47541,0.385246,799,MDKJ Perera,0,0,0,0,0,0,0,0,16,11,27,16,11,27,0,225,0,0,1,3.30435,0.195652,25.7391,90.5199,46,0
Sri Lanka,244,223.373,7.09016,0.344262,227.578,7.47541,0.385246,799,TM Dilshan,0,0,0,0,0,0,0,0,16,11,27,16,11,27,0,225,0,0,1,4.60199,0.273632,38.3632,86.0219,201,4
Sri Lanka,244,223.373,7.09016,0.344262,227.578,7.47541,0.385246,799,KC Sangakkara,0,0,0,0,0,0,0,0,16,11,27,16,11,27,0,225,0,0,1,4.33659,0.360976,41.9854,80.6276,205,4
Sri Lanka,244,223.373,7.09016,0.344262,227.578,7.47541,0.385246,799,LD Chandimal,0,0,0,0,0,0,0,0,16,11,27,16,11,27,0,225,0,0,1,2.18478,0.184783,25.7391,73.8615,92,4
Pakistan,211,222.621,7.38389,0.393365,235.517,7.54976,0.336493,799,Sharjeel Khan,0,0,0,0,0,0,0,0,20,10,30,20,10,30,226,226,1,0,1,2.6,0.1,16.9,81.25,10,1
Pakistan,211,222.621,7.38389,0.393365,235.517,7.54976,0.336493,799,Ahmed Shehzad,0,0,0,0,0,0,0,0,20,10,30,20,10,30,226,226,1,0,1,3.67143,0.242857,33.2714,70.8118,70,4
Pakistan,211,222.621,7.38389,0.393365,235.517,7.54976,0.336493,800,Sharjeel Khan,0,0,0,0,0,0,0,0,12,7,19,12,7,19,0,232,1,0,1,2.6,0.1,16.9,81.25,10,1
Pakistan,211,222.621,7.38389,0.393365,235.517,7.54976,0.336493,800,Ahmed Shehzad,0,0,0,0,0,0,0,0,12,7,19,12,7,19,0,232,1,0,1,3.67143,0.242857,33.2714,70.8118,70,4
Sri Lanka,244,223.373,7.09016,0.344262,227.578,7.47541,0.385246,800,MDKJ Perera,0,0,0,0,0,0,0,0,16,8,24,16,8,24,233,235,2,0,1,3.30435,0.195652,25.7391,90.5199,46,0
Sri Lanka,244,223.373,7.09016,0.344262,227.578,7.47541,0.385246,800,TM Dilshan,0,0,0,0,0,0,0,0,16,8,24,16,8,24,233,235,2,0,1,4.60199,0.273632,38.3632,86.0219,201,4
Pakistan,211,222.621,7.38389,0.393365,235.517,7.54976,0.336493,801,Nasir Jamshed,0,0,0,0,0,0,0,0,0,8,8,0,8,8,0,244,5,0,1,3.63043,0.23913,30.2174,73.8184,46,4
Pakistan,211,222.621,7.38389,0.393365,235.517,7.54976,0.336493,801,Ahmed Shehzad,0,0,0,0,0,0,0,0,0,8,8,0,8,8,0,244,5,0,1,3.67143,0.242857,33.2714,70.8118,70,4
Zimbabwe,142,212.077,7.5,0.380282,227.704,6.97887,0.316901,801,H Masakadza,0,0,0,0,0,0,0,0,8,6,14,8,6,14,245,246,4,1,1,3.11215,0.186916,26.972,70.0485,107,4
Zimbabwe,142,212.077,7.5,0.380282,227.704,6.97887,0.316901,801,V Sibanda,0,0,0,0,0,0,0,0,8,6,14,8,6,14,245,246,4,1,1,2.9697,0.181818,23.5152,63.5545,66,1
Pakistan,211,222.621,7.38389,0.393365,235.517,7.54976,0.336493,802,Nasir Jamshed,0,0,0,0,0,0,0,0,8,5,13,8,5,13,0,260,2,0,1,3.63043,0.23913,30.2174,73.8184,46,4
Pakistan,211,222.621,7.38389,0.393365,235.517,7.54976,0.336493,802,Ahmed Shehzad,0,0,0,0,0,0,0,0,8,5,13,8,5,13,0,260,2,0,1,3.67143,0.242857,33.2714,70.8118,70,4
Zimbabwe,142,212.077,7.5,0.380282,227.704,6.97887,0.316901,802,H Masakadza,0,0,0,0,0,0,0,0,4,6,10,4,6,10,261,152,8,1,1,3.11215,0.186916,26.972,70.0485,107,4
Zimbabwe,142,212.077,7.5,0.380282,227.704,6.97887,0.316901,802,V Sibanda,0,0,0,0,0,0,0,0,4,6,10,4,6,10,261,152,8,1,1,2.9697,0.181818,23.5152,63.5545,66,1
Zimbabwe,142,212.077,7.5,0.380282,227.704,6.97887,0.316901,802,BRM Taylor,0,0,0,0,0,0,0,0,4,6,10,4,6,10,261,152,8,1,1,3.3,0.26,33.56,76.3421,100,4
New Zealand,184,233.745,7.39674,0.36413,227.951,7.30435,0.353261,805,MJ Guptill,0,0,0,0,0,0,0,0,0,5,5,0,5,5,0,156,0,1,1,4.8087,0.313043,38.1217,82.7482,115,4
New Zealand,184,233.745,7.39674,0.36413,227.951,7.30435,0.353261,805,JD Ryder,0,0,0,0,0,0,0,0,0,5,5,0,5,5,0,156,0,1,1,4.88571,0.257143,34.4,97.2536,35,0
New Zealand,184,233.745,7.39674,0.36413,227.951,7.30435,0.353261,805,KS Williamson,0,0,0,0,0,0,0,0,0,5,5,0,5,5,0,156,0,1,1,4.31707,0.390244,43.0488,82.8833,82,4
West Indies,176,217.33,7.15909,0.3125,225.278,7.57386,0.380682,805,J Charles,0,0,0,0,0,0,0,0,14,3,17,14,3,17,157,157,1,0,1,3.82353,0.147059,28.2353,81.2183,34,4
West Indies,176,217.33,7.15909,0.3125,225.278,7.57386,0.380682,805,KOA Powell,0,0,0,0,0,0,0,0,14,3,17,14,3,17,157,157,1,0,1,3.59259,0.222222,26.4815,80.6088,27,4
West Indies,176,217.33,7.15909,0.3125,225.278,7.57386,0.380682,805,DM Bravo,0,0,0,0,0,0,0,0,14,3,17,14,3,17,157,157,1,0,1,3,0.226667,28.52,67.4551,75,4
New Zealand,184,233.745,7.39674,0.36413,227.951,7.30435,0.353261,806,MJ Guptill,0,0,0,0,0,0,0,0,50,7,57,50,7,57,0,283,0,1,1,4.8087,0.313043,38.1217,82.7482,115,4
New Zealand,184,233.745,7.39674,0.36413,227.951,7.30435,0.353261,806,JD Ryder,0,0,0,0,0,0,0,0,50,7,57,50,7,57,0,283,0,1,1,4.88571,0.257143,34.4,97.2536,35,0
New Zealand,184,233.745,7.39674,0.36413,227.951,7.30435,0.353261,806,BB McCullum,0,0,0,0,0,0,0,0,50,7,57,50,7,57,0,283,0,1,1,3.98611,0.201389,29.9028,98.4004,144,0
West Indies,176,217.33,7.15909,0.3125,225.278,7.57386,0.380682,806,J Charles,0,0,0,0,0,0,0,0,10,9,19,10,9,19,284,124,1,0,1,3.82353,0.147059,28.2353,81.2183,34,4
West Indies,176,217.33,7.15909,0.3125,225.278,7.57386,0.380682,806,LMP Simmons,0,0,0,0,0,0,0,0,10,9,19,10,9,19,284,124,1,0,1,3.3125,0.28125,30.5938,71.4338,64,4
West Indies,176,217.33,7.15909,0.3125,225.278,7.57386,0.380682,806,CAK Walton,0,0,0,0,0,0,0,0,10,9,19,10,9,19,284,124,1,0,1,0.25,0,4.25,56.6667,4,3
West Indies,176,217.33,7.15909,0.3125,225.278,7.57386,0.380682,806,KOA Powell,0,0,0,0,0,0,0,0,10,9,19,10,9,19,284,124,1,0,1,3.59259,0.222222,26.4815,80.6088,27,4
West Indies,176,217.33,7.15909,0.3125,225.278,7.57386,0.380682,806,DJ Bravo,0,0,0,0,0,0,0,0,10,9,19,10,9,19,284,124,1,0,1,2.35514,0.11215,23.1589,80.9011,107,4
New Zealand,184,233.745,7.39674,0.36413,227.951,7.30435,0.353261,807,MJ Guptill,0,0,0,0,0,0,0,0,8,6,14,8,6,14,0,285,0,1,1,4.8087,0.313043,38.1217,82.7482,115,4
New Zealand,184,233.745,7.39674,0.36413,227.951,7.30435,0.353261,807,JD Ryder,0,0,0,0,0,0,0,0,8,6,14,8,6,14,0,285,0,1,1,4.88571,0.257143,34.4,97.2536,35,0
West Indies,176,217.33,7.15909,0.3125,225.278,7.57386,0.380682,807,CAK Walton,0,0,0,0,0,0,0,0,12,4,16,12,4,16,286,134,0,0,1,0.25,0,4.25,56.6667,4,3
West Indies,176,217.33,7.15909,0.3125,225.278,7.57386,0.380682,807,KA Edwards,0,0,0,0,0,0,0,0,12,4,16,12,4,16,286,134,0,0,1,1.875,0.0625,20.6875,64.902,16,1
West Indies,176,217.33,7.15909,0.3125,225.278,7.57386,0.380682,807,J Charles,0,0,0,0,0,0,0,0,12,4,16,12,4,16,286,134,0,0,1,3.82353,0.147059,28.2353,81.2183,34,4
West Indies,176,217.33,7.15909,0.3125,225.278,7.57386,0.380682,807,LMP Simmons,0,0,0,0,0,0,0,0,12,4,16,12,4,16,286,134,0,0,1,3.3125,0.28125,30.5938,71.4338,64,4
West Indies,176,217.33,7.15909,0.3125,225.278,7.57386,0.380682,808,KOA Powell,0,0,0,0,0,0,0,0,34,3,37,34,3,37,0,363,0,0,1,3.59259,0.222222,26.4815,80.6088,27,4
West Indies,176,217.33,7.15909,0.3125,225.278,7.57386,0.380682,808,J Charles,0,0,0,0,0,0,0,0,34,3,37,34,3,37,0,363,0,0,1,3.82353,0.147059,28.2353,81.2183,34,4
New Zealand,184,233.745,7.39674,0.36413,227.951,7.30435,0.353261,808,MJ Guptill,0,0,0,0,0,0,0,0,12,16,28,12,16,28,364,160,0,1,1,4.8087,0.313043,38.1217,82.7482,115,4
New Zealand,184,233.745,7.39674,0.36413,227.951,7.30435,0.353261,808,JD Ryder,0,0,0,0,0,0,0,0,12,16,28,12,16,28,364,160,0,1,1,4.88571,0.257143,34.4,97.2536,35,0
New Zealand,184,233.745,7.39674,0.36413,227.951,7.30435,0.353261,808,KS Williamson,0,0,0,0,0,0,0,0,12,16,28,12,16,28,364,160,0,1,1,4.31707,0.390244,43.0488,82.8833,82,4
New Zealand,184,233.745,7.39674,0.36413,227.951,7.30435,0.353261,809,MJ Guptill,0,0,0,0,0,0,0,0,22,2,24,22,2,24,0,292,2,1,1,4.8087,0.313043,38.1217,82.7482,115,4
New Zealand,184,233.745,7.39674,0.36413,227.951,7.30435,0.353261,809,JD Ryder,0,0,0,0,0,0,0,0,22,2,24,22,2,24,0,292,2,1,1,4.88571,0.257143,34.4,97.2536,35,0
India,259,242.378,7.15058,0.339768,244.568,7.12741,0.30888,809,RG Sharma,0,0,0,0,0,0,0,0,0,10,10,0,10,10,293,268,5,0,1,3.82836,0.268657,35.9179,83.083,134,4
India,259,242.378,7.15058,0.339768,244.568,7.12741,0.30888,809,S Dhawan,0,0,0,0,0,0,0,0,0,10,10,0,10,10,293,268,5,0,1,5.65217,0.362319,43.2174,88.9088,69,4
New Zealand,184,233.745,7.39674,0.36413,227.951,7.30435,0.353261,810,MJ Guptill,0,0,0,0,0,0,0,0,12,8,20,12,8,20,0,271,1,1,1,4.8087,0.313043,38.1217,82.7482,115,4
New Zealand,184,233.745,7.39674,0.36413,227.951,7.30435,0.353261,810,JD Ryder,0,0,0,0,0,0,0,0,12,8,20,12,8,20,0,271,1,1,1,4.88571,0.257143,34.4,97.2536,35,0
India,259,242.378,7.15058,0.339768,244.568,7.12741,0.30888,810,S Dhawan,0,0,0,0,0,0,0,0,4,6,10,4,6,10,272,277,0,0,1,5.65217,0.362319,43.2174,88.9088,69,4
India,259,242.378,7.15058,0.339768,244.568,7.12741,0.30888,810,RG Sharma,0,0,0,0,0,0,0,0,4,6,10,4,6,10,272,277,0,0,1,3.82836,0.268657,35.9179,83.083,134,4
India,259,242.378,7.15058,0.339768,244.568,7.12741,0.30888,811,RG Sharma,0,0,0,0,0,0,0,0,0,6,6,0,6,6,0,278,1,0,1,3.82836,0.268657,35.9179,83.083,134,4
India,259,242.378,7.15058,0.339768,244.568,7.12741,0.30888,811,V Kohli,0,0,0,0,0,0,0,0,0,6,6,0,6,6,0,278,1,0,1,4.66456,0.379747,44.9937,88.3325,158,4
India,259,242.378,7.15058,0.339768,244.568,7.12741,0.30888,811,AM Rahane,0,0,0,0,0,0,0,0,0,6,6,0,6,6,0,278,1,0,1,3.55738,0.262295,32.2295,78.0159,61,4
New Zealand,184,233.745,7.39674,0.36413,227.951,7.30435,0.353261,811,MJ Guptill,0,0,0,0,0,0,0,0,28,5,33,28,5,33,279,280,0,1,1,4.8087,0.313043,38.1217,82.7482,115,4
New Zealand,184,233.745,7.39674,0.36413,227.951,7.30435,0.353261,811,JD Ryder,0,0,0,0,0,0,0,0,28,5,33,28,5,33,279,280,0,1,1,4.88571,0.257143,34.4,97.2536,35,0
New Zealand,184,233.745,7.39674,0.36413,227.951,7.30435,0.353261,812,MJ Guptill,0,0,0,0,0,0,0,0,0,7,7,0,7,7,0,303,3,1,1,4.8087,0.313043,38.1217,82.7482,115,4
New Zealand,184,233.745,7.39674,0.36413,227.951,7.30435,0.353261,812,JD Ryder,0,0,0,0,0,0,0,0,0,7,7,0,7,7,0,303,3,1,1,4.88571,0.257143,34.4,97.2536,35,0
India,259,242.378,7.15058,0.339768,244.568,7.12741,0.30888,812,RG Sharma,0,0,0,0,0,0,0,0,0,8,8,0,8,8,304,216,0,0,1,3.82836,0.268657,35.9179,83.083,134,4
India,259,242.378,7.15058,0.339768,244.568,7.12741,0.30888,812,S Dhawan,0,0,0,0,0,0,0,0,0,8,8,0,8,8,304,216,0,0,1,5.65217,0.362319,43.2174,88.9088,69,4
India,259,242.378,7.15058,0.339768,244.568,7.12741,0.30888,812,V Kohli,0,0,0,0,0,0,0,0,0,8,8,0,8,8,304,216,0,0,1,4.66456,0.379747,44.9937,88.3325,158,4
India,259,242.378,7.15058,0.339768,244.568,7.12741,0.30888,813,RG Sharma,0,0,0,0,0,0,0,0,8,2,10,8,2,10,0,304,1,0,1,3.82836,0.268657,35.9179,83.083,134,4
India,259,242.378,7.15058,0.339768,244.568,7.12741,0.30888,813,S Dhawan,0,0,0,0,0,0,0,0,8,2,10,8,2,10,0,304,1,0,1,5.65217,0.362319,43.2174,88.9088,69,4
England,221,237.176,7.17647,0.289593,230.633,7.45701,0.384615,813,AN Cook,0,0,0,0,0,0,0,0,8,12,20,8,12,20,305,161,0,1,1,4.17045,0.272727,35.75,75.5524,88,4
England,221,237.176,7.17647,0.289593,230.633,7.45701,0.384615,813,AD Hales,0,0,0,0,0,0,0,0,8,12,20,8,12,20,305,161,0,1,1,4.2963,0.296296,34.1111,85.1201,27,4
England,221,237.176,7.17647,0.289593,230.633,7.45701,0.384615,814,AN Cook,0,0,0,0,0,0,0,0,0,10,10,0,10,10,0,227,1,1,1,4.17045,0.272727,35.75,75.5524,88,4
England,221,237.176,7.17647,0.289593,230.633,7.45701,0.384615,814,AD Hales,0,0,0,0,0,0,0,0,0,10,10,0,10,10,0,227,1,1,1,4.2963,0.296296,34.1111,85.1201,27,4
India,259,242.378,7.15058,0.339768,244.568,7.12741,0.30888,814,AM Rahane,0,0,0,0,0,0,0,0,12,11,23,12,11,23,228,228,1,0,1,3.55738,0.262295,32.2295,78.0159,61,4
India,259,242.378,7.15058,0.339768,244.568,7.12741,0.30888,814,S Dhawan,0,0,0,0,0,0,0,0,12,11,23,12,11,23,228,228,1,0,1,5.65217,0.362319,43.2174,88.9088,69,4
England,221,237.176,7.17647,0.289593,230.633,7.45701,0.384615,815,AN Cook,0,0,0,0,0,0,0,0,12,4,16,12,4,16,0,206,0,1,1,4.17045,0.272727,35.75,75.5524,88,4
England,221,237.176,7.17647,0.289593,230.633,7.45701,0.384615,815,AD Hales,0,0,0,0,0,0,0,0,12,4,16,12,4,16,0,206,0,1,1,4.2963,0.296296,34.1111,85.1201,27,4
England,221,237.176,7.17647,0.289593,230.633,7.45701,0.384615,815,GS Ballance,0,0,0,0,0,0,0,0,12,4,16,12,4,16,0,206,0,1,1,1.69231,0.153846,22,66.3573,13,1
England,221,237.176,7.17647,0.289593,230.633,7.45701,0.384615,815,JE Root,0,0,0,0,0,0,0,0,12,4,16,12,4,16,0,206,0,1,1,3.68852,0.327869,41.6721,83.3443,61,4
India,259,242.378,7.15058,0.339768,244.568,7.12741,0.30888,815,AM Rahane,0,0,0,0,0,0,0,0,16,4,20,16,4,20,207,212,0,0,1,3.55738,0.262295,32.2295,78.0159,61,4
India,259,242.378,7.15058,0.339768,244.568,7.12741,0.30888,815,S Dhawan,0,0,0,0,0,0,0,0,16,4,20,16,4,20,207,212,0,0,1,5.65217,0.362319,43.2174,88.9088,69,4
England,221,237.176,7.17647,0.289593,230.633,7.45701,0.384615,816,AN Cook,0,0,0,0,0,0,0,0,12,12,24,12,12,24,0,294,2,1,1,4.17045,0.272727,35.75,75.5524,88,4
England,221,237.176,7.17647,0.289593,230.633,7.45701,0.384615,816,AD Hales,0,0,0,0,0,0,0,0,12,12,24,12,12,24,0,294,2,1,1,4.2963,0.296296,34.1111,85.1201,27,4
England,221,237.176,7.17647,0.289593,230.633,7.45701,0.384615,816,MM Ali,0,0,0,0,0,0,0,0,12,12,24,12,12,24,0,294,2,1,1,2.67647,0.117647,21.3824,94.5384,34,0
India,259,242.378,7.15058,0.339768,244.568,7.12741,0.30888,816,AM Rahane,0,0,0,0,0,0,0,0,12,5,17,12,5,17,295,253,1,0,1,3.55738,0.262295,32.2295,78.0159,61,4
India,259,242.378,7.15058,0.339768,244.568,7.12741,0.30888,816,V Kohli,0,0,0,0,0,0,0,0,12,5,17,12,5,17,295,253,1,0,1,4.66456,0.379747,44.9937,88.3325,158,4
India,259,242.378,7.15058,0.339768,244.568,7.12741,0.30888,816,S Dhawan,0,0,0,0,0,0,0,0,12,5,17,12,5,17,295,253,1,0,1,5.65217,0.362319,43.2174,88.9088,69,4
England,221,237.176,7.17647,0.289593,230.633,7.45701,0.384615,817,AN Cook,0,0,0,0,0,0,0,0,12,9,21,12,9,21,0,247,1,1,1,4.17045,0.272727,35.75,75.5524,88,4
England,221,237.176,7.17647,0.289593,230.633,7.45701,0.384615,817,IR Bell,0,0,0,0,0,0,0,0,12,9,21,12,9,21,0,247,1,1,1,3.63433,0.246269,35.3806,75.6623,134,4
Sri Lanka,244,223.373,7.09016,0.344262,227.578,7.47541,0.385246,817,HDRL Thirimanne,0,0,0,0,0,0,0,0,12,4,16,12,4,16,248,144,2,0,1,2.77778,0.246914,31.5802,71.4725,81,4
Sri Lanka,244,223.373,7.09016,0.344262,227.578,7.47541,0.385246,817,KC Sangakkara,0,0,0,0,0,0,0,0,12,4,16,12,4,16,248,144,2,0,1,4.33659,0.360976,41.9854,80.6276,205,4
Sri Lanka,244,223.373,7.09016,0.344262,227.578,7.47541,0.385246,817,TM Dilshan,0,0,0,0,0,0,0,0,12,4,16,12,4,16,248,144,2,0,1,4.60199,0.273632,38.3632,86.0219,201,4
Sri Lanka,244,223.373,7.09016,0.344262,227.578,7.47541,0.385246,818,HDRL Thirimanne,0,0,0,0,0,0,0,0,8,5,13,8,5,13,0,256,4,0,1,2.77778,0.246914,31.5802,71.4725,81,4
Sri Lanka,244,223.373,7.09016,0.344262,227.578,7.47541,0.385246,818,TM Dilshan,0,0,0,0,0,0,0,0,8,5,13,8,5,13,0,256,4,0,1,4.60199,0.273632,38.3632,86.0219,201,4
England,221,237.176,7.17647,0.289593,230.633,7.45701,0.384615,818,MA Carberry,0,0,0,0,0,0,0,0,8,14,22,8,14,22,257,99,4,1,1,2.8,0.2,22.6,63.4831,5,1
England,221,237.176,7.17647,0.289593,230.633,7.45701,0.384615,818,IR Bell,0,0,0,0,0,0,0,0,8,14,22,8,14,22,257,99,4,1,1,3.63433,0.246269,35.3806,75.6623,134,4
England,221,237.176,7.17647,0.289593,230.633,7.45701,0.384615,818,GS Ballance,0,0,0,0,0,0,0,0,8,14,22,8,14,22,257,99,4,1,1,1.69231,0.153846,22,66.3573,13,1
England,221,237.176,7.17647,0.289593,230.633,7.45701,0.384615,818,JE Root,0,0,0,0,0,0,0,0,8,14,22,8,14,22,257,99,4,1,1,3.68852,0.327869,41.6721,83.3443,61,4
Sri Lanka,244,223.373,7.09016,0.344262,227.578,7.47541,0.385246,819,HDRL Thirimanne,0,0,0,0,0,0,0,0,8,7,15,8,7,15,0,67,2,0,1,2.77778,0.246914,31.5802,71.4725,81,4
Sri Lanka,244,223.373,7.09016,0.344262,227.578,7.47541,0.385246,819,TM Dilshan,0,0,0,0,0,0,0,0,8,7,15,8,7,15,0,67,2,0,1,4.60199,0.273632,38.3632,86.0219,201,4
Sri Lanka,244,223.373,7.09016,0.344262,227.578,7.47541,0.385246,819,KC Sangakkara,0,0,0,0,0,0,0,0,8,7,15,8,7,15,0,67,2,0,1,4.33659,0.360976,41.9854,80.6276,205,4
Sri Lanka,244,223.373,7.09016,0.344262,227.578,7.47541,0.385246,819,DPMD Jayawardene,0,0,0,0,0,0,0,0,8,7,15,8,7,15,0,67,2,0,1,3.20833,0.244792,31.6979,79.1109,192,4
England,221,237.176,7.17647,0.289593,230.633,7.45701,0.384615,819,AN Cook,0,0,0,0,0,0,0,0,8,12,20,8,12,20,68,73,2,1,1,4.17045,0.272727,35.75,75.5524,88,4
England,221,237.176,7.17647,0.289593,230.633,7.45701,0.384615,819,IR Bell,0,0,0,0,0,0,0,0,8,12,20,8,12,20,68,73,2,1,1,3.63433,0.246269,35.3806,75.6623,134,4
England,221,237.176,7.17647,0.289593,230.633,7.45701,0.384615,820,AN Cook,0,0,0,0,0,0,0,0,4,17,21,4,17,21,0,219,1,1,1,4.17045,0.272727,35.75,75.5524,88,4
England,221,237.176,7.17647,0.289593,230.633,7.45701,0.384615,820,IR Bell,0,0,0,0,0,0,0,0,4,17,21,4,17,21,0,219,1,1,1,3.63433,0.246269,35.3806,75.6623,134,4
Sri Lanka,244,223.373,7.09016,0.344262,227.578,7.47541,0.385246,820,TM Dilshan,0,0,0,0,0,0,0,0,16,10,26,16,10,26,220,222,9,0,1,4.60199,0.273632,38.3632,86.0219,201,4
Sri Lanka,244,223.373,7.09016,0.344262,227.578,7.47541,0.385246,820,MDKJ Perera,0,0,0,0,0,0,0,0,16,10,26,16,10,26,220,222,9,0,1,3.30435,0.195652,25.7391,90.5199,46,0
Bangladesh,160,218.438,7.70625,0.4,211.106,7.05,0.325,821,Tamim Iqbal,0,0,0,0,0,0,0,0,12,7,19,12,7,19,0,265,3,1,1,4.05344,0.274809,31.8015,76.8068,131,4
Bangladesh,160,218.438,7.70625,0.4,211.106,7.05,0.325,821,Anamul Haque,0,0,0,0,0,0,0,0,12,7,19,12,7,19,0,265,3,1,1,4.12,0.24,36.8,69.6442,25,4
Bangladesh,160,218.438,7.70625,0.4,211.106,7.05,0.325,821,Mushfiqur Rahim,0,0,0,0,0,0,0,0,12,7,19,12,7,19,0,265,3,1,1,2.61111,0.18254,27.7778,75.2526,126,4
New Zealand,184,233.745,7.39674,0.36413,227.951,7.30435,0.353261,821,HD Rutherford,0,0,0,0,0,0,0,0,12,4,16,12,4,16,266,162,0,0,1,0.5,0,3.5,25,4,3
New Zealand,184,233.745,7.39674,0.36413,227.951,7.30435,0.353261,821,AP Devcich,0,0,0,0,0,0,0,0,12,4,16,12,4,16,266,162,0,0,1,3.125,0.125,22.125,73.444,8,1
New Zealand,184,233.745,7.39674,0.36413,227.951,7.30435,0.353261,821,GD Elliott,0,0,0,0,0,0,0,0,12,4,16,12,4,16,266,162,0,0,1,2.67188,0.203125,29.4375,79.7629,64,4
Bangladesh,160,218.438,7.70625,0.4,211.106,7.05,0.325,822,Tamim Iqbal,0,0,0,0,0,0,0,0,12,2,14,12,2,14,0,247,1,1,1,4.05344,0.274809,31.8015,76.8068,131,4
Bangladesh,160,218.438,7.70625,0.4,211.106,7.05,0.325,822,Shamsur Rahman,0,0,0,0,0,0,0,0,12,2,14,12,2,14,0,247,1,1,1,3.55556,0.222222,29.5556,74.5098,9,4
New Zealand,184,233.745,7.39674,0.36413,227.951,7.30435,0.353261,822,AP Devcich,0,0,0,0,0,0,0,0,4,8,12,4,8,12,248,207,3,0,1,3.125,0.125,22.125,73.444,8,1
New Zealand,184,233.745,7.39674,0.36413,227.951,7.30435,0.353261,822,HD Rutherford,0,0,0,0,0,0,0,0,4,8,12,4,8,12,248,207,3,0,1,0.5,0,3.5,25,4,3
New Zealand,184,233.745,7.39674,0.36413,227.951,7.30435,0.353261,822,GD Elliott,0,0,0,0,0,0,0,0,4,8,12,4,8,12,248,207,3,0,1,2.67188,0.203125,29.4375,79.7629,64,4
New Zealand,184,233.745,7.39674,0.36413,227.951,7.30435,0.353261,823,AP Devcich,0,0,0,0,0,0,0,0,24,10,34,24,10,34,0,307,1,0,1,3.125,0.125,22.125,73.444,8,1
New Zealand,184,233.745,7.39674,0.36413,227.951,7.30435,0.353261,823,TWM Latham,0,0,0,0,0,0,0,0,24,10,34,24,10,34,0,307,1,0,1,2.76471,0.147059,25.3529,75.2182,34,4
Bangladesh,160,218.438,7.70625,0.4,211.106,7.05,0.325,823,Shamsur Rahman,0,0,0,0,0,0,0,0,32,9,41,32,9,41,308,309,2,1,1,3.55556,0.222222,29.5556,74.5098,9,4
Bangladesh,160,218.438,7.70625,0.4,211.106,7.05,0.325,823,Ziaur Rahman,0,0,0,0,0,0,0,0,32,9,41,32,9,41,308,309,2,1,1,1.2,0,8.3,91.2088,10,0
Sri Lanka,244,223.373,7.09016,0.344262,227.578,7.47541,0.385246,824,FDM Karunaratne,0,0,0,0,0,0,0,0,16,8,24,16,8,24,0,138,0,1,1,0.8,0,10.7,64.8485,10,1
Sri Lanka,244,223.373,7.09016,0.344262,227.578,7.47541,0.385246,824,TM Dilshan,0,0,0,0,0,0,0,0,16,8,24,16,8,24,0,138,0,1,1,4.60199,0.273632,38.3632,86.0219,201,4
Sri Lanka,244,223.373,7.09016,0.344262,227.578,7.47541,0.385246,824,KC Sangakkara,0,0,0,0,0,0,0,0,16,8,24,16,8,24,0,138,0,1,1,4.33659,0.360976,41.9854,80.6276,205,4
New Zealand,184,233.745,7.39674,0.36413,227.951,7.30435,0.353261,824,TWM Latham,0,0,0,0,0,0,0,0,12,11,23,12,11,23,139,203,4,0,1,2.76471,0.147059,25.3529,75.2182,34,4
New Zealand,184,233.745,7.39674,0.36413,227.951,7.30435,0.353261,824,AP Devcich,0,0,0,0,0,0,0,0,12,11,23,12,11,23,139,203,4,0,1,3.125,0.125,22.125,73.444,8,1
New Zealand,184,233.745,7.39674,0.36413,227.951,7.30435,0.353261,824,RJ Nicol,0,0,0,0,0,0,0,0,12,11,23,12,11,23,139,203,4,0,1,3.3,0.2,29.25,73.4003,20,4
New Zealand,184,233.745,7.39674,0.36413,227.951,7.30435,0.353261,824,GD Elliott,0,0,0,0,0,0,0,0,12,11,23,12,11,23,139,203,4,0,1,2.67188,0.203125,29.4375,79.7629,64,4
Sri Lanka,244,223.373,7.09016,0.344262,227.578,7.47541,0.385246,825,DPMD Jayawardene,0,0,0,0,0,0,0,0,24,4,28,24,4,28,0,211,2,1,1,3.20833,0.244792,31.6979,79.1109,192,4
Sri Lanka,244,223.373,7.09016,0.344262,227.578,7.47541,0.385246,825,TM Dilshan,0,0,0,0,0,0,0,0,24,4,28,24,4,28,0,211,2,1,1,4.60199,0.273632,38.3632,86.0219,201,4
New Zealand,184,233.745,7.39674,0.36413,227.951,7.30435,0.353261,825,TWM Latham,0,0,0,0,0,0,0,0,12,2,14,12,2,14,212,126,2,0,1,2.76471,0.147059,25.3529,75.2182,34,4
New Zealand,184,233.745,7.39674,0.36413,227.951,7.30435,0.353261,825,AP Devcich,0,0,0,0,0,0,0,0,12,2,14,12,2,14,212,126,2,0,1,3.125,0.125,22.125,73.444,8,1
New Zealand,184,233.745,7.39674,0.36413,227.951,7.30435,0.353261,825,RJ Nicol,0,0,0,0,0,0,0,0,12,2,14,12,2,14,212,126,2,0,1,3.3,0.2,29.25,73.4003,20,4
West Indies,176,217.33,7.15909,0.3125,225.278,7.57386,0.380682,826,CH Gayle,0,0,0,0,0,0,0,0,16,5,21,16,5,21,0,211,1,0,1,4.58621,0.206897,31.1293,89.4255,116,4
West Indies,176,217.33,7.15909,0.3125,225.278,7.57386,0.380682,826,J Charles,0,0,0,0,0,0,0,0,16,5,21,16,5,21,0,211,1,0,1,3.82353,0.147059,28.2353,81.2183,34,4
West Indies,176,217.33,7.15909,0.3125,225.278,7.57386,0.380682,826,MN Samuels,0,0,0,0,0,0,0,0,16,5,21,16,5,21,0,211,1,0,1,3.74757,0.23301,31.6214,74.5821,103,4
India,259,242.378,7.15058,0.339768,244.568,7.12741,0.30888,826,RG Sharma,0,0,0,0,0,0,0,0,12,10,22,12,10,22,212,212,5,1,1,3.82836,0.268657,35.9179,83.083,134,4
India,259,242.378,7.15058,0.339768,244.568,7.12741,0.30888,826,S Dhawan,0,0,0,0,0,0,0,0,12,10,22,12,10,22,212,212,5,1,1,5.65217,0.362319,43.2174,88.9088,69,4
India,259,242.378,7.15058,0.339768,244.568,7.12741,0.30888,826,V Kohli,0,0,0,0,0,0,0,0,12,10,22,12,10,22,212,212,5,1,1,4.66456,0.379747,44.9937,88.3325,158,4
India,259,242.378,7.15058,0.339768,244.568,7.12741,0.30888,827,RG Sharma,0,0,0,0,0,0,0,0,16,2,18,16,2,18,0,288,4,1,1,3.82836,0.268657,35.9179,83.083,134,4
India,259,242.378,7.15058,0.339768,244.568,7.12741,0.30888,827,S Dhawan,0,0,0,0,0,0,0,0,16,2,18,16,2,18,0,288,4,1,1,5.65217,0.362319,43.2174,88.9088,69,4
India,259,242.378,7.15058,0.339768,244.568,7.12741,0.30888,827,V Kohli,0,0,0,0,0,0,0,0,16,2,18,16,2,18,0,288,4,1,1,4.66456,0.379747,44.9937,88.3325,158,4
West Indies,176,217.33,7.15909,0.3125,225.278,7.57386,0.380682,827,J Charles,0,0,0,0,0,0,0,0,8,7,15,8,7,15,289,289,0,0,1,3.82353,0.147059,28.2353,81.2183,34,4
West Indies,176,217.33,7.15909,0.3125,225.278,7.57386,0.380682,827,KOA Powell,0,0,0,0,0,0,0,0,8,7,15,8,7,15,289,289,0,0,1,3.59259,0.222222,26.4815,80.6088,27,4
West Indies,176,217.33,7.15909,0.3125,225.278,7.57386,0.380682,827,MN Samuels,0,0,0,0,0,0,0,0,8,7,15,8,7,15,289,289,0,0,1,3.74757,0.23301,31.6214,74.5821,103,4
West Indies,176,217.33,7.15909,0.3125,225.278,7.57386,0.380682,828,J Charles,0,0,0,0,0,0,0,0,8,12,20,8,12,20,0,263,0,0,1,3.82353,0.147059,28.2353,81.2183,34,4
West Indies,176,217.33,7.15909,0.3125,225.278,7.57386,0.380682,828,KOA Powell,0,0,0,0,0,0,0,0,8,12,20,8,12,20,0,263,0,0,1,3.59259,0.222222,26.4815,80.6088,27,4
West Indies,176,217.33,7.15909,0.3125,225.278,7.57386,0.380682,828,MN Samuels,0,0,0,0,0,0,0,0,8,12,20,8,12,20,0,263,0,0,1,3.74757,0.23301,31.6214,74.5821,103,4
India,259,242.378,7.15058,0.339768,244.568,7.12741,0.30888,828,RG Sharma,0,0,0,0,0,0,0,0,24,4,28,24,4,28,264,266,1,1,1,3.82836,0.268657,35.9179,83.083,134,4
India,259,242.378,7.15058,0.339768,244.568,7.12741,0.30888,828,S Dhawan,0,0,0,0,0,0,0,0,24,4,28,24,4,28,264,266,1,1,1,5.65217,0.362319,43.2174,88.9088,69,4
India,259,242.378,7.15058,0.339768,244.568,7.12741,0.30888,828,V Kohli,0,0,0,0,0,0,0,0,24,4,28,24,4,28,264,266,1,1,1,4.66456,0.379747,44.9937,88.3325,158,4
Pakistan,211,222.621,7.38389,0.393365,235.517,7.54976,0.336493,829,Nasir Jamshed,0,0,0,0,0,0,0,0,8,7,15,8,7,15,0,218,1,0,1,3.63043,0.23913,30.2174,73.8184,46,4
Pakistan,211,222.621,7.38389,0.393365,235.517,7.54976,0.336493,829,Ahmed Shehzad,0,0,0,0,0,0,0,0,8,7,15,8,7,15,0,218,1,0,1,3.67143,0.242857,33.2714,70.8118,70,4
South Africa,190,234.274,7.4,0.373684,232.363,7.33158,0.342105,829,GC Smith,0,0,0,0,0,0,0,0,12,8,20,12,8,20,219,195,1,1,1,3.97,0.29,33.57,79.6819,100,4
South Africa,190,234.274,7.4,0.373684,232.363,7.33158,0.342105,829,HM Amla,0,0,0,0,0,0,0,0,12,8,20,12,8,20,219,195,1,1,1,5.20168,0.403361,48.7899,86.9292,119,4
South Africa,190,234.274,7.4,0.373684,232.363,7.33158,0.342105,829,Q de Kock,0,0,0,0,0,0,0,0,12,8,20,12,8,20,219,195,1,1,1,5.12963,0.240741,39.1111,91.2311,54,4
South Africa,190,234.274,7.4,0.373684,232.363,7.33158,0.342105,829,JH Kallis,0,0,0,0,0,0,0,0,12,8,20,12,8,20,219,195,1,1,1,3.58621,0.356322,37.2644,76.4442,87,4
Pakistan,211,222.621,7.38389,0.393365,235.517,7.54976,0.336493,830,Nasir Jamshed,0,0,0,0,0,0,0,0,4,12,16,4,12,16,0,262,2,0,1,3.63043,0.23913,30.2174,73.8184,46,4
Pakistan,211,222.621,7.38389,0.393365,235.517,7.54976,0.336493,830,Mohammad Hafeez,0,0,0,0,0,0,0,0,4,12,16,4,12,16,0,262,2,0,1,4.04511,0.255639,34.3534,78.0625,133,4
Pakistan,211,222.621,7.38389,0.393365,235.517,7.54976,0.336493,830,Ahmed Shehzad,0,0,0,0,0,0,0,0,4,12,16,4,12,16,0,262,2,0,1,3.67143,0.242857,33.2714,70.8118,70,4
South Africa,190,234.274,7.4,0.373684,232.363,7.33158,0.342105,830,HM Amla,0,0,0,0,0,0,0,0,4,5,9,4,5,9,263,261,0,1,1,5.20168,0.403361,48.7899,86.9292,119,4
South Africa,190,234.274,7.4,0.373684,232.363,7.33158,0.342105,830,GC Smith,0,0,0,0,0,0,0,0,4,5,9,4,5,9,263,261,0,1,1,3.97,0.29,33.57,79.6819,100,4
South Africa,190,234.274,7.4,0.373684,232.363,7.33158,0.342105,830,Q de Kock,0,0,0,0,0,0,0,0,4,5,9,4,5,9,263,261,0,1,1,5.12963,0.240741,39.1111,91.2311,54,4
Pakistan,211,222.621,7.38389,0.393365,235.517,7.54976,0.336493,831,Umar Amin,0,0,0,0,0,0,0,0,14,4,18,14,4,18,0,179,3,0,1,2.14286,0.0714286,18.8571,67.3469,14,1
Pakistan,211,222.621,7.38389,0.393365,235.517,7.54976,0.336493,831,Ahmed Shehzad,0,0,0,0,0,0,0,0,14,4,18,14,4,18,0,179,3,0,1,3.67143,0.242857,33.2714,70.8118,70,4
Pakistan,211,222.621,7.38389,0.393365,235.517,7.54976,0.336493,831,Asad Shafiq,0,0,0,0,0,0,0,0,14,4,18,14,4,18,0,179,3,0,1,2.07843,0.176471,24.7843,67.1269,51,4
Pakistan,211,222.621,7.38389,0.393365,235.517,7.54976,0.336493,831,Sohaib Maqsood,0,0,0,0,0,0,0,0,14,4,18,14,4,18,0,179,3,0,1,2.86957,0.217391,29.4348,79.7409,23,4
South Africa,190,234.274,7.4,0.373684,232.363,7.33158,0.342105,831,Q de Kock,0,0,0,0,0,0,0,0,24,10,34,24,10,34,180,181,0,1,1,5.12963,0.240741,39.1111,91.2311,54,4
South Africa,190,234.274,7.4,0.373684,232.363,7.33158,0.342105,831,HM Amla,0,0,0,0,0,0,0,0,24,10,34,24,10,34,180,181,0,1,1,5.20168,0.403361,48.7899,86.9292,119,4
Sri Lanka,244,223.373,7.09016,0.344262,227.578,7.47541,0.385246,832,MDKJ Perera,0,0,0,0,0,0,0,0,14,11,25,14,11,25,0,180,2,0,1,3.30435,0.195652,25.7391,90.5199,46,0
Sri Lanka,244,223.373,7.09016,0.344262,227.578,7.47541,0.385246,832,TM Dilshan,0,0,0,0,0,0,0,0,14,11,25,14,11,25,0,180,2,0,1,4.60199,0.273632,38.3632,86.0219,201,4
Sri Lanka,244,223.373,7.09016,0.344262,227.578,7.47541,0.385246,832,KC Sangakkara,0,0,0,0,0,0,0,0,14,11,25,14,11,25,0,180,2,0,1,4.33659,0.360976,41.9854,80.6276,205,4
Bangladesh,160,218.438,7.70625,0.4,211.106,7.05,0.325,832,Anamul Haque,0,0,0,0,0,0,0,0,4,12,16,4,12,16,181,167,2,1,1,4.12,0.24,36.8,69.6442,25,4
Bangladesh,160,218.438,7.70625,0.4,211.106,7.05,0.325,832,Mominul Haque,0,0,0,0,0,0,0,0,4,12,16,4,12,16,181,167,2,1,1,2.57143,0.0952381,23.3333,73.4633,21,4
Bangladesh,160,218.438,7.70625,0.4,211.106,7.05,0.325,832,Shamsur Rahman,0,0,0,0,0,0,0,0,4,12,16,4,12,16,181,167,2,1,1,3.55556,0.222222,29.5556,74.5098,9,4
Sri Lanka,244,223.373,7.09016,0.344262,227.578,7.47541,0.385246,833,MDKJ Perera,0,0,0,0,0,0,0,0,16,9,25,16,9,25,0,289,0,0,1,3.30435,0.195652,25.7391,90.5199,46,0
Sri Lanka,244,223.373,7.09016,0.344262,227.578,7.47541,0.385246,833,TM Dilshan,0,0,0,0,0,0,0,0,16,9,25,16,9,25,0,289,0,0,1,4.60199,0.273632,38.3632,86.0219,201,4
Sri Lanka,244,223.373,7.09016,0.344262,227.578,7.47541,0.385246,833,KC Sangakkara,0,0,0,0,0,0,0,0,16,9,25,16,9,25,0,289,0,0,1,4.33659,0.360976,41.9854,80.6276,205,4
Bangladesh,160,218.438,7.70625,0.4,211.106,7.05,0.325,833,Anamul Haque,0,0,0,0,0,0,0,0,0,6,6,0,6,6,290,228,1,1,1,4.12,0.24,36.8,69.6442,25,4
Bangladesh,160,218.438,7.70625,0.4,211.106,7.05,0.325,833,Shamsur Rahman,0,0,0,0,0,0,0,0,0,6,6,0,6,6,290,228,1,1,1,3.55556,0.222222,29.5556,74.5098,9,4
Bangladesh,160,218.438,7.70625,0.4,211.106,7.05,0.325,833,Mominul Haque,0,0,0,0,0,0,0,0,0,6,6,0,6,6,290,228,1,1,1,2.57143,0.0952381,23.3333,73.4633,21,4
Bangladesh,160,218.438,7.70625,0.4,211.106,7.05,0.325,834,Anamul Haque,0,0,0,0,0,0,0,0,8,5,13,8,5,13,0,240,2,1,1,4.12,0.24,36.8,69.6442,25,4
Bangladesh,160,218.438,7.70625,0.4,211.106,7.05,0.325,834,Shamsur Rahman,0,0,0,0,0,0,0,0,8,5,13,8,5,13,0,240,2,1,1,3.55556,0.222222,29.5556,74.5098,9,4
Sri Lanka,244,223.373,7.09016,0.344262,227.578,7.47541,0.385246,834,MDKJ Perera,0,0,0,0,0,0,0,0,12,9,21,12,9,21,241,246,2,0,1,3.30435,0.195652,25.7391,90.5199,46,0
Sri Lanka,244,223.373,7.09016,0.344262,227.578,7.47541,0.385246,834,HDRL Thirimanne,0,0,0,0,0,0,0,0,12,9,21,12,9,21,241,246,2,0,1,2.77778,0.246914,31.5802,71.4725,81,4
Ireland,55,219.527,7.65455,0.290909,202.727,7.56364,0.4,838,WTS Porterfield,0,0,0,0,0,0,0,0,4,3,7,4,3,7,0,202,1,0,1,2.6,0.142857,24.6857,56.2866,35,3
Ireland,55,219.527,7.65455,0.290909,202.727,7.56364,0.4,838,PR Stirling,0,0,0,0,0,0,0,0,4,3,7,4,3,7,0,202,1,0,1,3.47826,0.173913,24.2174,88.1329,23,0
Ireland,55,219.527,7.65455,0.290909,202.727,7.56364,0.4,838,EC Joyce,0,0,0,0,0,0,0,0,4,3,7,4,3,7,0,202,1,0,1,3.08571,0.2,28.3429,68.6505,35,4
West Indies,176,217.33,7.15909,0.3125,225.278,7.57386,0.380682,838,DR Smith,0,0,0,0,0,0,0,0,16,4,20,16,4,20,203,205,1,1,1,2.5,0.12,17.96,84.5574,50,1
West Indies,176,217.33,7.15909,0.3125,225.278,7.57386,0.380682,838,KOA Powell,0,0,0,0,0,0,0,0,16,4,20,16,4,20,203,205,1,1,1,3.59259,0.222222,26.4815,80.6088,27,4
Sri Lanka,244,223.373,7.09016,0.344262,227.578,7.47541,0.385246,839,MDKJ Perera,0,0,0,0,0,0,0,0,0,9,9,0,9,9,0,219,1,0,1,3.30435,0.195652,25.7391,90.5199,46,0
Sri Lanka,244,223.373,7.09016,0.344262,227.578,7.47541,0.385246,839,HDRL Thirimanne,0,0,0,0,0,0,0,0,0,9,9,0,9,9,0,219,1,0,1,2.77778,0.246914,31.5802,71.4725,81,4
Sri Lanka,244,223.373,7.09016,0.344262,227.578,7.47541,0.385246,839,WU Tharanga,0,0,0,0,0,0,0,0,0,9,9,0,9,9,0,219,1,0,1,3.93985,0.263158,32.9699,71.6035,133,4
Ireland,55,219.527,7.65455,0.290909,202.727,7.56364,0.4,839,WTS Porterfield,0,0,0,0,0,0,0,0,8,3,11,8,3,11,220,140,0,1,1,2.6,0.142857,24.6857,56.2866,35,3
Ireland,55,219.527,7.65455,0.290909,202.727,7.56364,0.4,839,PR Stirling,0,0,0,0,0,0,0,0,8,3,11,8,3,11,220,140,0,1,1,3.47826,0.173913,24.2174,88.1329,23,0
Ireland,55,219.527,7.65455,0.290909,202.727,7.56364,0.4,839,EC Joyce,0,0,0,0,0,0,0,0,8,3,11,8,3,11,220,140,0,1,1,3.08571,0.2,28.3429,68.6505,35,4
Ireland,55,219.527,7.65455,0.290909,202.727,7.56364,0.4,839,NJ O'Brien,0,0,0,0,0,0,0,0,8,3,11,8,3,11,220,140,0,1,1,2.55882,0.176471,25.5882,69.378,34,4
Sri Lanka,244,223.373,7.09016,0.344262,227.578,7.47541,0.385246,840,MDKJ Perera,0,0,0,0,0,0,0,0,12,4,16,12,4,16,0,296,1,0,1,3.30435,0.195652,25.7391,90.5199,46,0
Sri Lanka,244,223.373,7.09016,0.344262,227.578,7.47541,0.385246,840,HDRL Thirimanne,0,0,0,0,0,0,0,0,12,4,16,12,4,16,0,296,1,0,1,2.77778,0.246914,31.5802,71.4725,81,4
Pakistan,211,222.621,7.38389,0.393365,235.517,7.54976,0.336493,840,Sharjeel Khan,0,0,0,0,0,0,0,0,16,4,20,16,4,20,297,284,1,0,1,2.6,0.1,16.9,81.25,10,1
Pakistan,211,222.621,7.38389,0.393365,235.517,7.54976,0.336493,840,Ahmed Shehzad,0,0,0,0,0,0,0,0,16,4,20,16,4,20,297,284,1,0,1,3.67143,0.242857,33.2714,70.8118,70,4
Bangladesh,160,218.438,7.70625,0.4,211.106,7.05,0.325,841,Anamul Haque,0,0,0,0,0,0,0,0,8,7,15,8,7,15,0,279,1,1,1,4.12,0.24,36.8,69.6442,25,4
Bangladesh,160,218.438,7.70625,0.4,211.106,7.05,0.325,841,Shamsur Rahman,0,0,0,0,0,0,0,0,8,7,15,8,7,15,0,279,1,1,1,3.55556,0.222222,29.5556,74.5098,9,4
India,259,242.378,7.15058,0.339768,244.568,7.12741,0.30888,841,RG Sharma,0,0,0,0,0,0,0,0,8,3,11,8,3,11,280,280,0,0,1,3.82836,0.268657,35.9179,83.083,134,4
India,259,242.378,7.15058,0.339768,244.568,7.12741,0.30888,841,S Dhawan,0,0,0,0,0,0,0,0,8,3,11,8,3,11,280,280,0,0,1,5.65217,0.362319,43.2174,88.9088,69,4
India,259,242.378,7.15058,0.339768,244.568,7.12741,0.30888,843,RG Sharma,0,0,0,0,0,0,0,0,12,7,19,12,7,19,0,264,0,0,1,3.82836,0.268657,35.9179,83.083,134,4
India,259,242.378,7.15058,0.339768,244.568,7.12741,0.30888,843,S Dhawan,0,0,0,0,0,0,0,0,12,7,19,12,7,19,0,264,0,0,1,5.65217,0.362319,43.2174,88.9088,69,4
Sri Lanka,244,223.373,7.09016,0.344262,227.578,7.47541,0.385246,843,MDKJ Perera,0,0,0,0,0,0,0,0,12,4,16,12,4,16,265,265,1,0,1,3.30435,0.195652,25.7391,90.5199,46,0
Sri Lanka,244,223.373,7.09016,0.344262,227.578,7.47541,0.385246,843,HDRL Thirimanne,0,0,0,0,0,0,0,0,12,4,16,12,4,16,265,265,1,0,1,2.77778,0.246914,31.5802,71.4725,81,4
India,259,242.378,7.15058,0.339768,244.568,7.12741,0.30888,845,RG Sharma,0,0,0,0,0,0,0,0,22,6,28,22,6,28,0,245,2,0,1,3.82836,0.268657,35.9179,83.083,134,4
India,259,242.378,7.15058,0.339768,244.568,7.12741,0.30888,845,S Dhawan,0,0,0,0,0,0,0,0,22,6,28,22,6,28,0,245,2,0,1,5.65217,0.362319,43.2174,88.9088,69,4
India,259,242.378,7.15058,0.339768,244.568,7.12741,0.30888,845,V Kohli,0,0,0,0,0,0,0,0,22,6,28,22,6,28,0,245,2,0,1,4.66456,0.379747,44.9937,88.3325,158,4
Pakistan,211,222.621,7.38389,0.393365,235.517,7.54976,0.336493,845,Sharjeel Khan,0,0,0,0,0,0,0,0,16,6,22,16,6,22,246,249,2,0,1,2.6,0.1,16.9,81.25,10,1
Pakistan,211,222.621,7.38389,0.393365,235.517,7.54976,0.336493,845,Ahmed Shehzad,0,0,0,0,0,0,0,0,16,6,22,16,6,22,246,249,2,0,1,3.67143,0.242857,33.2714,70.8118,70,4
Bangladesh,160,218.438,7.70625,0.4,211.106,7.05,0.325,848,Anamul Haque,0,0,0,0,0,0,0,0,8,8,16,8,8,16,0,204,0,1,1,4.12,0.24,36.8,69.6442,25,4
Bangladesh,160,218.438,7.70625,0.4,211.106,7.05,0.325,848,Shamsur Rahman,0,0,0,0,0,0,0,0,8,8,16,8,8,16,0,204,0,1,1,3.55556,0.222222,29.5556,74.5098,9,4
Sri Lanka,244,223.373,7.09016,0.344262,227.578,7.47541,0.385246,848,MDKJ Perera,0,0,0,0,0,0,0,0,8,7,15,8,7,15,205,208,1,0,1,3.30435,0.195652,25.7391,90.5199,46,0
Sri Lanka,244,223.373,7.09016,0.344262,227.578,7.47541,0.385246,848,KC Sangakkara,0,0,0,0,0,0,0,0,8,7,15,8,7,15,205,208,1,0,1,4.33659,0.360976,41.9854,80.6276,205,4
Sri Lanka,244,223.373,7.09016,0.344262,227.578,7.47541,0.385246,848,HDRL Thirimanne,0,0,0,0,0,0,0,0,8,7,15,8,7,15,205,208,1,0,1,2.77778,0.246914,31.5802,71.4725,81,4
Sri Lanka,244,223.373,7.09016,0.344262,227.578,7.47541,0.385246,848,DPMD Jayawardene,0,0,0,0,0,0,0,0,8,7,15,8,7,15,205,208,1,0,1,3.20833,0.244792,31.6979,79.1109,192,4
Sri Lanka,244,223.373,7.09016,0.344262,227.578,7.47541,0.385246,848,SMA Priyanjan,0,0,0,0,0,0,0,0,8,7,15,8,7,15,205,208,1,0,1,2.5,0.1,20.95,78.6116,20,4
Pakistan,211,222.621,7.38389,0.393365,235.517,7.54976,0.336493,849,Sharjeel Khan,0,0,0,0,0,0,0,0,12,5,17,12,5,17,0,260,1,0,1,2.6,0.1,16.9,81.25,10,1
Pakistan,211,222.621,7.38389,0.393365,235.517,7.54976,0.336493,849,Ahmed Shehzad,0,0,0,0,0,0,0,0,12,5,17,12,5,17,0,260,1,0,1,3.67143,0.242857,33.2714,70.8118,70,4
Pakistan,211,222.621,7.38389,0.393365,235.517,7.54976,0.336493,849,Mohammad Hafeez,0,0,0,0,0,0,0,0,12,5,17,12,5,17,0,260,1,0,1,4.04511,0.255639,34.3534,78.0625,133,4
Pakistan,211,222.621,7.38389,0.393365,235.517,7.54976,0.336493,849,Misbah-ul-Haq,0,0,0,0,0,0,0,0,12,5,17,12,5,17,0,260,1,0,1,2.95238,0.285714,34.9921,71.8195,126,4
Pakistan,211,222.621,7.38389,0.393365,235.517,7.54976,0.336493,849,Fawad Alam,0,0,0,0,0,0,0,0,12,5,17,12,5,17,0,260,1,0,1,1.85294,0.176471,26.5588,72.6468,34,4
Sri Lanka,244,223.373,7.09016,0.344262,227.578,7.47541,0.385246,849,MDKJ Perera,0,0,0,0,0,0,0,0,16,9,25,16,9,25,261,261,0,0,1,3.30435,0.195652,25.7391,90.5199,46,0
Sri Lanka,244,223.373,7.09016,0.344262,227.578,7.47541,0.385246,849,HDRL Thirimanne,0,0,0,0,0,0,0,0,16,9,25,16,9,25,261,261,0,0,1,2.77778,0.246914,31.5802,71.4725,81,4
South Africa,190,234.274,7.4,0.373684,232.363,7.33158,0.342105,850,HM Amla,0,0,0,0,0,0,0,0,12,5,17,12,5,17,0,279,3,1,1,5.20168,0.403361,48.7899,86.9292,119,4
South Africa,190,234.274,7.4,0.373684,232.363,7.33158,0.342105,850,RR Rossouw,0,0,0,0,0,0,0,0,12,5,17,12,5,17,0,279,3,1,1,3.80769,0.230769,31.3846,93.1507,26,0
South Africa,190,234.274,7.4,0.373684,232.363,7.33158,0.342105,850,F du Plessis,0,0,0,0,0,0,0,0,12,5,17,12,5,17,0,279,3,1,1,3.45122,0.292683,34.9268,83.135,82,4
South Africa,190,234.274,7.4,0.373684,232.363,7.33158,0.342105,850,AB de Villiers,0,0,0,0,0,0,0,0,12,5,17,12,5,17,0,279,3,1,1,5.04969,0.403727,47.2174,98.8428,161,4
West Indies,176,217.33,7.15909,0.3125,225.278,7.57386,0.380682,850,DR Smith,0,0,0,0,0,0,0,0,28,14,42,28,14,42,280,164,1,0,1,2.5,0.12,17.96,84.5574,50,1
West Indies,176,217.33,7.15909,0.3125,225.278,7.57386,0.380682,850,CH Gayle,0,0,0,0,0,0,0,0,28,14,42,28,14,42,280,164,1,0,1,4.58621,0.206897,31.1293,89.4255,116,4
South Africa,190,234.274,7.4,0.373684,232.363,7.33158,0.342105,851,HM Amla,0,0,0,0,0,0,0,0,12,12,24,12,12,24,0,439,1,1,1,5.20168,0.403361,48.7899,86.9292,119,4
South Africa,190,234.274,7.4,0.373684,232.363,7.33158,0.342105,851,RR Rossouw,0,0,0,0,0,0,0,0,12,12,24,12,12,24,0,439,1,1,1,3.80769,0.230769,31.3846,93.1507,26,0
West Indies,176,217.33,7.15909,0.3125,225.278,7.57386,0.380682,851,DR Smith,0,0,0,0,0,0,0,0,22,10,32,22,10,32,440,291,4,0,1,2.5,0.12,17.96,84.5574,50,1
West Indies,176,217.33,7.15909,0.3125,225.278,7.57386,0.380682,851,CH Gayle,0,0,0,0,0,0,0,0,22,10,32,22,10,32,440,291,4,0,1,4.58621,0.206897,31.1293,89.4255,116,4
West Indies,176,217.33,7.15909,0.3125,225.278,7.57386,0.380682,852,DR Smith,0,0,0,0,0,0,0,0,12,2,14,12,2,14,0,122,4,0,1,2.5,0.12,17.96,84.5574,50,1
West Indies,176,217.33,7.15909,0.3125,225.278,7.57386,0.380682,852,N Deonarine,0,0,0,0,0,0,0,0,12,2,14,12,2,14,0,122,4,0,1,2.09091,0.136364,20.9545,65.7632,22,1
West Indies,176,217.33,7.15909,0.3125,225.278,7.57386,0.380682,852,CH Gayle,0,0,0,0,0,0,0,0,12,2,14,12,2,14,0,122,4,0,1,4.58621,0.206897,31.1293,89.4255,116,4
West Indies,176,217.33,7.15909,0.3125,225.278,7.57386,0.380682,852,MN Samuels,0,0,0,0,0,0,0,0,12,2,14,12,2,14,0,122,4,0,1,3.74757,0.23301,31.6214,74.5821,103,4
South Africa,190,234.274,7.4,0.373684,232.363,7.33158,0.342105,852,RR Rossouw,0,0,0,0,0,0,0,0,12,11,23,12,11,23,123,124,0,1,1,3.80769,0.230769,31.3846,93.1507,26,0
South Africa,190,234.274,7.4,0.373684,232.363,7.33158,0.342105,852,HM Amla,0,0,0,0,0,0,0,0,12,11,23,12,11,23,123,124,0,1,1,5.20168,0.403361,48.7899,86.9292,119,4
South Africa,190,234.274,7.4,0.373684,232.363,7.33158,0.342105,853,MN van Wyk,0,0,0,0,0,0,0,0,20,1,21,20,1,21,0,262,6,1,1,3.33333,0.266667,27.2,66.9951,15,4
South Africa,190,234.274,7.4,0.373684,232.363,7.33158,0.342105,853,RR Rossouw,0,0,0,0,0,0,0,0,20,1,21,20,1,21,0,262,6,1,1,3.80769,0.230769,31.3846,93.1507,26,0
South Africa,190,234.274,7.4,0.373684,232.363,7.33158,0.342105,853,F du Plessis,0,0,0,0,0,0,0,0,20,1,21,20,1,21,0,262,6,1,1,3.45122,0.292683,34.9268,83.135,82,4
West Indies,176,217.33,7.15909,0.3125,225.278,7.57386,0.380682,853,DR Smith,0,0,0,0,0,0,0,0,0,6,6,0,6,6,263,266,1,0,1,2.5,0.12,17.96,84.5574,50,1
West Indies,176,217.33,7.15909,0.3125,225.278,7.57386,0.380682,853,LR Johnson,0,0,0,0,0,0,0,0,0,6,6,0,6,6,263,266,1,0,1,1,0,6.33333,29.2308,3,3
West Indies,176,217.33,7.15909,0.3125,225.278,7.57386,0.380682,853,CH Gayle,0,0,0,0,0,0,0,0,0,6,6,0,6,6,263,266,1,0,1,4.58621,0.206897,31.1293,89.4255,116,4
South Africa,190,234.274,7.4,0.373684,232.363,7.33158,0.342105,854,Q de Kock,0,0,0,0,0,0,0,0,16,4,20,16,4,20,0,361,3,1,1,5.12963,0.240741,39.1111,91.2311,54,4
South Africa,190,234.274,7.4,0.373684,232.363,7.33158,0.342105,854,HM Amla,0,0,0,0,0,0,0,0,16,4,20,16,4,20,0,361,3,1,1,5.20168,0.403361,48.7899,86.9292,119,4
South Africa,190,234.274,7.4,0.373684,232.363,7.33158,0.342105,854,F du Plessis,0,0,0,0,0,0,0,0,16,4,20,16,4,20,0,361,3,1,1,3.45122,0.292683,34.9268,83.135,82,4
West Indies,176,217.33,7.15909,0.3125,225.278,7.57386,0.380682,854,CH Gayle,0,0,0,0,0,0,0,0,22,7,29,22,7,29,362,230,3,0,1,4.58621,0.206897,31.1293,89.4255,116,4
West Indies,176,217.33,7.15909,0.3125,225.278,7.57386,0.380682,854,DR Smith,0,0,0,0,0,0,0,0,22,7,29,22,7,29,362,230,3,0,1,2.5,0.12,17.96,84.5574,50,1
West Indies,176,217.33,7.15909,0.3125,225.278,7.57386,0.380682,854,N Deonarine,0,0,0,0,0,0,0,0,22,7,29,22,7,29,362,230,3,0,1,2.09091,0.136364,20.9545,65.7632,22,1
Australia,228,239.627,7.69737,0.372807,232.079,7.23246,0.337719,855,AJ Finch,0,0,0,0,0,0,0,0,12,1,13,12,1,13,0,255,1,0,1,4.52941,0.313725,37.2549,83.4431,51,4
Australia,228,239.627,7.69737,0.372807,232.079,7.23246,0.337719,855,SPD Smith,0,0,0,0,0,0,0,0,12,1,13,12,1,13,0,255,1,0,1,3.19298,0.22807,34.5614,87.0526,57,4
Australia,228,239.627,7.69737,0.372807,232.079,7.23246,0.337719,855,DA Warner,0,0,0,0,0,0,0,0,12,1,13,12,1,13,0,255,1,0,1,4.20312,0.265625,35.2031,87.7336,64,4
Pakistan,211,222.621,7.38389,0.393365,235.517,7.54976,0.336493,855,Ahmed Shehzad,0,0,0,0,0,0,0,0,4,8,12,4,8,12,256,162,9,0,1,3.67143,0.242857,33.2714,70.8118,70,4
Pakistan,211,222.621,7.38389,0.393365,235.517,7.54976,0.336493,855,Sarfraz Ahmed,0,0,0,0,0,0,0,0,4,8,12,4,8,12,256,162,9,0,1,2.04878,0.097561,25.4878,83.9357,41,4
Pakistan,211,222.621,7.38389,0.393365,235.517,7.54976,0.336493,855,Asad Shafiq,0,0,0,0,0,0,0,0,4,8,12,4,8,12,256,162,9,0,1,2.07843,0.176471,24.7843,67.1269,51,4
Australia,228,239.627,7.69737,0.372807,232.079,7.23246,0.337719,856,AJ Finch,0,0,0,0,0,0,0,0,16,9,25,16,9,25,0,231,0,0,1,4.52941,0.313725,37.2549,83.4431,51,4
Australia,228,239.627,7.69737,0.372807,232.079,7.23246,0.337719,856,DA Warner,0,0,0,0,0,0,0,0,16,9,25,16,9,25,0,231,0,0,1,4.20312,0.265625,35.2031,87.7336,64,4
Pakistan,211,222.621,7.38389,0.393365,235.517,7.54976,0.336493,856,Ahmed Shehzad,0,0,0,0,0,0,0,0,4,13,17,4,13,17,232,230,1,0,1,3.67143,0.242857,33.2714,70.8118,70,4
Pakistan,211,222.621,7.38389,0.393365,235.517,7.54976,0.336493,856,Sarfraz Ahmed,0,0,0,0,0,0,0,0,4,13,17,4,13,17,232,230,1,0,1,2.04878,0.097561,25.4878,83.9357,41,4
South Africa,190,234.274,7.4,0.373684,232.363,7.33158,0.342105,860,HM Amla,0,0,0,0,0,0,0,0,12,8,20,12,8,20,0,304,1,0,1,5.20168,0.403361,48.7899,86.9292,119,4
South Africa,190,234.274,7.4,0.373684,232.363,7.33158,0.342105,860,Q de Kock,0,0,0,0,0,0,0,0,12,8,20,12,8,20,0,304,1,0,1,5.12963,0.240741,39.1111,91.2311,54,4
Sri Lanka,244,223.373,7.09016,0.344262,227.578,7.47541,0.385246,860,MDKJ Perera,0,0,0,0,0,0,0,0,16,8,24,16,8,24,305,229,1,1,1,3.30435,0.195652,25.7391,90.5199,46,0
Sri Lanka,244,223.373,7.09016,0.344262,227.578,7.47541,0.385246,860,TM Dilshan,0,0,0,0,0,0,0,0,16,8,24,16,8,24,305,229,1,1,1,4.60199,0.273632,38.3632,86.0219,201,4
Sri Lanka,244,223.373,7.09016,0.344262,227.578,7.47541,0.385246,861,MDKJ Perera,0,0,0,0,0,0,0,0,24,13,37,24,13,37,0,267,1,1,1,3.30435,0.195652,25.7391,90.5199,46,0
Sri Lanka,244,223.373,7.09016,0.344262,227.578,7.47541,0.385246,861,TM Dilshan,0,0,0,0,0,0,0,0,24,13,37,24,13,37,0,267,1,1,1,4.60199,0.273632,38.3632,86.0219,201,4
Sri Lanka,244,223.373,7.09016,0.344262,227.578,7.47541,0.385246,861,KC Sangakkara,0,0,0,0,0,0,0,0,24,13,37,24,13,37,0,267,1,1,1,4.33659,0.360976,41.9854,80.6276,205,4
South Africa,190,234.274,7.4,0.373684,232.363,7.33158,0.342105,861,HM Amla,0,0,0,0,0,0,0,0,20,5,25,20,5,25,268,180,1,0,1,5.20168,0.403361,48.7899,86.9292,119,4
South Africa,190,234.274,7.4,0.373684,232.363,7.33158,0.342105,861,Q de Kock,0,0,0,0,0,0,0,0,20,5,25,20,5,25,268,180,1,0,1,5.12963,0.240741,39.1111,91.2311,54,4
South Africa,190,234.274,7.4,0.373684,232.363,7.33158,0.342105,861,JH Kallis,0,0,0,0,0,0,0,0,20,5,25,20,5,25,268,180,1,0,1,3.58621,0.356322,37.2644,76.4442,87,4
South Africa,190,234.274,7.4,0.373684,232.363,7.33158,0.342105,861,AB de Villiers,0,0,0,0,0,0,0,0,20,5,25,20,5,25,268,180,1,0,1,5.04969,0.403727,47.2174,98.8428,161,4
South Africa,190,234.274,7.4,0.373684,232.363,7.33158,0.342105,862,HM Amla,0,0,0,0,0,0,0,0,20,9,29,20,9,29,0,339,2,0,1,5.20168,0.403361,48.7899,86.9292,119,4
South Africa,190,234.274,7.4,0.373684,232.363,7.33158,0.342105,862,Q de Kock,0,0,0,0,0,0,0,0,20,9,29,20,9,29,0,339,2,0,1,5.12963,0.240741,39.1111,91.2311,54,4
Sri Lanka,244,223.373,7.09016,0.344262,227.578,7.47541,0.385246,862,MDKJ Perera,0,0,0,0,0,0,0,0,36,11,47,36,11,47,340,257,5,1,1,3.30435,0.195652,25.7391,90.5199,46,0
Sri Lanka,244,223.373,7.09016,0.344262,227.578,7.47541,0.385246,862,TM Dilshan,0,0,0,0,0,0,0,0,36,11,47,36,11,47,340,257,5,1,1,4.60199,0.273632,38.3632,86.0219,201,4
Bangladesh,160,218.438,7.70625,0.4,211.106,7.05,0.325,863,Tamim Iqbal,0,0,0,0,0,0,0,0,0,15,15,0,15,15,0,217,1,0,1,4.05344,0.274809,31.8015,76.8068,131,4
Bangladesh,160,218.438,7.70625,0.4,211.106,7.05,0.325,863,Anamul Haque,0,0,0,0,0,0,0,0,0,15,15,0,15,15,0,217,1,0,1,4.12,0.24,36.8,69.6442,25,4
West Indies,176,217.33,7.15909,0.3125,225.278,7.57386,0.380682,863,CH Gayle,0,0,0,0,0,0,0,0,0,8,8,0,8,8,218,219,0,1,1,4.58621,0.206897,31.1293,89.4255,116,4
West Indies,176,217.33,7.15909,0.3125,225.278,7.57386,0.380682,863,KA Edwards,0,0,0,0,0,0,0,0,0,8,8,0,8,8,218,219,0,1,1,1.875,0.0625,20.6875,64.902,16,1
West Indies,176,217.33,7.15909,0.3125,225.278,7.57386,0.380682,864,CH Gayle,0,0,0,0,0,0,0,0,10,2,12,10,2,12,0,247,1,1,1,4.58621,0.206897,31.1293,89.4255,116,4
West Indies,176,217.33,7.15909,0.3125,225.278,7.57386,0.380682,864,KA Edwards,0,0,0,0,0,0,0,0,10,2,12,10,2,12,0,247,1,1,1,1.875,0.0625,20.6875,64.902,16,1
West Indies,176,217.33,7.15909,0.3125,225.278,7.57386,0.380682,864,DM Bravo,0,0,0,0,0,0,0,0,10,2,12,10,2,12,0,247,1,1,1,3,0.226667,28.52,67.4551,75,4
Bangladesh,160,218.438,7.70625,0.4,211.106,7.05,0.325,864,Tamim Iqbal,0,0,0,0,0,0,0,0,6,5,11,6,5,11,248,70,1,0,1,4.05344,0.274809,31.8015,76.8068,131,4
Bangladesh,160,218.438,7.70625,0.4,211.106,7.05,0.325,864,Anamul Haque,0,0,0,0,0,0,0,0,6,5,11,6,5,11,248,70,1,0,1,4.12,0.24,36.8,69.6442,25,4
Bangladesh,160,218.438,7.70625,0.4,211.106,7.05,0.325,864,Imrul Kayes,0,0,0,0,0,0,0,0,6,5,11,6,5,11,248,70,1,0,1,3,0.207547,26.2642,63.6488,53,4
South Africa,190,234.274,7.4,0.373684,232.363,7.33158,0.342105,865,Q de Kock,0,0,0,0,0,0,0,0,12,7,19,12,7,19,0,309,0,0,1,5.12963,0.240741,39.1111,91.2311,54,4
South Africa,190,234.274,7.4,0.373684,232.363,7.33158,0.342105,865,HM Amla,0,0,0,0,0,0,0,0,12,7,19,12,7,19,0,309,0,0,1,5.20168,0.403361,48.7899,86.9292,119,4
Zimbabwe,142,212.077,7.5,0.380282,227.704,6.97887,0.316901,865,V Sibanda,0,0,0,0,0,0,0,0,12,5,17,12,5,17,310,216,1,1,1,2.9697,0.181818,23.5152,63.5545,66,1
Zimbabwe,142,212.077,7.5,0.380282,227.704,6.97887,0.316901,865,R Mutumbami,0,0,0,0,0,0,0,0,12,5,17,12,5,17,310,216,1,1,1,1.93333,0.0666667,15.4667,69.8795,15,1
Zimbabwe,142,212.077,7.5,0.380282,227.704,6.97887,0.316901,865,H Masakadza,0,0,0,0,0,0,0,0,12,5,17,12,5,17,310,216,1,1,1,3.11215,0.186916,26.972,70.0485,107,4
South Africa,190,234.274,7.4,0.373684,232.363,7.33158,0.342105,866,Q de Kock,0,0,0,0,0,0,0,0,20,9,29,20,9,29,0,257,1,0,1,5.12963,0.240741,39.1111,91.2311,54,4
South Africa,190,234.274,7.4,0.373684,232.363,7.33158,0.342105,866,HM Amla,0,0,0,0,0,0,0,0,20,9,29,20,9,29,0,257,1,0,1,5.20168,0.403361,48.7899,86.9292,119,4
Zimbabwe,142,212.077,7.5,0.380282,227.704,6.97887,0.316901,866,H Masakadza,0,0,0,0,0,0,0,0,4,8,12,4,8,12,258,196,2,1,1,3.11215,0.186916,26.972,70.0485,107,4
Zimbabwe,142,212.077,7.5,0.380282,227.704,6.97887,0.316901,866,R Mutumbami,0,0,0,0,0,0,0,0,4,8,12,4,8,12,258,196,2,1,1,1.93333,0.0666667,15.4667,69.8795,15,1
Zimbabwe,142,212.077,7.5,0.380282,227.704,6.97887,0.316901,867,H Masakadza,0,0,0,0,0,0,0,0,16,8,24,16,8,24,0,165,0,1,1,3.11215,0.186916,26.972,70.0485,107,4
Zimbabwe,142,212.077,7.5,0.380282,227.704,6.97887,0.316901,867,Sikandar Raza,0,0,0,0,0,0,0,0,16,8,24,16,8,24,0,165,0,1,1,3,0.131579,26.1842,81.1582,38,4
Zimbabwe,142,212.077,7.5,0.380282,227.704,6.97887,0.316901,867,R Mutumbami,0,0,0,0,0,0,0,0,16,8,24,16,8,24,0,165,0,1,1,1.93333,0.0666667,15.4667,69.8795,15,1
Zimbabwe,142,212.077,7.5,0.380282,227.704,6.97887,0.316901,867,E Chigumbura,0,0,0,0,0,0,0,0,16,8,24,16,8,24,0,165,0,1,1,2.28947,0.114035,22.7895,77.7844,114,4
South Africa,190,234.274,7.4,0.373684,232.363,7.33158,0.342105,867,Q de Kock,0,0,0,0,0,0,0,0,12,10,22,12,10,22,166,171,3,0,1,5.12963,0.240741,39.1111,91.2311,54,4
South Africa,190,234.274,7.4,0.373684,232.363,7.33158,0.342105,867,RR Rossouw,0,0,0,0,0,0,0,0,12,10,22,12,10,22,166,171,3,0,1,3.80769,0.230769,31.3846,93.1507,26,0
South Africa,190,234.274,7.4,0.373684,232.363,7.33158,0.342105,867,F du Plessis,0,0,0,0,0,0,0,0,12,10,22,12,10,22,166,171,3,0,1,3.45122,0.292683,34.9268,83.135,82,4
Australia,228,239.627,7.69737,0.372807,232.079,7.23246,0.337719,868,AJ Finch,0,0,0,0,0,0,0,0,4,10,14,4,10,14,0,350,0,0,1,4.52941,0.313725,37.2549,83.4431,51,4
Australia,228,239.627,7.69737,0.372807,232.079,7.23246,0.337719,868,BJ Haddin,0,0,0,0,0,0,0,0,4,10,14,4,10,14,0,350,0,0,1,3.14737,0.147368,26.7789,81.382,95,4
Zimbabwe,142,212.077,7.5,0.380282,227.704,6.97887,0.316901,868,TMK Mawoyo,0,0,0,0,0,0,0,0,6,5,11,6,5,11,351,152,0,1,1,0.571429,0,8.28571,34.9398,7,3
Zimbabwe,142,212.077,7.5,0.380282,227.704,6.97887,0.316901,868,Sikandar Raza,0,0,0,0,0,0,0,0,6,5,11,6,5,11,351,152,0,1,1,3,0.131579,26.1842,81.1582,38,4
Zimbabwe,142,212.077,7.5,0.380282,227.704,6.97887,0.316901,868,H Masakadza,0,0,0,0,0,0,0,0,6,5,11,6,5,11,351,152,0,1,1,3.11215,0.186916,26.972,70.0485,107,4
Australia,228,239.627,7.69737,0.372807,232.079,7.23246,0.337719,869,AJ Finch,0,0,0,0,0,0,0,0,12,14,26,12,14,26,0,327,1,0,1,4.52941,0.313725,37.2549,83.4431,51,4
Australia,228,239.627,7.69737,0.372807,232.079,7.23246,0.337719,869,PJ Hughes,0,0,0,0,0,0,0,0,12,14,26,12,14,26,0,327,1,0,1,4.52381,0.285714,38.7619,74.7475,21,4
South Africa,190,234.274,7.4,0.373684,232.363,7.33158,0.342105,869,Q de Kock,0,0,0,0,0,0,0,0,24,9,33,24,9,33,328,328,2,0,1,5.12963,0.240741,39.1111,91.2311,54,4
South Africa,190,234.274,7.4,0.373684,232.363,7.33158,0.342105,869,HM Amla,0,0,0,0,0,0,0,0,24,9,33,24,9,33,328,328,2,0,1,5.20168,0.403361,48.7899,86.9292,119,4
South Africa,190,234.274,7.4,0.373684,232.363,7.33158,0.342105,870,HM Amla,0,0,0,0,0,0,0,0,16,9,25,16,9,25,0,231,0,0,1,5.20168,0.403361,48.7899,86.9292,119,4
South Africa,190,234.274,7.4,0.373684,232.363,7.33158,0.342105,870,Q de Kock,0,0,0,0,0,0,0,0,16,9,25,16,9,25,0,231,0,0,1,5.12963,0.240741,39.1111,91.2311,54,4
Zimbabwe,142,212.077,7.5,0.380282,227.704,6.97887,0.316901,870,TMK Mawoyo,0,0,0,0,0,0,0,0,10,6,16,10,6,16,232,170,0,1,1,0.571429,0,8.28571,34.9398,7,3
Zimbabwe,142,212.077,7.5,0.380282,227.704,6.97887,0.316901,870,Sikandar Raza,0,0,0,0,0,0,0,0,10,6,16,10,6,16,232,170,0,1,1,3,0.131579,26.1842,81.1582,38,4
Zimbabwe,142,212.077,7.5,0.380282,227.704,6.97887,0.316901,870,H Masakadza,0,0,0,0,0,0,0,0,10,6,16,10,6,16,232,170,0,1,1,3.11215,0.186916,26.972,70.0485,107,4
Australia,228,239.627,7.69737,0.372807,232.079,7.23246,0.337719,871,AJ Finch,0,0,0,0,0,0,0,0,8,6,14,8,6,14,0,209,0,0,1,4.52941,0.313725,37.2549,83.4431,51,4
Australia,228,239.627,7.69737,0.372807,232.079,7.23246,0.337719,871,PJ Hughes,0,0,0,0,0,0,0,0,8,6,14,8,6,14,0,209,0,0,1,4.52381,0.285714,38.7619,74.7475,21,4
Australia,228,239.627,7.69737,0.372807,232.079,7.23246,0.337719,871,MJ Clarke,0,0,0,0,0,0,0,0,8,6,14,8,6,14,0,209,0,0,1,3.10294,0.301471,35.9265,74.0303,136,4
Zimbabwe,142,212.077,7.5,0.380282,227.704,6.97887,0.316901,871,TMK Mawoyo,0,0,0,0,0,0,0,0,4,5,9,4,5,9,210,211,0,1,1,0.571429,0,8.28571,34.9398,7,3
Zimbabwe,142,212.077,7.5,0.380282,227.704,6.97887,0.316901,871,Sikandar Raza,0,0,0,0,0,0,0,0,4,5,9,4,5,9,210,211,0,1,1,3,0.131579,26.1842,81.1582,38,4
Australia,228,239.627,7.69737,0.372807,232.079,7.23246,0.337719,872,AJ Finch,0,0,0,0,0,0,0,0,8,11,19,8,11,19,0,282,1,0,1,4.52941,0.313725,37.2549,83.4431,51,4
Australia,228,239.627,7.69737,0.372807,232.079,7.23246,0.337719,872,PJ Hughes,0,0,0,0,0,0,0,0,8,11,19,8,11,19,0,282,1,0,1,4.52381,0.285714,38.7619,74.7475,21,4
South Africa,190,234.274,7.4,0.373684,232.363,7.33158,0.342105,872,HM Amla,0,0,0,0,0,0,0,0,8,8,16,8,8,16,283,220,5,0,1,5.20168,0.403361,48.7899,86.9292,119,4
South Africa,190,234.274,7.4,0.373684,232.363,7.33158,0.342105,872,Q de Kock,0,0,0,0,0,0,0,0,8,8,16,8,8,16,283,220,5,0,1,5.12963,0.240741,39.1111,91.2311,54,4
South Africa,190,234.274,7.4,0.373684,232.363,7.33158,0.342105,872,F du Plessis,0,0,0,0,0,0,0,0,8,8,16,8,8,16,283,220,5,0,1,3.45122,0.292683,34.9268,83.135,82,4
South Africa,190,234.274,7.4,0.373684,232.363,7.33158,0.342105,873,Q de Kock,0,0,0,0,0,0,0,0,0,11,11,0,11,11,0,271,2,0,1,5.12963,0.240741,39.1111,91.2311,54,4
South Africa,190,234.274,7.4,0.373684,232.363,7.33158,0.342105,873,F du Plessis,0,0,0,0,0,0,0,0,0,11,11,0,11,11,0,271,2,0,1,3.45122,0.292683,34.9268,83.135,82,4
South Africa,190,234.274,7.4,0.373684,232.363,7.33158,0.342105,873,HM Amla,0,0,0,0,0,0,0,0,0,11,11,0,11,11,0,271,2,0,1,5.20168,0.403361,48.7899,86.9292,119,4
Zimbabwe,142,212.077,7.5,0.380282,227.704,6.97887,0.316901,873,V Sibanda,0,0,0,0,0,0,0,0,8,12,20,8,12,20,272,208,1,1,1,2.9697,0.181818,23.5152,63.5545,66,1
Zimbabwe,142,212.077,7.5,0.380282,227.704,6.97887,0.316901,873,Sikandar Raza,0,0,0,0,0,0,0,0,8,12,20,8,12,20,272,208,1,1,1,3,0.131579,26.1842,81.1582,38,4
New Zealand,184,233.745,7.39674,0.36413,227.951,7.30435,0.353261,876,AP Devcich,0,0,0,0,0,0,0,0,8,11,19,8,11,19,0,246,0,0,1,3.125,0.125,22.125,73.444,8,1
New Zealand,184,233.745,7.39674,0.36413,227.951,7.30435,0.353261,876,DG Brownlie,0,0,0,0,0,0,0,0,8,11,19,8,11,19,0,246,0,0,1,3,0,22.5556,72.5,9,1
Pakistan,211,222.621,7.38389,0.393365,235.517,7.54976,0.336493,876,Mohammad Hafeez,0,0,0,0,0,0,0,0,4,8,12,4,8,12,247,250,1,0,1,4.04511,0.255639,34.3534,78.0625,133,4
Pakistan,211,222.621,7.38389,0.393365,235.517,7.54976,0.336493,876,Ahmed Shehzad,0,0,0,0,0,0,0,0,4,8,12,4,8,12,247,250,1,0,1,3.67143,0.242857,33.2714,70.8118,70,4
Pakistan,211,222.621,7.38389,0.393365,235.517,7.54976,0.336493,876,Asad Shafiq,0,0,0,0,0,0,0,0,4,8,12,4,8,12,247,250,1,0,1,2.07843,0.176471,24.7843,67.1269,51,4
Pakistan,211,222.621,7.38389,0.393365,235.517,7.54976,0.336493,877,Mohammad Hafeez,0,0,0,0,0,0,0,0,12,6,18,12,6,18,0,252,3,0,1,4.04511,0.255639,34.3534,78.0625,133,4
Pakistan,211,222.621,7.38389,0.393365,235.517,7.54976,0.336493,877,Ahmed Shehzad,0,0,0,0,0,0,0,0,12,6,18,12,6,18,0,252,3,0,1,3.67143,0.242857,33.2714,70.8118,70,4
Pakistan,211,222.621,7.38389,0.393365,235.517,7.54976,0.336493,877,Younis Khan,0,0,0,0,0,0,0,0,12,6,18,12,6,18,0,252,3,0,1,2.64655,0.215517,28.5,73.2713,116,4
Pakistan,211,222.621,7.38389,0.393365,235.517,7.54976,0.336493,877,Asad Shafiq,0,0,0,0,0,0,0,0,12,6,18,12,6,18,0,252,3,0,1,2.07843,0.176471,24.7843,67.1269,51,4
Pakistan,211,222.621,7.38389,0.393365,235.517,7.54976,0.336493,877,Haris Sohail,0,0,0,0,0,0,0,0,12,6,18,12,6,18,0,252,3,0,1,3.25,0.3,35.2,80.8266,20,4
New Zealand,184,233.745,7.39674,0.36413,227.951,7.30435,0.353261,877,DG Brownlie,0,0,0,0,0,0,0,0,12,6,18,12,6,18,253,255,4,0,1,3,0,22.5556,72.5,9,1
New Zealand,184,233.745,7.39674,0.36413,227.951,7.30435,0.353261,877,AP Devcich,0,0,0,0,0,0,0,0,12,6,18,12,6,18,253,255,4,0,1,3.125,0.125,22.125,73.444,8,1
Pakistan,211,222.621,7.38389,0.393365,235.517,7.54976,0.336493,878,Mohammad Hafeez,0,0,0,0,0,0,0,0,20,10,30,20,10,30,0,364,0,0,1,4.04511,0.255639,34.3534,78.0625,133,4
Pakistan,211,222.621,7.38389,0.393365,235.517,7.54976,0.336493,878,Ahmed Shehzad,0,0,0,0,0,0,0,0,20,10,30,20,10,30,0,364,0,0,1,3.67143,0.242857,33.2714,70.8118,70,4
New Zealand,184,233.745,7.39674,0.36413,227.951,7.30435,0.353261,878,MJ Guptill,0,0,0,0,0,0,0,0,4,12,16,4,12,16,365,217,5,0,1,4.8087,0.313043,38.1217,82.7482,115,4
New Zealand,184,233.745,7.39674,0.36413,227.951,7.30435,0.353261,878,AP Devcich,0,0,0,0,0,0,0,0,4,12,16,4,12,16,365,217,5,0,1,3.125,0.125,22.125,73.444,8,1
New Zealand,184,233.745,7.39674,0.36413,227.951,7.30435,0.353261,878,KS Williamson,0,0,0,0,0,0,0,0,4,12,16,4,12,16,365,217,5,0,1,4.31707,0.390244,43.0488,82.8833,82,4
New Zealand,184,233.745,7.39674,0.36413,227.951,7.30435,0.353261,879,MJ Guptill,0,0,0,0,0,0,0,0,8,10,18,8,10,18,0,299,1,0,1,4.8087,0.313043,38.1217,82.7482,115,4
New Zealand,184,233.745,7.39674,0.36413,227.951,7.30435,0.353261,879,DG Brownlie,0,0,0,0,0,0,0,0,8,10,18,8,10,18,0,299,1,0,1,3,0,22.5556,72.5,9,1
Pakistan,211,222.621,7.38389,0.393365,235.517,7.54976,0.336493,879,Nasir Jamshed,0,0,0,0,0,0,0,0,8,10,18,8,10,18,300,292,0,0,1,3.63043,0.23913,30.2174,73.8184,46,4
Pakistan,211,222.621,7.38389,0.393365,235.517,7.54976,0.336493,879,Ahmed Shehzad,0,0,0,0,0,0,0,0,8,10,18,8,10,18,300,292,0,0,1,3.67143,0.242857,33.2714,70.8118,70,4
Pakistan,211,222.621,7.38389,0.393365,235.517,7.54976,0.336493,879,Younis Khan,0,0,0,0,0,0,0,0,8,10,18,8,10,18,300,292,0,0,1,2.64655,0.215517,28.5,73.2713,116,4
New Zealand,184,233.745,7.39674,0.36413,227.951,7.30435,0.353261,880,MJ Guptill,0,0,0,0,0,0,0,0,20,9,29,20,9,29,0,275,1,0,1,4.8087,0.313043,38.1217,82.7482,115,4
New Zealand,184,233.745,7.39674,0.36413,227.951,7.30435,0.353261,880,DG Brownlie,0,0,0,0,0,0,0,0,20,9,29,20,9,29,0,275,1,0,1,3,0,22.5556,72.5,9,1
New Zealand,184,233.745,7.39674,0.36413,227.951,7.30435,0.353261,880,KS Williamson,0,0,0,0,0,0,0,0,20,9,29,20,9,29,0,275,1,0,1,4.31707,0.390244,43.0488,82.8833,82,4
Pakistan,211,222.621,7.38389,0.393365,235.517,7.54976,0.336493,880,Nasir Jamshed,0,0,0,0,0,0,0,0,0,11,11,0,11,11,276,207,0,0,1,3.63043,0.23913,30.2174,73.8184,46,4
Pakistan,211,222.621,7.38389,0.393365,235.517,7.54976,0.336493,880,Younis Khan,0,0,0,0,0,0,0,0,0,11,11,0,11,11,276,207,0,0,1,2.64655,0.215517,28.5,73.2713,116,4
Pakistan,211,222.621,7.38389,0.393365,235.517,7.54976,0.336493,880,Ahmed Shehzad,0,0,0,0,0,0,0,0,0,11,11,0,11,11,276,207,0,0,1,3.67143,0.242857,33.2714,70.8118,70,4
England,221,237.176,7.17647,0.289593,230.633,7.45701,0.384615,881,JJ Roy,0,0,0,0,0,0,0,0,20,15,35,20,15,35,0,408,0,1,1,4.36842,0.210526,29.3684,95.3846,19,0
England,221,237.176,7.17647,0.289593,230.633,7.45701,0.384615,881,JE Root,0,0,0,0,0,0,0,0,20,15,35,20,15,35,0,408,0,1,1,3.68852,0.327869,41.6721,83.3443,61,4
England,221,237.176,7.17647,0.289593,230.633,7.45701,0.384615,881,AD Hales,0,0,0,0,0,0,0,0,20,15,35,20,15,35,0,408,0,1,1,4.2963,0.296296,34.1111,85.1201,27,4
New Zealand,184,233.745,7.39674,0.36413,227.951,7.30435,0.353261,881,MJ Guptill,0,0,0,0,0,0,0,0,24,9,33,24,9,33,409,198,4,0,1,4.8087,0.313043,38.1217,82.7482,115,4
New Zealand,184,233.745,7.39674,0.36413,227.951,7.30435,0.353261,881,BB McCullum,0,0,0,0,0,0,0,0,24,9,33,24,9,33,409,198,4,0,1,3.98611,0.201389,29.9028,98.4004,144,0
New Zealand,184,233.745,7.39674,0.36413,227.951,7.30435,0.353261,881,KS Williamson,0,0,0,0,0,0,0,0,24,9,33,24,9,33,409,198,4,0,1,4.31707,0.390244,43.0488,82.8833,82,4
New Zealand,184,233.745,7.39674,0.36413,227.951,7.30435,0.353261,882,MJ Guptill,0,0,0,0,0,0,0,0,22,6,28,22,6,28,0,398,1,0,1,4.8087,0.313043,38.1217,82.7482,115,4
New Zealand,184,233.745,7.39674,0.36413,227.951,7.30435,0.353261,882,BB McCullum,0,0,0,0,0,0,0,0,22,6,28,22,6,28,0,398,1,0,1,3.98611,0.201389,29.9028,98.4004,144,0
England,221,237.176,7.17647,0.289593,230.633,7.45701,0.384615,882,JJ Roy,0,0,0,0,0,0,0,0,20,7,27,20,7,27,399,365,1,1,1,4.36842,0.210526,29.3684,95.3846,19,0
England,221,237.176,7.17647,0.289593,230.633,7.45701,0.384615,882,AD Hales,0,0,0,0,0,0,0,0,20,7,27,20,7,27,399,365,1,1,1,4.2963,0.296296,34.1111,85.1201,27,4
New Zealand,184,233.745,7.39674,0.36413,227.951,7.30435,0.353261,883,MJ Guptill,0,0,0,0,0,0,0,0,8,16,24,8,16,24,0,349,1,0,1,4.8087,0.313043,38.1217,82.7482,115,4
New Zealand,184,233.745,7.39674,0.36413,227.951,7.30435,0.353261,883,BB McCullum,0,0,0,0,0,0,0,0,8,16,24,8,16,24,0,349,1,0,1,3.98611,0.201389,29.9028,98.4004,144,0
England,221,237.176,7.17647,0.289593,230.633,7.45701,0.384615,883,JJ Roy,0,0,0,0,0,0,0,0,22,5,27,22,5,27,350,350,2,1,1,4.36842,0.210526,29.3684,95.3846,19,0
England,221,237.176,7.17647,0.289593,230.633,7.45701,0.384615,883,AD Hales,0,0,0,0,0,0,0,0,22,5,27,22,5,27,350,350,2,1,1,4.2963,0.296296,34.1111,85.1201,27,4
New Zealand,184,233.745,7.39674,0.36413,227.951,7.30435,0.353261,884,MJ Guptill,0,0,0,0,0,0,0,0,6,18,24,6,18,24,0,283,0,0,1,4.8087,0.313043,38.1217,82.7482,115,4
New Zealand,184,233.745,7.39674,0.36413,227.951,7.30435,0.353261,884,BB McCullum,0,0,0,0,0,0,0,0,6,18,24,6,18,24,0,283,0,0,1,3.98611,0.201389,29.9028,98.4004,144,0
New Zealand,184,233.745,7.39674,0.36413,227.951,7.30435,0.353261,884,KS Williamson,0,0,0,0,0,0,0,0,6,18,24,6,18,24,0,283,0,0,1,4.31707,0.390244,43.0488,82.8833,82,4
England,221,237.176,7.17647,0.289593,230.633,7.45701,0.384615,884,JJ Roy,0,0,0,0,0,0,0,0,8,9,17,8,9,17,284,192,6,1,1,4.36842,0.210526,29.3684,95.3846,19,0
England,221,237.176,7.17647,0.289593,230.633,7.45701,0.384615,884,AD Hales,0,0,0,0,0,0,0,0,8,9,17,8,9,17,284,192,6,1,1,4.2963,0.296296,34.1111,85.1201,27,4
England,221,237.176,7.17647,0.289593,230.633,7.45701,0.384615,884,JE Root,0,0,0,0,0,0,0,0,8,9,17,8,9,17,284,192,6,1,1,3.68852,0.327869,41.6721,83.3443,61,4
England,221,237.176,7.17647,0.289593,230.633,7.45701,0.384615,884,EJG Morgan,0,0,0,0,0,0,0,0,8,9,17,8,9,17,284,192,6,1,1,3.19549,0.233083,30.0526,86.9291,133,4
England,221,237.176,7.17647,0.289593,230.633,7.45701,0.384615,884,BA Stokes,0,0,0,0,0,0,0,0,8,9,17,8,9,17,284,192,6,1,1,2.23529,0.117647,20.1471,90.0131,34,0
Australia,228,239.627,7.69737,0.372807,232.079,7.23246,0.337719,885,JA Burns,0,0,0,0,0,0,0,0,30,13,43,30,13,43,0,222,1,0,1,2.83333,0.166667,24.3333,77.2487,6,4
Australia,228,239.627,7.69737,0.372807,232.079,7.23246,0.337719,885,DA Warner,0,0,0,0,0,0,0,0,30,13,43,30,13,43,0,222,1,0,1,4.20312,0.265625,35.2031,87.7336,64,4
Ireland,55,219.527,7.65455,0.290909,202.727,7.56364,0.4,885,WTS Porterfield,0,0,0,0,0,0,0,0,12,10,22,12,10,22,223,157,2,1,1,2.6,0.142857,24.6857,56.2866,35,3
Ireland,55,219.527,7.65455,0.290909,202.727,7.56364,0.4,885,EC Joyce,0,0,0,0,0,0,0,0,12,10,22,12,10,22,223,157,2,1,1,3.08571,0.2,28.3429,68.6505,35,4
Ireland,55,219.527,7.65455,0.290909,202.727,7.56364,0.4,885,PR Stirling,0,0,0,0,0,0,0,0,12,10,22,12,10,22,223,157,2,1,1,3.47826,0.173913,24.2174,88.1329,23,0
Ireland,55,219.527,7.65455,0.290909,202.727,7.56364,0.4,885,NJ O'Brien,0,0,0,0,0,0,0,0,12,10,22,12,10,22,223,157,2,1,1,2.55882,0.176471,25.5882,69.378,34,4
Australia,228,239.627,7.69737,0.372807,232.079,7.23246,0.337719,886,JA Burns,0,0,0,0,0,0,0,0,8,11,19,8,11,19,0,305,2,0,1,2.83333,0.166667,24.3333,77.2487,6,4
Australia,228,239.627,7.69737,0.372807,232.079,7.23246,0.337719,886,DA Warner,0,0,0,0,0,0,0,0,8,11,19,8,11,19,0,305,2,0,1,4.20312,0.265625,35.2031,87.7336,64,4
England,221,237.176,7.17647,0.289593,230.633,7.45701,0.384615,886,JJ Roy,0,0,0,0,0,0,0,0,30,5,35,30,5,35,306,246,0,1,1,4.36842,0.210526,29.3684,95.3846,19,0
England,221,237.176,7.17647,0.289593,230.633,7.45701,0.384615,886,AD Hales,0,0,0,0,0,0,0,0,30,5,35,30,5,35,306,246,0,1,1,4.2963,0.296296,34.1111,85.1201,27,4
Australia,228,239.627,7.69737,0.372807,232.079,7.23246,0.337719,887,JA Burns,0,0,0,0,0,0,0,0,8,8,16,8,8,16,0,309,0,0,1,2.83333,0.166667,24.3333,77.2487,6,4
Australia,228,239.627,7.69737,0.372807,232.079,7.23246,0.337719,887,DA Warner,0,0,0,0,0,0,0,0,8,8,16,8,8,16,0,309,0,0,1,4.20312,0.265625,35.2031,87.7336,64,4
Australia,228,239.627,7.69737,0.372807,232.079,7.23246,0.337719,887,SPD Smith,0,0,0,0,0,0,0,0,8,8,16,8,8,16,0,309,0,0,1,3.19298,0.22807,34.5614,87.0526,57,4
England,221,237.176,7.17647,0.289593,230.633,7.45701,0.384615,887,JJ Roy,0,0,0,0,0,0,0,0,24,2,26,24,2,26,310,245,3,1,1,4.36842,0.210526,29.3684,95.3846,19,0
England,221,237.176,7.17647,0.289593,230.633,7.45701,0.384615,887,AD Hales,0,0,0,0,0,0,0,0,24,2,26,24,2,26,310,245,3,1,1,4.2963,0.296296,34.1111,85.1201,27,4
England,221,237.176,7.17647,0.289593,230.633,7.45701,0.384615,888,JJ Roy,0,0,0,0,0,0,0,0,8,12,20,8,12,20,0,300,4,1,1,4.36842,0.210526,29.3684,95.3846,19,0
England,221,237.176,7.17647,0.289593,230.633,7.45701,0.384615,888,AD Hales,0,0,0,0,0,0,0,0,8,12,20,8,12,20,0,300,4,1,1,4.2963,0.296296,34.1111,85.1201,27,4
Australia,228,239.627,7.69737,0.372807,232.079,7.23246,0.337719,888,JA Burns,0,0,0,0,0,0,0,0,8,12,20,8,12,20,301,207,2,0,1,2.83333,0.166667,24.3333,77.2487,6,4
Australia,228,239.627,7.69737,0.372807,232.079,7.23246,0.337719,888,AJ Finch,0,0,0,0,0,0,0,0,8,12,20,8,12,20,301,207,2,0,1,4.52941,0.313725,37.2549,83.4431,51,4
Australia,228,239.627,7.69737,0.372807,232.079,7.23246,0.337719,889,JA Burns,0,0,0,0,0,0,0,0,4,11,15,4,11,15,0,299,6,0,1,2.83333,0.166667,24.3333,77.2487,6,4
Australia,228,239.627,7.69737,0.372807,232.079,7.23246,0.337719,889,AJ Finch,0,0,0,0,0,0,0,0,4,11,15,4,11,15,0,299,6,0,1,4.52941,0.313725,37.2549,83.4431,51,4
Australia,228,239.627,7.69737,0.372807,232.079,7.23246,0.337719,889,SPD Smith,0,0,0,0,0,0,0,0,4,11,15,4,11,15,0,299,6,0,1,3.19298,0.22807,34.5614,87.0526,57,4
England,221,237.176,7.17647,0.289593,230.633,7.45701,0.384615,889,JJ Roy,0,0,0,0,0,0,0,0,28,2,30,28,2,30,300,304,4,1,1,4.36842,0.210526,29.3684,95.3846,19,0
England,221,237.176,7.17647,0.289593,230.633,7.45701,0.384615,889,AD Hales,0,0,0,0,0,0,0,0,28,2,30,28,2,30,300,304,4,1,1,4.2963,0.296296,34.1111,85.1201,27,4
England,221,237.176,7.17647,0.289593,230.633,7.45701,0.384615,889,JWA Taylor,0,0,0,0,0,0,0,0,28,2,30,28,2,30,300,304,4,1,1,3.375,0.333333,35.9167,79.8888,24,4
England,221,237.176,7.17647,0.289593,230.633,7.45701,0.384615,890,JJ Roy,0,0,0,0,0,0,0,0,16,3,19,16,3,19,0,138,1,1,1,4.36842,0.210526,29.3684,95.3846,19,0
England,221,237.176,7.17647,0.289593,230.633,7.45701,0.384615,890,JWA Taylor,0,0,0,0,0,0,0,0,16,3,19,16,3,19,0,138,1,1,1,3.375,0.333333,35.9167,79.8888,24,4
England,221,237.176,7.17647,0.289593,230.633,7.45701,0.384615,890,AD Hales,0,0,0,0,0,0,0,0,16,3,19,16,3,19,0,138,1,1,1,4.2963,0.296296,34.1111,85.1201,27,4
England,221,237.176,7.17647,0.289593,230.633,7.45701,0.384615,890,EJG Morgan,0,0,0,0,0,0,0,0,16,3,19,16,3,19,0,138,1,1,1,3.19549,0.233083,30.0526,86.9291,133,4
Australia,228,239.627,7.69737,0.372807,232.079,7.23246,0.337719,890,JA Burns,0,0,0,0,0,0,0,0,4,5,9,4,5,9,139,140,4,0,1,2.83333,0.166667,24.3333,77.2487,6,4
Australia,228,239.627,7.69737,0.372807,232.079,7.23246,0.337719,890,AJ Finch,0,0,0,0,0,0,0,0,4,5,9,4,5,9,139,140,4,0,1,4.52941,0.313725,37.2549,83.4431,51,4
Australia,228,239.627,7.69737,0.372807,232.079,7.23246,0.337719,890,SPD Smith,0,0,0,0,0,0,0,0,4,5,9,4,5,9,139,140,4,0,1,3.19298,0.22807,34.5614,87.0526,57,4
Bangladesh,160,218.438,7.70625,0.4,211.106,7.05,0.325,891,Tamim Iqbal,0,0,0,0,0,0,0,0,8,3,11,8,3,11,0,272,2,1,1,4.05344,0.274809,31.8015,76.8068,131,4
Bangladesh,160,218.438,7.70625,0.4,211.106,7.05,0.325,891,Anamul Haque,0,0,0,0,0,0,0,0,8,3,11,8,3,11,0,272,2,1,1,4.12,0.24,36.8,69.6442,25,4
India,259,242.378,7.15058,0.339768,244.568,7.12741,0.30888,891,RV Uthappa,0,0,0,0,0,0,0,0,12,11,23,12,11,23,273,153,2,0,1,3,0.117647,22.1471,89.0071,34,0
India,259,242.378,7.15058,0.339768,244.568,7.12741,0.30888,891,AM Rahane,0,0,0,0,0,0,0,0,12,11,23,12,11,23,273,153,2,0,1,3.55738,0.262295,32.2295,78.0159,61,4
Sri Lanka,244,223.373,7.09016,0.344262,227.578,7.47541,0.385246,892,WU Tharanga,0,0,0,0,0,0,0,0,4,10,14,4,10,14,0,275,3,1,1,3.93985,0.263158,32.9699,71.6035,133,4
Sri Lanka,244,223.373,7.09016,0.344262,227.578,7.47541,0.385246,892,TM Dilshan,0,0,0,0,0,0,0,0,4,10,14,4,10,14,0,275,3,1,1,4.60199,0.273632,38.3632,86.0219,201,4
Sri Lanka,244,223.373,7.09016,0.344262,227.578,7.47541,0.385246,892,KC Sangakkara,0,0,0,0,0,0,0,0,4,10,14,4,10,14,0,275,3,1,1,4.33659,0.360976,41.9854,80.6276,205,4
Pakistan,211,222.621,7.38389,0.393365,235.517,7.54976,0.336493,892,Ahmed Shehzad,0,0,0,0,0,0,0,0,16,7,23,16,7,23,276,277,0,0,1,3.67143,0.242857,33.2714,70.8118,70,4
Pakistan,211,222.621,7.38389,0.393365,235.517,7.54976,0.336493,892,Mohammad Hafeez,0,0,0,0,0,0,0,0,16,7,23,16,7,23,276,277,0,0,1,4.04511,0.255639,34.3534,78.0625,133,4
Sri Lanka,244,223.373,7.09016,0.344262,227.578,7.47541,0.385246,893,WU Tharanga,0,0,0,0,0,0,0,0,20,6,26,20,6,26,0,310,3,1,1,3.93985,0.263158,32.9699,71.6035,133,4
Sri Lanka,244,223.373,7.09016,0.344262,227.578,7.47541,0.385246,893,TM Dilshan,0,0,0,0,0,0,0,0,20,6,26,20,6,26,0,310,3,1,1,4.60199,0.273632,38.3632,86.0219,201,4
Sri Lanka,244,223.373,7.09016,0.344262,227.578,7.47541,0.385246,893,KC Sangakkara,0,0,0,0,0,0,0,0,20,6,26,20,6,26,0,310,3,1,1,4.33659,0.360976,41.9854,80.6276,205,4
Pakistan,211,222.621,7.38389,0.393365,235.517,7.54976,0.336493,893,Ahmed Shehzad,0,0,0,0,0,0,0,0,24,8,32,24,8,32,311,233,4,0,1,3.67143,0.242857,33.2714,70.8118,70,4
Pakistan,211,222.621,7.38389,0.393365,235.517,7.54976,0.336493,893,Sharjeel Khan,0,0,0,0,0,0,0,0,24,8,32,24,8,32,311,233,4,0,1,2.6,0.1,16.9,81.25,10,1
Pakistan,211,222.621,7.38389,0.393365,235.517,7.54976,0.336493,893,Mohammad Hafeez,0,0,0,0,0,0,0,0,24,8,32,24,8,32,311,233,4,0,1,4.04511,0.255639,34.3534,78.0625,133,4
Pakistan,211,222.621,7.38389,0.393365,235.517,7.54976,0.336493,894,Ahmed Shehzad,0,0,0,0,0,0,0,0,0,4,4,0,4,4,0,102,2,0,1,3.67143,0.242857,33.2714,70.8118,70,4
Pakistan,211,222.621,7.38389,0.393365,235.517,7.54976,0.336493,894,Sharjeel Khan,0,0,0,0,0,0,0,0,0,4,4,0,4,4,0,102,2,0,1,2.6,0.1,16.9,81.25,10,1
Pakistan,211,222.621,7.38389,0.393365,235.517,7.54976,0.336493,894,Mohammad Hafeez,0,0,0,0,0,0,0,0,0,4,4,0,4,4,0,102,2,0,1,4.04511,0.255639,34.3534,78.0625,133,4
Sri Lanka,244,223.373,7.09016,0.344262,227.578,7.47541,0.385246,894,WU Tharanga,0,0,0,0,0,0,0,0,24,7,31,24,7,31,103,104,3,1,1,3.93985,0.263158,32.9699,71.6035,133,4
Sri Lanka,244,223.373,7.09016,0.344262,227.578,7.47541,0.385246,894,TM Dilshan,0,0,0,0,0,0,0,0,24,7,31,24,7,31,103,104,3,1,1,4.60199,0.273632,38.3632,86.0219,201,4
New Zealand,184,233.745,7.39674,0.36413,227.951,7.30435,0.353261,895,MJ Guptill,0,0,0,0,0,0,0,0,12,5,17,12,5,17,0,230,3,1,1,4.8087,0.313043,38.1217,82.7482,115,4
New Zealand,184,233.745,7.39674,0.36413,227.951,7.30435,0.353261,895,JDS Neesham,0,0,0,0,0,0,0,0,12,5,17,12,5,17,0,230,3,1,1,1.75,0,14.875,93.7008,16,0
South Africa,190,234.274,7.4,0.373684,232.363,7.33158,0.342105,895,Q de Kock,0,0,0,0,0,0,0,0,8,8,16,8,8,16,231,236,1,0,1,5.12963,0.240741,39.1111,91.2311,54,4
South Africa,190,234.274,7.4,0.373684,232.363,7.33158,0.342105,895,HM Amla,0,0,0,0,0,0,0,0,8,8,16,8,8,16,231,236,1,0,1,5.20168,0.403361,48.7899,86.9292,119,4
South Africa,190,234.274,7.4,0.373684,232.363,7.33158,0.342105,895,F du Plessis,0,0,0,0,0,0,0,0,8,8,16,8,8,16,231,236,1,0,1,3.45122,0.292683,34.9268,83.135,82,4
South Africa,190,234.274,7.4,0.373684,232.363,7.33158,0.342105,896,HM Amla,0,0,0,0,0,0,0,0,0,13,13,0,13,13,0,282,2,0,1,5.20168,0.403361,48.7899,86.9292,119,4
South Africa,190,234.274,7.4,0.373684,232.363,7.33158,0.342105,896,Q de Kock,0,0,0,0,0,0,0,0,0,13,13,0,13,13,0,282,2,0,1,5.12963,0.240741,39.1111,91.2311,54,4
New Zealand,184,233.745,7.39674,0.36413,227.951,7.30435,0.353261,896,MJ Guptill,0,0,0,0,0,0,0,0,4,11,15,4,11,15,283,210,2,1,1,4.8087,0.313043,38.1217,82.7482,115,4
New Zealand,184,233.745,7.39674,0.36413,227.951,7.30435,0.353261,896,JDS Neesham,0,0,0,0,0,0,0,0,4,11,15,4,11,15,283,210,2,1,1,1.75,0,14.875,93.7008,16,0
Sri Lanka,244,223.373,7.09016,0.344262,227.578,7.47541,0.385246,897,FDM Karunaratne,0,0,0,0,0,0,0,0,0,8,8,0,8,8,0,218,3,0,1,0.8,0,10.7,64.8485,10,1
Sri Lanka,244,223.373,7.09016,0.344262,227.578,7.47541,0.385246,897,TM Dilshan,0,0,0,0,0,0,0,0,0,8,8,0,8,8,0,218,3,0,1,4.60199,0.273632,38.3632,86.0219,201,4
Sri Lanka,244,223.373,7.09016,0.344262,227.578,7.47541,0.385246,897,KC Sangakkara,0,0,0,0,0,0,0,0,0,8,8,0,8,8,0,218,3,0,1,4.33659,0.360976,41.9854,80.6276,205,4
New Zealand,184,233.745,7.39674,0.36413,227.951,7.30435,0.353261,897,MJ Guptill,0,0,0,0,0,0,0,0,32,12,44,32,12,44,219,219,4,1,1,4.8087,0.313043,38.1217,82.7482,115,4
New Zealand,184,233.745,7.39674,0.36413,227.951,7.30435,0.353261,897,KS Williamson,0,0,0,0,0,0,0,0,32,12,44,32,12,44,219,219,4,1,1,4.31707,0.390244,43.0488,82.8833,82,4
New Zealand,184,233.745,7.39674,0.36413,227.951,7.30435,0.353261,897,BB McCullum,0,0,0,0,0,0,0,0,32,12,44,32,12,44,219,219,4,1,1,3.98611,0.201389,29.9028,98.4004,144,0
New Zealand,184,233.745,7.39674,0.36413,227.951,7.30435,0.353261,898,MJ Guptill,0,0,0,0,0,0,0,0,16,12,28,16,12,28,0,248,0,1,1,4.8087,0.313043,38.1217,82.7482,115,4
New Zealand,184,233.745,7.39674,0.36413,227.951,7.30435,0.353261,898,BB McCullum,0,0,0,0,0,0,0,0,16,12,28,16,12,28,0,248,0,1,1,3.98611,0.201389,29.9028,98.4004,144,0
Sri Lanka,244,223.373,7.09016,0.344262,227.578,7.47541,0.385246,898,FDM Karunaratne,0,0,0,0,0,0,0,0,16,6,22,16,6,22,249,252,6,0,1,0.8,0,10.7,64.8485,10,1
Sri Lanka,244,223.373,7.09016,0.344262,227.578,7.47541,0.385246,898,TM Dilshan,0,0,0,0,0,0,0,0,16,6,22,16,6,22,249,252,6,0,1,4.60199,0.273632,38.3632,86.0219,201,4
Sri Lanka,244,223.373,7.09016,0.344262,227.578,7.47541,0.385246,899,FDM Karunaratne,0,0,0,0,0,0,0,0,0,9,9,0,9,9,0,276,2,0,1,0.8,0,10.7,64.8485,10,1
Sri Lanka,244,223.373,7.09016,0.344262,227.578,7.47541,0.385246,899,TM Dilshan,0,0,0,0,0,0,0,0,0,9,9,0,9,9,0,276,2,0,1,4.60199,0.273632,38.3632,86.0219,201,4
Sri Lanka,244,223.373,7.09016,0.344262,227.578,7.47541,0.385246,899,KC Sangakkara,0,0,0,0,0,0,0,0,0,9,9,0,9,9,0,276,2,0,1,4.33659,0.360976,41.9854,80.6276,205,4
New Zealand,184,233.745,7.39674,0.36413,227.951,7.30435,0.353261,899,MJ Guptill,0,0,0,0,0,0,0,0,12,13,25,12,13,25,277,280,1,1,1,4.8087,0.313043,38.1217,82.7482,115,4
New Zealand,184,233.745,7.39674,0.36413,227.951,7.30435,0.353261,899,BB McCullum,0,0,0,0,0,0,0,0,12,13,25,12,13,25,277,280,1,1,1,3.98611,0.201389,29.9028,98.4004,144,0
New Zealand,184,233.745,7.39674,0.36413,227.951,7.30435,0.353261,899,KS Williamson,0,0,0,0,0,0,0,0,12,13,25,12,13,25,277,280,1,1,1,4.31707,0.390244,43.0488,82.8833,82,4
New Zealand,184,233.745,7.39674,0.36413,227.951,7.30435,0.353261,900,MJ Guptill,0,0,0,0,0,0,0,0,20,7,27,20,7,27,0,360,0,1,1,4.8087,0.313043,38.1217,82.7482,115,4
New Zealand,184,233.745,7.39674,0.36413,227.951,7.30435,0.353261,900,KS Williamson,0,0,0,0,0,0,0,0,20,7,27,20,7,27,0,360,0,1,1,4.31707,0.390244,43.0488,82.8833,82,4
New Zealand,184,233.745,7.39674,0.36413,227.951,7.30435,0.353261,900,BB McCullum,0,0,0,0,0,0,0,0,20,7,27,20,7,27,0,360,0,1,1,3.98611,0.201389,29.9028,98.4004,144,0
Sri Lanka,244,223.373,7.09016,0.344262,227.578,7.47541,0.385246,900,HDRL Thirimanne,0,0,0,0,0,0,0,0,8,9,17,8,9,17,361,252,5,0,1,2.77778,0.246914,31.5802,71.4725,81,4
Sri Lanka,244,223.373,7.09016,0.344262,227.578,7.47541,0.385246,900,TM Dilshan,0,0,0,0,0,0,0,0,8,9,17,8,9,17,361,252,5,0,1,4.60199,0.273632,38.3632,86.0219,201,4
Sri Lanka,244,223.373,7.09016,0.344262,227.578,7.47541,0.385246,901,HDRL Thirimanne,0,0,0,0,0,0,0,0,8,9,17,8,9,17,0,287,1,0,1,2.77778,0.246914,31.5802,71.4725,81,4
Sri Lanka,244,223.373,7.09016,0.344262,227.578,7.47541,0.385246,901,TM Dilshan,0,0,0,0,0,0,0,0,8,9,17,8,9,17,0,287,1,0,1,4.60199,0.273632,38.3632,86.0219,201,4
New Zealand,184,233.745,7.39674,0.36413,227.951,7.30435,0.353261,901,MJ Guptill,0,0,0,0,0,0,0,0,8,8,16,8,8,16,288,253,2,1,1,4.8087,0.313043,38.1217,82.7482,115,4
New Zealand,184,233.745,7.39674,0.36413,227.951,7.30435,0.353261,901,KS Williamson,0,0,0,0,0,0,0,0,8,8,16,8,8,16,288,253,2,1,1,4.31707,0.390244,43.0488,82.8833,82,4
New Zealand,184,233.745,7.39674,0.36413,227.951,7.30435,0.353261,901,TWM Latham,0,0,0,0,0,0,0,0,8,8,16,8,8,16,288,253,2,1,1,2.76471,0.147059,25.3529,75.2182,34,4
New Zealand,184,233.745,7.39674,0.36413,227.951,7.30435,0.353261,901,LRPL Taylor,0,0,0,0,0,0,0,0,8,8,16,8,8,16,288,253,2,1,1,3.68382,0.301471,36.7206,79.3959,136,4
Pakistan,211,222.621,7.38389,0.393365,235.517,7.54976,0.336493,902,Mohammad Hafeez,0,0,0,0,0,0,0,0,0,3,3,0,3,3,0,210,3,0,1,4.04511,0.255639,34.3534,78.0625,133,4
Pakistan,211,222.621,7.38389,0.393365,235.517,7.54976,0.336493,902,Younis Khan,0,0,0,0,0,0,0,0,0,3,3,0,3,3,0,210,3,0,1,2.64655,0.215517,28.5,73.2713,116,4
Pakistan,211,222.621,7.38389,0.393365,235.517,7.54976,0.336493,902,Ahmed Shehzad,0,0,0,0,0,0,0,0,0,3,3,0,3,3,0,210,3,0,1,3.67143,0.242857,33.2714,70.8118,70,4
New Zealand,184,233.745,7.39674,0.36413,227.951,7.30435,0.353261,902,MJ Guptill,0,0,0,0,0,0,0,0,28,3,31,28,3,31,211,213,2,1,1,4.8087,0.313043,38.1217,82.7482,115,4
New Zealand,184,233.745,7.39674,0.36413,227.951,7.30435,0.353261,902,BB McCullum,0,0,0,0,0,0,0,0,28,3,31,28,3,31,211,213,2,1,1,3.98611,0.201389,29.9028,98.4004,144,0
New Zealand,184,233.745,7.39674,0.36413,227.951,7.30435,0.353261,902,TWM Latham,0,0,0,0,0,0,0,0,28,3,31,28,3,31,211,213,2,1,1,2.76471,0.147059,25.3529,75.2182,34,4
New Zealand,184,233.745,7.39674,0.36413,227.951,7.30435,0.353261,903,MJ Guptill,0,0,0,0,0,0,0,0,18,10,28,18,10,28,0,369,2,1,1,4.8087,0.313043,38.1217,82.7482,115,4
New Zealand,184,233.745,7.39674,0.36413,227.951,7.30435,0.353261,903,BB McCullum,0,0,0,0,0,0,0,0,18,10,28,18,10,28,0,369,2,1,1,3.98611,0.201389,29.9028,98.4004,144,0
Pakistan,211,222.621,7.38389,0.393365,235.517,7.54976,0.336493,903,Mohammad Hafeez,0,0,0,0,0,0,0,0,12,12,24,12,12,24,370,250,3,0,1,4.04511,0.255639,34.3534,78.0625,133,4
Pakistan,211,222.621,7.38389,0.393365,235.517,7.54976,0.336493,903,Ahmed Shehzad,0,0,0,0,0,0,0,0,12,12,24,12,12,24,370,250,3,0,1,3.67143,0.242857,33.2714,70.8118,70,4
Sri Lanka,244,223.373,7.09016,0.344262,227.578,7.47541,0.385246,904,TM Dilshan,0,0,0,0,0,0,0,0,16,9,25,16,9,25,0,317,1,1,1,4.60199,0.273632,38.3632,86.0219,201,4
Sri Lanka,244,223.373,7.09016,0.344262,227.578,7.47541,0.385246,904,MDKJ Perera,0,0,0,0,0,0,0,0,16,9,25,16,9,25,0,317,1,1,1,3.30435,0.195652,25.7391,90.5199,46,0
England,221,237.176,7.17647,0.289593,230.633,7.45701,0.384615,904,AN Cook,0,0,0,0,0,0,0,0,16,15,31,16,15,31,318,292,1,0,1,4.17045,0.272727,35.75,75.5524,88,4
England,221,237.176,7.17647,0.289593,230.633,7.45701,0.384615,904,MM Ali,0,0,0,0,0,0,0,0,16,15,31,16,15,31,318,292,1,0,1,2.67647,0.117647,21.3824,94.5384,34,0
England,221,237.176,7.17647,0.289593,230.633,7.45701,0.384615,905,AN Cook,0,0,0,0,0,0,0,0,8,11,19,8,11,19,0,185,2,0,1,4.17045,0.272727,35.75,75.5524,88,4
England,221,237.176,7.17647,0.289593,230.633,7.45701,0.384615,905,MM Ali,0,0,0,0,0,0,0,0,8,11,19,8,11,19,0,185,2,0,1,2.67647,0.117647,21.3824,94.5384,34,0
England,221,237.176,7.17647,0.289593,230.633,7.45701,0.384615,905,IR Bell,0,0,0,0,0,0,0,0,8,11,19,8,11,19,0,185,2,0,1,3.63433,0.246269,35.3806,75.6623,134,4
Sri Lanka,244,223.373,7.09016,0.344262,227.578,7.47541,0.385246,905,TM Dilshan,0,0,0,0,0,0,0,0,16,10,26,16,10,26,186,186,1,1,1,4.60199,0.273632,38.3632,86.0219,201,4
Sri Lanka,244,223.373,7.09016,0.344262,227.578,7.47541,0.385246,905,MDKJ Perera,0,0,0,0,0,0,0,0,16,10,26,16,10,26,186,186,1,1,1,3.30435,0.195652,25.7391,90.5199,46,0
Sri Lanka,244,223.373,7.09016,0.344262,227.578,7.47541,0.385246,905,KC Sangakkara,0,0,0,0,0,0,0,0,16,10,26,16,10,26,186,186,1,1,1,4.33659,0.360976,41.9854,80.6276,205,4
Sri Lanka,244,223.373,7.09016,0.344262,227.578,7.47541,0.385246,906,TM Dilshan,0,0,0,0,0,0,0,0,20,10,30,20,10,30,0,242,0,1,1,4.60199,0.273632,38.3632,86.0219,201,4
Sri Lanka,244,223.373,7.09016,0.344262,227.578,7.47541,0.385246,906,MDKJ Perera,0,0,0,0,0,0,0,0,20,10,30,20,10,30,0,242,0,1,1,3.30435,0.195652,25.7391,90.5199,46,0
Sri Lanka,244,223.373,7.09016,0.344262,227.578,7.47541,0.385246,906,KC Sangakkara,0,0,0,0,0,0,0,0,20,10,30,20,10,30,0,242,0,1,1,4.33659,0.360976,41.9854,80.6276,205,4
Sri Lanka,244,223.373,7.09016,0.344262,227.578,7.47541,0.385246,906,SHT Kandamby,0,0,0,0,0,0,0,0,20,10,30,20,10,30,0,242,0,1,1,2.23333,0.166667,27.1667,69.5392,30,4
England,221,237.176,7.17647,0.289593,230.633,7.45701,0.384615,906,AN Cook,0,0,0,0,0,0,0,0,18,15,33,18,15,33,243,236,0,0,1,4.17045,0.272727,35.75,75.5524,88,4
England,221,237.176,7.17647,0.289593,230.633,7.45701,0.384615,906,MM Ali,0,0,0,0,0,0,0,0,18,15,33,18,15,33,243,236,0,0,1,2.67647,0.117647,21.3824,94.5384,34,0
England,221,237.176,7.17647,0.289593,230.633,7.45701,0.384615,907,MM Ali,0,0,0,0,0,0,0,0,4,9,13,4,9,13,0,265,1,0,1,2.67647,0.117647,21.3824,94.5384,34,0
England,221,237.176,7.17647,0.289593,230.633,7.45701,0.384615,907,AD Hales,0,0,0,0,0,0,0,0,4,9,13,4,9,13,0,265,1,0,1,4.2963,0.296296,34.1111,85.1201,27,4
England,221,237.176,7.17647,0.289593,230.633,7.45701,0.384615,907,JWA Taylor,0,0,0,0,0,0,0,0,4,9,13,4,9,13,0,265,1,0,1,3.375,0.333333,35.9167,79.8888,24,4
Sri Lanka,244,223.373,7.09016,0.344262,227.578,7.47541,0.385246,907,TM Dilshan,0,0,0,0,0,0,0,0,20,6,26,20,6,26,266,267,2,1,1,4.60199,0.273632,38.3632,86.0219,201,4
Sri Lanka,244,223.373,7.09016,0.344262,227.578,7.47541,0.385246,907,MDKJ Perera,0,0,0,0,0,0,0,0,20,6,26,20,6,26,266,267,2,1,1,3.30435,0.195652,25.7391,90.5199,46,0
Sri Lanka,244,223.373,7.09016,0.344262,227.578,7.47541,0.385246,908,TM Dilshan,0,0,0,0,0,0,0,0,16,10,26,16,10,26,0,239,0,1,1,4.60199,0.273632,38.3632,86.0219,201,4
Sri Lanka,244,223.373,7.09016,0.344262,227.578,7.47541,0.385246,908,MDKJ Perera,0,0,0,0,0,0,0,0,16,10,26,16,10,26,0,239,0,1,1,3.30435,0.195652,25.7391,90.5199,46,0
Sri Lanka,244,223.373,7.09016,0.344262,227.578,7.47541,0.385246,908,KC Sangakkara,0,0,0,0,0,0,0,0,16,10,26,16,10,26,0,239,0,1,1,4.33659,0.360976,41.9854,80.6276,205,4
England,221,237.176,7.17647,0.289593,230.633,7.45701,0.384615,908,AN Cook,0,0,0,0,0,0,0,0,18,7,25,18,7,25,240,240,0,0,1,4.17045,0.272727,35.75,75.5524,88,4
England,221,237.176,7.17647,0.289593,230.633,7.45701,0.384615,908,MM Ali,0,0,0,0,0,0,0,0,18,7,25,18,7,25,240,240,0,0,1,2.67647,0.117647,21.3824,94.5384,34,0
England,221,237.176,7.17647,0.289593,230.633,7.45701,0.384615,908,JWA Taylor,0,0,0,0,0,0,0,0,18,7,25,18,7,25,240,240,0,0,1,3.375,0.333333,35.9167,79.8888,24,4
Sri Lanka,244,223.373,7.09016,0.344262,227.578,7.47541,0.385246,909,DPMD Jayawardene,0,0,0,0,0,0,0,0,8,4,12,8,4,12,0,292,1,1,1,3.20833,0.244792,31.6979,79.1109,192,4
Sri Lanka,244,223.373,7.09016,0.344262,227.578,7.47541,0.385246,909,TM Dilshan,0,0,0,0,0,0,0,0,8,4,12,8,4,12,0,292,1,1,1,4.60199,0.273632,38.3632,86.0219,201,4
Sri Lanka,244,223.373,7.09016,0.344262,227.578,7.47541,0.385246,909,KC Sangakkara,0,0,0,0,0,0,0,0,8,4,12,8,4,12,0,292,1,1,1,4.33659,0.360976,41.9854,80.6276,205,4
England,221,237.176,7.17647,0.289593,230.633,7.45701,0.384615,909,AN Cook,0,0,0,0,0,0,0,0,8,9,17,8,9,17,293,202,0,0,1,4.17045,0.272727,35.75,75.5524,88,4
England,221,237.176,7.17647,0.289593,230.633,7.45701,0.384615,909,MM Ali,0,0,0,0,0,0,0,0,8,9,17,8,9,17,293,202,0,0,1,2.67647,0.117647,21.3824,94.5384,34,0
England,221,237.176,7.17647,0.289593,230.633,7.45701,0.384615,909,JWA Taylor,0,0,0,0,0,0,0,0,8,9,17,8,9,17,293,202,0,0,1,3.375,0.333333,35.9167,79.8888,24,4
Australia,228,239.627,7.69737,0.372807,232.079,7.23246,0.337719,910,DA Warner,0,0,0,0,0,0,0,0,0,10,10,0,10,10,0,300,2,1,1,4.20312,0.265625,35.2031,87.7336,64,4
Australia,228,239.627,7.69737,0.372807,232.079,7.23246,0.337719,910,AJ Finch,0,0,0,0,0,0,0,0,0,10,10,0,10,10,0,300,2,1,1,4.52941,0.313725,37.2549,83.4431,51,4
South Africa,190,234.274,7.4,0.373684,232.363,7.33158,0.342105,910,HM Amla,0,0,0,0,0,0,0,0,4,12,16,4,12,16,301,268,2,0,1,5.20168,0.403361,48.7899,86.9292,119,4
South Africa,190,234.274,7.4,0.373684,232.363,7.33158,0.342105,910,Q de Kock,0,0,0,0,0,0,0,0,4,12,16,4,12,16,301,268,2,0,1,5.12963,0.240741,39.1111,91.2311,54,4
South Africa,190,234.274,7.4,0.373684,232.363,7.33158,0.342105,910,F du Plessis,0,0,0,0,0,0,0,0,4,12,16,4,12,16,301,268,2,0,1,3.45122,0.292683,34.9268,83.135,82,4
South Africa,190,234.274,7.4,0.373684,232.363,7.33158,0.342105,910,F Behardien,0,0,0,0,0,0,0,0,4,12,16,4,12,16,301,268,2,0,1,2.0303,0.0909091,21.2424,91.395,33,0
Australia,228,239.627,7.69737,0.372807,232.079,7.23246,0.337719,911,DA Warner,0,0,0,0,0,0,0,0,10,3,13,10,3,13,0,154,1,1,1,4.20312,0.265625,35.2031,87.7336,64,4
Australia,228,239.627,7.69737,0.372807,232.079,7.23246,0.337719,911,SR Watson,0,0,0,0,0,0,0,0,10,3,13,10,3,13,0,154,1,1,1,4.71318,0.286822,37.7907,90.0943,129,4
Australia,228,239.627,7.69737,0.372807,232.079,7.23246,0.337719,911,AJ Finch,0,0,0,0,0,0,0,0,10,3,13,10,3,13,0,154,1,1,1,4.52941,0.313725,37.2549,83.4431,51,4
Australia,228,239.627,7.69737,0.372807,232.079,7.23246,0.337719,911,SPD Smith,0,0,0,0,0,0,0,0,10,3,13,10,3,13,0,154,1,1,1,3.19298,0.22807,34.5614,87.0526,57,4
South Africa,190,234.274,7.4,0.373684,232.363,7.33158,0.342105,911,Q de Kock,0,0,0,0,0,0,0,0,12,6,18,12,6,18,155,157,2,0,1,5.12963,0.240741,39.1111,91.2311,54,4
South Africa,190,234.274,7.4,0.373684,232.363,7.33158,0.342105,911,HM Amla,0,0,0,0,0,0,0,0,12,6,18,12,6,18,155,157,2,0,1,5.20168,0.403361,48.7899,86.9292,119,4
South Africa,190,234.274,7.4,0.373684,232.363,7.33158,0.342105,911,F du Plessis,0,0,0,0,0,0,0,0,12,6,18,12,6,18,155,157,2,0,1,3.45122,0.292683,34.9268,83.135,82,4
Australia,228,239.627,7.69737,0.372807,232.079,7.23246,0.337719,912,AJ Finch,0,0,0,0,0,0,0,0,18,6,24,18,6,24,0,329,7,1,1,4.52941,0.313725,37.2549,83.4431,51,4
Australia,228,239.627,7.69737,0.372807,232.079,7.23246,0.337719,912,DA Warner,0,0,0,0,0,0,0,0,18,6,24,18,6,24,0,329,7,1,1,4.20312,0.265625,35.2031,87.7336,64,4
South Africa,190,234.274,7.4,0.373684,232.363,7.33158,0.342105,912,HM Amla,0,0,0,0,0,0,0,0,20,8,28,20,8,28,330,256,1,0,1,5.20168,0.403361,48.7899,86.9292,119,4
South Africa,190,234.274,7.4,0.373684,232.363,7.33158,0.342105,912,Q de Kock,0,0,0,0,0,0,0,0,20,8,28,20,8,28,330,256,1,0,1,5.12963,0.240741,39.1111,91.2311,54,4
South Africa,190,234.274,7.4,0.373684,232.363,7.33158,0.342105,913,Q de Kock,0,0,0,0,0,0,0,0,12,10,22,12,10,22,0,267,5,0,1,5.12963,0.240741,39.1111,91.2311,54,4
South Africa,190,234.274,7.4,0.373684,232.363,7.33158,0.342105,913,HM Amla,0,0,0,0,0,0,0,0,12,10,22,12,10,22,0,267,5,0,1,5.20168,0.403361,48.7899,86.9292,119,4
Australia,228,239.627,7.69737,0.372807,232.079,7.23246,0.337719,913,AJ Finch,0,0,0,0,0,0,0,0,4,11,15,4,11,15,268,268,0,1,1,4.52941,0.313725,37.2549,83.4431,51,4
Australia,228,239.627,7.69737,0.372807,232.079,7.23246,0.337719,913,DA Warner,0,0,0,0,0,0,0,0,4,11,15,4,11,15,268,268,0,1,1,4.20312,0.265625,35.2031,87.7336,64,4
Australia,228,239.627,7.69737,0.372807,232.079,7.23246,0.337719,913,SR Watson,0,0,0,0,0,0,0,0,4,11,15,4,11,15,268,268,0,1,1,4.71318,0.286822,37.7907,90.0943,129,4
South Africa,190,234.274,7.4,0.373684,232.363,7.33158,0.342105,914,HM Amla,0,0,0,0,0,0,0,0,16,3,19,16,3,19,0,280,4,0,1,5.20168,0.403361,48.7899,86.9292,119,4
South Africa,190,234.274,7.4,0.373684,232.363,7.33158,0.342105,914,Q de Kock,0,0,0,0,0,0,0,0,16,3,19,16,3,19,0,280,4,0,1,5.12963,0.240741,39.1111,91.2311,54,4
Australia,228,239.627,7.69737,0.372807,232.079,7.23246,0.337719,914,DA Warner,0,0,0,0,0,0,0,0,26,10,36,26,10,36,281,275,1,1,1,4.20312,0.265625,35.2031,87.7336,64,4
Australia,228,239.627,7.69737,0.372807,232.079,7.23246,0.337719,914,AJ Finch,0,0,0,0,0,0,0,0,26,10,36,26,10,36,281,275,1,1,1,4.52941,0.313725,37.2549,83.4431,51,4
India,259,242.378,7.15058,0.339768,244.568,7.12741,0.30888,915,RG Sharma,0,0,0,0,0,0,0,0,18,8,26,18,8,26,0,267,3,0,1,3.82836,0.268657,35.9179,83.083,134,4
India,259,242.378,7.15058,0.339768,244.568,7.12741,0.30888,915,S Dhawan,0,0,0,0,0,0,0,0,18,8,26,18,8,26,0,267,3,0,1,5.65217,0.362319,43.2174,88.9088,69,4
India,259,242.378,7.15058,0.339768,244.568,7.12741,0.30888,915,AM Rahane,0,0,0,0,0,0,0,0,18,8,26,18,8,26,0,267,3,0,1,3.55738,0.262295,32.2295,78.0159,61,4
Australia,228,239.627,7.69737,0.372807,232.079,7.23246,0.337719,915,AJ Finch,0,0,0,0,0,0,0,0,16,12,28,16,12,28,268,269,4,1,1,4.52941,0.313725,37.2549,83.4431,51,4
Australia,228,239.627,7.69737,0.372807,232.079,7.23246,0.337719,915,DA Warner,0,0,0,0,0,0,0,0,16,12,28,16,12,28,268,269,4,1,1,4.20312,0.265625,35.2031,87.7336,64,4
England,221,237.176,7.17647,0.289593,230.633,7.45701,0.384615,916,IR Bell,0,0,0,0,0,0,0,0,8,5,13,8,5,13,0,234,2,0,1,3.63433,0.246269,35.3806,75.6623,134,4
England,221,237.176,7.17647,0.289593,230.633,7.45701,0.384615,916,JWA Taylor,0,0,0,0,0,0,0,0,8,5,13,8,5,13,0,234,2,0,1,3.375,0.333333,35.9167,79.8888,24,4
England,221,237.176,7.17647,0.289593,230.633,7.45701,0.384615,916,JE Root,0,0,0,0,0,0,0,0,8,5,13,8,5,13,0,234,2,0,1,3.68852,0.327869,41.6721,83.3443,61,4
England,221,237.176,7.17647,0.289593,230.633,7.45701,0.384615,916,MM Ali,0,0,0,0,0,0,0,0,8,5,13,8,5,13,0,234,2,0,1,2.67647,0.117647,21.3824,94.5384,34,0
England,221,237.176,7.17647,0.289593,230.633,7.45701,0.384615,916,EJG Morgan,0,0,0,0,0,0,0,0,8,5,13,8,5,13,0,234,2,0,1,3.19549,0.233083,30.0526,86.9291,133,4
Australia,228,239.627,7.69737,0.372807,232.079,7.23246,0.337719,916,DA Warner,0,0,0,0,0,0,0,0,16,8,24,16,8,24,235,235,0,1,1,4.20312,0.265625,35.2031,87.7336,64,4
Australia,228,239.627,7.69737,0.372807,232.079,7.23246,0.337719,916,AJ Finch,0,0,0,0,0,0,0,0,16,8,24,16,8,24,235,235,0,1,1,4.52941,0.313725,37.2549,83.4431,51,4
India,259,242.378,7.15058,0.339768,244.568,7.12741,0.30888,917,AM Rahane,0,0,0,0,0,0,0,0,0,6,6,0,6,6,0,153,2,0,1,3.55738,0.262295,32.2295,78.0159,61,4
India,259,242.378,7.15058,0.339768,244.568,7.12741,0.30888,917,S Dhawan,0,0,0,0,0,0,0,0,0,6,6,0,6,6,0,153,2,0,1,5.65217,0.362319,43.2174,88.9088,69,4
India,259,242.378,7.15058,0.339768,244.568,7.12741,0.30888,917,AT Rayudu,0,0,0,0,0,0,0,0,0,6,6,0,6,6,0,153,2,0,1,3.38462,0.269231,35.6923,76.0656,26,4
England,221,237.176,7.17647,0.289593,230.633,7.45701,0.384615,917,IR Bell,0,0,0,0,0,0,0,0,12,17,29,12,17,29,154,156,2,0,1,3.63433,0.246269,35.3806,75.6623,134,4
England,221,237.176,7.17647,0.289593,230.633,7.45701,0.384615,917,MM Ali,0,0,0,0,0,0,0,0,12,17,29,12,17,29,154,156,2,0,1,2.67647,0.117647,21.3824,94.5384,34,0
England,221,237.176,7.17647,0.289593,230.633,7.45701,0.384615,917,JWA Taylor,0,0,0,0,0,0,0,0,12,17,29,12,17,29,154,156,2,0,1,3.375,0.333333,35.9167,79.8888,24,4
England,221,237.176,7.17647,0.289593,230.633,7.45701,0.384615,918,MM Ali,0,0,0,0,0,0,0,0,28,6,34,28,6,34,0,303,0,0,1,2.67647,0.117647,21.3824,94.5384,34,0
England,221,237.176,7.17647,0.289593,230.633,7.45701,0.384615,918,IR Bell,0,0,0,0,0,0,0,0,28,6,34,28,6,34,0,303,0,0,1,3.63433,0.246269,35.3806,75.6623,134,4
Australia,228,239.627,7.69737,0.372807,232.079,7.23246,0.337719,918,AJ Finch,0,0,0,0,0,0,0,0,28,8,36,28,8,36,304,304,3,1,1,4.52941,0.313725,37.2549,83.4431,51,4
Australia,228,239.627,7.69737,0.372807,232.079,7.23246,0.337719,918,SE Marsh,0,0,0,0,0,0,0,0,28,8,36,28,8,36,304,304,3,1,1,3.66667,0.291667,35.5417,74.7918,48,4
Australia,228,239.627,7.69737,0.372807,232.079,7.23246,0.337719,919,AJ Finch,0,0,0,0,0,0,0,0,16,9,25,16,9,25,0,278,0,1,1,4.52941,0.313725,37.2549,83.4431,51,4
Australia,228,239.627,7.69737,0.372807,232.079,7.23246,0.337719,919,SPD Smith,0,0,0,0,0,0,0,0,16,9,25,16,9,25,0,278,0,1,1,3.19298,0.22807,34.5614,87.0526,57,4
Australia,228,239.627,7.69737,0.372807,232.079,7.23246,0.337719,919,DA Warner,0,0,0,0,0,0,0,0,16,9,25,16,9,25,0,278,0,1,1,4.20312,0.265625,35.2031,87.7336,64,4
England,221,237.176,7.17647,0.289593,230.633,7.45701,0.384615,919,MM Ali,0,0,0,0,0,0,0,0,20,4,24,20,4,24,279,166,2,0,1,2.67647,0.117647,21.3824,94.5384,34,0
England,221,237.176,7.17647,0.289593,230.633,7.45701,0.384615,919,IR Bell,0,0,0,0,0,0,0,0,20,4,24,20,4,24,279,166,2,0,1,3.63433,0.246269,35.3806,75.6623,134,4
England,221,237.176,7.17647,0.289593,230.633,7.45701,0.384615,919,JWA Taylor,0,0,0,0,0,0,0,0,20,4,24,20,4,24,279,166,2,0,1,3.375,0.333333,35.9167,79.8888,24,4
Bangladesh,160,218.438,7.70625,0.4,211.106,7.05,0.325,923,Tamim Iqbal,0,0,0,0,0,0,0,0,4,4,8,4,4,8,0,281,0,1,1,4.05344,0.274809,31.8015,76.8068,131,4
Bangladesh,160,218.438,7.70625,0.4,211.106,7.05,0.325,923,Anamul Haque,0,0,0,0,0,0,0,0,4,4,8,4,4,8,0,281,0,1,1,4.12,0.24,36.8,69.6442,25,4
Bangladesh,160,218.438,7.70625,0.4,211.106,7.05,0.325,923,Mominul Haque,0,0,0,0,0,0,0,0,4,4,8,4,4,8,0,281,0,1,1,2.57143,0.0952381,23.3333,73.4633,21,4
Zimbabwe,142,212.077,7.5,0.380282,227.704,6.97887,0.316901,923,H Masakadza,0,0,0,0,0,0,0,0,20,12,32,20,12,32,282,194,11,0,1,3.11215,0.186916,26.972,70.0485,107,4
Zimbabwe,142,212.077,7.5,0.380282,227.704,6.97887,0.316901,923,Sikandar Raza,0,0,0,0,0,0,0,0,20,12,32,20,12,32,282,194,11,0,1,3,0.131579,26.1842,81.1582,38,4
Bangladesh,160,218.438,7.70625,0.4,211.106,7.05,0.325,924,Tamim Iqbal,0,0,0,0,0,0,0,0,12,5,17,12,5,17,0,251,1,1,1,4.05344,0.274809,31.8015,76.8068,131,4
Bangladesh,160,218.438,7.70625,0.4,211.106,7.05,0.325,924,Anamul Haque,0,0,0,0,0,0,0,0,12,5,17,12,5,17,0,251,1,1,1,4.12,0.24,36.8,69.6442,25,4
Zimbabwe,142,212.077,7.5,0.380282,227.704,6.97887,0.316901,924,H Masakadza,0,0,0,0,0,0,0,0,14,8,22,14,8,22,252,183,1,0,1,3.11215,0.186916,26.972,70.0485,107,4
Zimbabwe,142,212.077,7.5,0.380282,227.704,6.97887,0.316901,924,Sikandar Raza,0,0,0,0,0,0,0,0,14,8,22,14,8,22,252,183,1,0,1,3,0.131579,26.1842,81.1582,38,4
Zimbabwe,142,212.077,7.5,0.380282,227.704,6.97887,0.316901,924,V Sibanda,0,0,0,0,0,0,0,0,14,8,22,14,8,22,252,183,1,0,1,2.9697,0.181818,23.5152,63.5545,66,1
Bangladesh,160,218.438,7.70625,0.4,211.106,7.05,0.325,925,Tamim Iqbal,0,0,0,0,0,0,0,0,10,5,15,10,5,15,0,297,4,1,1,4.05344,0.274809,31.8015,76.8068,131,4
Bangladesh,160,218.438,7.70625,0.4,211.106,7.05,0.325,925,Anamul Haque,0,0,0,0,0,0,0,0,10,5,15,10,5,15,0,297,4,1,1,4.12,0.24,36.8,69.6442,25,4
Zimbabwe,142,212.077,7.5,0.380282,227.704,6.97887,0.316901,925,H Masakadza,0,0,0,0,0,0,0,0,22,3,25,22,3,25,298,173,1,0,1,3.11215,0.186916,26.972,70.0485,107,4
Zimbabwe,142,212.077,7.5,0.380282,227.704,6.97887,0.316901,925,V Sibanda,0,0,0,0,0,0,0,0,22,3,25,22,3,25,298,173,1,0,1,2.9697,0.181818,23.5152,63.5545,66,1
Zimbabwe,142,212.077,7.5,0.380282,227.704,6.97887,0.316901,925,T Maruma,0,0,0,0,0,0,0,0,22,3,25,22,3,25,298,173,1,0,1,0.5,0,5.5,38.3721,12,3
Zimbabwe,142,212.077,7.5,0.380282,227.704,6.97887,0.316901,925,BRM Taylor,0,0,0,0,0,0,0,0,22,3,25,22,3,25,298,173,1,0,1,3.3,0.26,33.56,76.3421,100,4
Bangladesh,160,218.438,7.70625,0.4,211.106,7.05,0.325,926,Tamim Iqbal,0,0,0,0,0,0,0,0,8,6,14,8,6,14,0,256,4,1,1,4.05344,0.274809,31.8015,76.8068,131,4
Bangladesh,160,218.438,7.70625,0.4,211.106,7.05,0.325,926,Anamul Haque,0,0,0,0,0,0,0,0,8,6,14,8,6,14,0,256,4,1,1,4.12,0.24,36.8,69.6442,25,4
Zimbabwe,142,212.077,7.5,0.380282,227.704,6.97887,0.316901,926,H Masakadza,0,0,0,0,0,0,0,0,16,7,23,16,7,23,257,235,3,0,1,3.11215,0.186916,26.972,70.0485,107,4
Zimbabwe,142,212.077,7.5,0.380282,227.704,6.97887,0.316901,926,V Sibanda,0,0,0,0,0,0,0,0,16,7,23,16,7,23,257,235,3,0,1,2.9697,0.181818,23.5152,63.5545,66,1
Zimbabwe,142,212.077,7.5,0.380282,227.704,6.97887,0.316901,927,H Masakadza,0,0,0,0,0,0,0,0,12,5,17,12,5,17,0,128,1,0,1,3.11215,0.186916,26.972,70.0485,107,4
Zimbabwe,142,212.077,7.5,0.380282,227.704,6.97887,0.316901,927,Sikandar Raza,0,0,0,0,0,0,0,0,12,5,17,12,5,17,0,128,1,0,1,3,0.131579,26.1842,81.1582,38,4
Zimbabwe,142,212.077,7.5,0.380282,227.704,6.97887,0.316901,927,V Sibanda,0,0,0,0,0,0,0,0,12,5,17,12,5,17,0,128,1,0,1,2.9697,0.181818,23.5152,63.5545,66,1
Bangladesh,160,218.438,7.70625,0.4,211.106,7.05,0.325,927,Tamim Iqbal,0,0,0,0,0,0,0,0,20,3,23,20,3,23,129,130,4,1,1,4.05344,0.274809,31.8015,76.8068,131,4
Bangladesh,160,218.438,7.70625,0.4,211.106,7.05,0.325,927,Anamul Haque,0,0,0,0,0,0,0,0,20,3,23,20,3,23,129,130,4,1,1,4.12,0.24,36.8,69.6442,25,4
Bangladesh,160,218.438,7.70625,0.4,211.106,7.05,0.325,927,Soumya Sarkar,0,0,0,0,0,0,0,0,20,3,23,20,3,23,129,130,4,1,1,7.35714,0.357143,47.2857,99.1018,14,4
India,259,242.378,7.15058,0.339768,244.568,7.12741,0.30888,928,AM Rahane,0,0,0,0,0,0,0,0,8,5,13,8,5,13,0,263,3,1,1,3.55738,0.262295,32.2295,78.0159,61,4
India,259,242.378,7.15058,0.339768,244.568,7.12741,0.30888,928,S Dhawan,0,0,0,0,0,0,0,0,8,5,13,8,5,13,0,263,3,1,1,5.65217,0.362319,43.2174,88.9088,69,4
India,259,242.378,7.15058,0.339768,244.568,7.12741,0.30888,928,AT Rayudu,0,0,0,0,0,0,0,0,8,5,13,8,5,13,0,263,3,1,1,3.38462,0.269231,35.6923,76.0656,26,4
West Indies,176,217.33,7.15909,0.3125,225.278,7.57386,0.380682,928,DR Smith,0,0,0,0,0,0,0,0,4,15,19,4,15,19,264,215,0,0,1,2.5,0.12,17.96,84.5574,50,1
West Indies,176,217.33,7.15909,0.3125,225.278,7.57386,0.380682,928,DM Bravo,0,0,0,0,0,0,0,0,4,15,19,4,15,19,264,215,0,0,1,3,0.226667,28.52,67.4551,75,4
India,259,242.378,7.15058,0.339768,244.568,7.12741,0.30888,929,AM Rahane,0,0,0,0,0,0,0,0,8,10,18,8,10,18,0,330,2,1,1,3.55738,0.262295,32.2295,78.0159,61,4
India,259,242.378,7.15058,0.339768,244.568,7.12741,0.30888,929,S Dhawan,0,0,0,0,0,0,0,0,8,10,18,8,10,18,0,330,2,1,1,5.65217,0.362319,43.2174,88.9088,69,4
West Indies,176,217.33,7.15909,0.3125,225.278,7.57386,0.380682,929,DR Smith,0,0,0,0,0,0,0,0,4,5,9,4,5,9,331,271,2,0,1,2.5,0.12,17.96,84.5574,50,1
West Indies,176,217.33,7.15909,0.3125,225.278,7.57386,0.380682,929,DM Bravo,0,0,0,0,0,0,0,0,4,5,9,4,5,9,331,271,2,0,1,3,0.226667,28.52,67.4551,75,4
West Indies,176,217.33,7.15909,0.3125,225.278,7.57386,0.380682,929,KA Pollard,0,0,0,0,0,0,0,0,4,5,9,4,5,9,331,271,2,0,1,2.70513,0.115385,24.5,88.0645,78,4
India,259,242.378,7.15058,0.339768,244.568,7.12741,0.30888,930,AM Rahane,0,0,0,0,0,0,0,0,8,4,12,8,4,12,0,363,2,1,1,3.55738,0.262295,32.2295,78.0159,61,4
India,259,242.378,7.15058,0.339768,244.568,7.12741,0.30888,930,S Dhawan,0,0,0,0,0,0,0,0,8,4,12,8,4,12,0,363,2,1,1,5.65217,0.362319,43.2174,88.9088,69,4
Sri Lanka,244,223.373,7.09016,0.344262,227.578,7.47541,0.385246,930,WU Tharanga,0,0,0,0,0,0,0,0,4,13,17,4,13,17,364,194,5,0,1,3.93985,0.263158,32.9699,71.6035,133,4
Sri Lanka,244,223.373,7.09016,0.344262,227.578,7.47541,0.385246,930,TM Dilshan,0,0,0,0,0,0,0,0,4,13,17,4,13,17,364,194,5,0,1,4.60199,0.273632,38.3632,86.0219,201,4
Sri Lanka,244,223.373,7.09016,0.344262,227.578,7.47541,0.385246,931,MDKJ Perera,0,0,0,0,0,0,0,0,8,7,15,8,7,15,0,274,6,0,1,3.30435,0.195652,25.7391,90.5199,46,0
Sri Lanka,244,223.373,7.09016,0.344262,227.578,7.47541,0.385246,931,TM Dilshan,0,0,0,0,0,0,0,0,8,7,15,8,7,15,0,274,6,0,1,4.60199,0.273632,38.3632,86.0219,201,4
Sri Lanka,244,223.373,7.09016,0.344262,227.578,7.47541,0.385246,931,KC Sangakkara,0,0,0,0,0,0,0,0,8,7,15,8,7,15,0,274,6,0,1,4.33659,0.360976,41.9854,80.6276,205,4
India,259,242.378,7.15058,0.339768,244.568,7.12741,0.30888,931,AM Rahane,0,0,0,0,0,0,0,0,4,9,13,4,9,13,275,275,0,1,1,3.55738,0.262295,32.2295,78.0159,61,4
India,259,242.378,7.15058,0.339768,244.568,7.12741,0.30888,931,S Dhawan,0,0,0,0,0,0,0,0,4,9,13,4,9,13,275,275,0,1,1,5.65217,0.362319,43.2174,88.9088,69,4
Sri Lanka,244,223.373,7.09016,0.344262,227.578,7.47541,0.385246,932,MDKJ Perera,0,0,0,0,0,0,0,0,20,3,23,20,3,23,0,242,2,0,1,3.30435,0.195652,25.7391,90.5199,46,0
Sri Lanka,244,223.373,7.09016,0.344262,227.578,7.47541,0.385246,932,TM Dilshan,0,0,0,0,0,0,0,0,20,3,23,20,3,23,0,242,2,0,1,4.60199,0.273632,38.3632,86.0219,201,4
Sri Lanka,244,223.373,7.09016,0.344262,227.578,7.47541,0.385246,932,KC Sangakkara,0,0,0,0,0,0,0,0,20,3,23,20,3,23,0,242,2,0,1,4.33659,0.360976,41.9854,80.6276,205,4
Sri Lanka,244,223.373,7.09016,0.344262,227.578,7.47541,0.385246,932,DPMD Jayawardene,0,0,0,0,0,0,0,0,20,3,23,20,3,23,0,242,2,0,1,3.20833,0.244792,31.6979,79.1109,192,4
India,259,242.378,7.15058,0.339768,244.568,7.12741,0.30888,932,AM Rahane,0,0,0,0,0,0,0,0,16,7,23,16,7,23,243,245,0,1,1,3.55738,0.262295,32.2295,78.0159,61,4
India,259,242.378,7.15058,0.339768,244.568,7.12741,0.30888,932,S Dhawan,0,0,0,0,0,0,0,0,16,7,23,16,7,23,243,245,0,1,1,5.65217,0.362319,43.2174,88.9088,69,4
India,259,242.378,7.15058,0.339768,244.568,7.12741,0.30888,933,AM Rahane,0,0,0,0,0,0,0,0,16,8,24,16,8,24,0,404,0,1,1,3.55738,0.262295,32.2295,78.0159,61,4
India,259,242.378,7.15058,0.339768,244.568,7.12741,0.30888,933,RG Sharma,0,0,0,0,0,0,0,0,16,8,24,16,8,24,0,404,0,1,1,3.82836,0.268657,35.9179,83.083,134,4
Sri Lanka,244,223.373,7.09016,0.344262,227.578,7.47541,0.385246,933,MDKJ Perera,0,0,0,0,0,0,0,0,20,4,24,20,4,24,405,251,1,0,1,3.30435,0.195652,25.7391,90.5199,46,0
Sri Lanka,244,223.373,7.09016,0.344262,227.578,7.47541,0.385246,933,TM Dilshan,0,0,0,0,0,0,0,0,20,4,24,20,4,24,405,251,1,0,1,4.60199,0.273632,38.3632,86.0219,201,4
Sri Lanka,244,223.373,7.09016,0.344262,227.578,7.47541,0.385246,933,LD Chandimal,0,0,0,0,0,0,0,0,20,4,24,20,4,24,405,251,1,0,1,2.18478,0.184783,25.7391,73.8615,92,4
Sri Lanka,244,223.373,7.09016,0.344262,227.578,7.47541,0.385246,934,TM Dilshan,0,0,0,0,0,0,0,0,20,11,31,20,11,31,0,286,6,0,1,4.60199,0.273632,38.3632,86.0219,201,4
Sri Lanka,244,223.373,7.09016,0.344262,227.578,7.47541,0.385246,934,LD Chandimal,0,0,0,0,0,0,0,0,20,11,31,20,11,31,0,286,6,0,1,2.18478,0.184783,25.7391,73.8615,92,4
India,259,242.378,7.15058,0.339768,244.568,7.12741,0.30888,934,AM Rahane,0,0,0,0,0,0,0,0,8,5,13,8,5,13,287,288,1,1,1,3.55738,0.262295,32.2295,78.0159,61,4
India,259,242.378,7.15058,0.339768,244.568,7.12741,0.30888,934,RG Sharma,0,0,0,0,0,0,0,0,8,5,13,8,5,13,287,288,1,1,1,3.82836,0.268657,35.9179,83.083,134,4
India,259,242.378,7.15058,0.339768,244.568,7.12741,0.30888,934,AT Rayudu,0,0,0,0,0,0,0,0,8,5,13,8,5,13,287,288,1,1,1,3.38462,0.269231,35.6923,76.0656,26,4
India,259,242.378,7.15058,0.339768,244.568,7.12741,0.30888,934,V Kohli,0,0,0,0,0,0,0,0,8,5,13,8,5,13,287,288,1,1,1,4.66456,0.379747,44.9937,88.3325,158,4
England,221,237.176,7.17647,0.289593,230.633,7.45701,0.384615,935,JJ Roy,0,0,0,0,0,0,0,0,24,14,38,24,14,38,0,399,2,0,1,4.36842,0.210526,29.3684,95.3846,19,0
England,221,237.176,7.17647,0.289593,230.633,7.45701,0.384615,935,AD Hales,0,0,0,0,0,0,0,0,24,14,38,24,14,38,0,399,2,0,1,4.2963,0.296296,34.1111,85.1201,27,4
South Africa,190,234.274,7.4,0.373684,232.363,7.33158,0.342105,935,Q de Kock,0,0,0,0,0,0,0,0,16,13,29,16,13,29,400,250,1,1,1,5.12963,0.240741,39.1111,91.2311,54,4
South Africa,190,234.274,7.4,0.373684,232.363,7.33158,0.342105,935,HM Amla,0,0,0,0,0,0,0,0,16,13,29,16,13,29,400,250,1,1,1,5.20168,0.403361,48.7899,86.9292,119,4
South Africa,190,234.274,7.4,0.373684,232.363,7.33158,0.342105,935,F du Plessis,0,0,0,0,0,0,0,0,16,13,29,16,13,29,400,250,1,1,1,3.45122,0.292683,34.9268,83.135,82,4
South Africa,190,234.274,7.4,0.373684,232.363,7.33158,0.342105,936,HM Amla,0,0,0,0,0,0,0,0,8,2,10,8,2,10,0,262,0,1,1,5.20168,0.403361,48.7899,86.9292,119,4
South Africa,190,234.274,7.4,0.373684,232.363,7.33158,0.342105,936,Q de Kock,0,0,0,0,0,0,0,0,8,2,10,8,2,10,0,262,0,1,1,5.12963,0.240741,39.1111,91.2311,54,4
South Africa,190,234.274,7.4,0.373684,232.363,7.33158,0.342105,936,F du Plessis,0,0,0,0,0,0,0,0,8,2,10,8,2,10,0,262,0,1,1,3.45122,0.292683,34.9268,83.135,82,4
England,221,237.176,7.17647,0.289593,230.633,7.45701,0.384615,936,JJ Roy,0,0,0,0,0,0,0,0,16,7,23,16,7,23,263,263,0,0,1,4.36842,0.210526,29.3684,95.3846,19,0
England,221,237.176,7.17647,0.289593,230.633,7.45701,0.384615,936,AD Hales,0,0,0,0,0,0,0,0,16,7,23,16,7,23,263,263,0,0,1,4.2963,0.296296,34.1111,85.1201,27,4
England,221,237.176,7.17647,0.289593,230.633,7.45701,0.384615,936,JE Root,0,0,0,0,0,0,0,0,16,7,23,16,7,23,263,263,0,0,1,3.68852,0.327869,41.6721,83.3443,61,4
England,221,237.176,7.17647,0.289593,230.633,7.45701,0.384615,937,JJ Roy,0,0,0,0,0,0,0,0,12,5,17,12,5,17,0,262,1,0,1,4.36842,0.210526,29.3684,95.3846,19,0
England,221,237.176,7.17647,0.289593,230.633,7.45701,0.384615,937,AD Hales,0,0,0,0,0,0,0,0,12,5,17,12,5,17,0,262,1,0,1,4.2963,0.296296,34.1111,85.1201,27,4
South Africa,190,234.274,7.4,0.373684,232.363,7.33158,0.342105,937,HM Amla,0,0,0,0,0,0,0,0,8,12,20,8,12,20,263,266,1,1,1,5.20168,0.403361,48.7899,86.9292,119,4
South Africa,190,234.274,7.4,0.373684,232.363,7.33158,0.342105,937,Q de Kock,0,0,0,0,0,0,0,0,8,12,20,8,12,20,263,266,1,1,1,5.12963,0.240741,39.1111,91.2311,54,4
South Africa,190,234.274,7.4,0.373684,232.363,7.33158,0.342105,937,F du Plessis,0,0,0,0,0,0,0,0,8,12,20,8,12,20,263,266,1,1,1,3.45122,0.292683,34.9268,83.135,82,4
England,221,237.176,7.17647,0.289593,230.633,7.45701,0.384615,938,JJ Roy,0,0,0,0,0,0,0,0,0,13,13,0,13,13,0,236,2,0,1,4.36842,0.210526,29.3684,95.3846,19,0
England,221,237.176,7.17647,0.289593,230.633,7.45701,0.384615,938,AD Hales,0,0,0,0,0,0,0,0,0,13,13,0,13,13,0,236,2,0,1,4.2963,0.296296,34.1111,85.1201,27,4
South Africa,190,234.274,7.4,0.373684,232.363,7.33158,0.342105,938,Q de Kock,0,0,0,0,0,0,0,0,8,3,11,8,3,11,237,237,3,1,1,5.12963,0.240741,39.1111,91.2311,54,4
South Africa,190,234.274,7.4,0.373684,232.363,7.33158,0.342105,938,HM Amla,0,0,0,0,0,0,0,0,8,3,11,8,3,11,237,237,3,1,1,5.20168,0.403361,48.7899,86.9292,119,4
Bangladesh,160,218.438,7.70625,0.4,211.106,7.05,0.325,945,Tamim Iqbal,0,0,0,0,0,0,0,0,12,4,16,12,4,16,0,160,8,1,1,4.05344,0.274809,31.8015,76.8068,131,4
Bangladesh,160,218.438,7.70625,0.4,211.106,7.05,0.325,945,Soumya Sarkar,0,0,0,0,0,0,0,0,12,4,16,12,4,16,0,160,8,1,1,7.35714,0.357143,47.2857,99.1018,14,4
Bangladesh,160,218.438,7.70625,0.4,211.106,7.05,0.325,945,Liton Das,0,0,0,0,0,0,0,0,12,4,16,12,4,16,0,160,8,1,1,1,0,7.66667,69.697,6,1
Bangladesh,160,218.438,7.70625,0.4,211.106,7.05,0.325,945,Mahmudullah,0,0,0,0,0,0,0,0,12,4,16,12,4,16,0,160,8,1,1,2.26531,0.153061,24.4286,70.9544,98,4
Bangladesh,160,218.438,7.70625,0.4,211.106,7.05,0.325,945,Shakib Al Hasan,0,0,0,0,0,0,0,0,12,4,16,12,4,16,0,160,8,1,1,2.86992,0.252033,29.9106,79.0163,123,4
South Africa,190,234.274,7.4,0.373684,232.363,7.33158,0.342105,945,Q de Kock,0,0,0,0,0,0,0,0,8,9,17,8,9,17,161,164,4,0,1,5.12963,0.240741,39.1111,91.2311,54,4
South Africa,190,234.274,7.4,0.373684,232.363,7.33158,0.342105,945,HM Amla,0,0,0,0,0,0,0,0,8,9,17,8,9,17,161,164,4,0,1,5.20168,0.403361,48.7899,86.9292,119,4
South Africa,190,234.274,7.4,0.373684,232.363,7.33158,0.342105,946,Q de Kock,0,0,0,0,0,0,0,0,8,9,17,8,9,17,0,168,0,0,1,5.12963,0.240741,39.1111,91.2311,54,4
South Africa,190,234.274,7.4,0.373684,232.363,7.33158,0.342105,946,HM Amla,0,0,0,0,0,0,0,0,8,9,17,8,9,17,0,168,0,0,1,5.20168,0.403361,48.7899,86.9292,119,4
South Africa,190,234.274,7.4,0.373684,232.363,7.33158,0.342105,946,F du Plessis,0,0,0,0,0,0,0,0,8,9,17,8,9,17,0,168,0,0,1,3.45122,0.292683,34.9268,83.135,82,4
Bangladesh,160,218.438,7.70625,0.4,211.106,7.05,0.325,946,Tamim Iqbal,0,0,0,0,0,0,0,0,8,14,22,8,14,22,169,170,4,1,1,4.05344,0.274809,31.8015,76.8068,131,4
Bangladesh,160,218.438,7.70625,0.4,211.106,7.05,0.325,946,Soumya Sarkar,0,0,0,0,0,0,0,0,8,14,22,8,14,22,169,170,4,1,1,7.35714,0.357143,47.2857,99.1018,14,4
South Africa,190,234.274,7.4,0.373684,232.363,7.33158,0.342105,947,MN van Wyk,0,0,0,0,0,0,0,0,14,7,21,14,7,21,0,304,4,1,1,3.33333,0.266667,27.2,66.9951,15,4
South Africa,190,234.274,7.4,0.373684,232.363,7.33158,0.342105,947,HM Amla,0,0,0,0,0,0,0,0,14,7,21,14,7,21,0,304,4,1,1,5.20168,0.403361,48.7899,86.9292,119,4
New Zealand,184,233.745,7.39674,0.36413,227.951,7.30435,0.353261,947,TWM Latham,0,0,0,0,0,0,0,0,6,11,17,6,11,17,305,284,1,0,1,2.76471,0.147059,25.3529,75.2182,34,4
New Zealand,184,233.745,7.39674,0.36413,227.951,7.30435,0.353261,947,L Ronchi,0,0,0,0,0,0,0,0,6,11,17,6,11,17,305,284,1,0,1,2.92157,0.0784314,22.1961,115.392,51,0
New Zealand,184,233.745,7.39674,0.36413,227.951,7.30435,0.353261,947,KS Williamson,0,0,0,0,0,0,0,0,6,11,17,6,11,17,305,284,1,0,1,4.31707,0.390244,43.0488,82.8833,82,4
South Africa,190,234.274,7.4,0.373684,232.363,7.33158,0.342105,948,HM Amla,0,0,0,0,0,0,0,0,16,4,20,16,4,20,0,204,0,1,1,5.20168,0.403361,48.7899,86.9292,119,4
South Africa,190,234.274,7.4,0.373684,232.363,7.33158,0.342105,948,MN van Wyk,0,0,0,0,0,0,0,0,16,4,20,16,4,20,0,204,0,1,1,3.33333,0.266667,27.2,66.9951,15,4
South Africa,190,234.274,7.4,0.373684,232.363,7.33158,0.342105,948,RR Rossouw,0,0,0,0,0,0,0,0,16,4,20,16,4,20,0,204,0,1,1,3.80769,0.230769,31.3846,93.1507,26,0
New Zealand,184,233.745,7.39674,0.36413,227.951,7.30435,0.353261,948,MJ Guptill,0,0,0,0,0,0,0,0,20,4,24,20,4,24,205,207,1,0,1,4.8087,0.313043,38.1217,82.7482,115,4
New Zealand,184,233.745,7.39674,0.36413,227.951,7.30435,0.353261,948,TWM Latham,0,0,0,0,0,0,0,0,20,4,24,20,4,24,205,207,1,0,1,2.76471,0.147059,25.3529,75.2182,34,4
South Africa,190,234.274,7.4,0.373684,232.363,7.33158,0.342105,949,MN van Wyk,0,0,0,0,0,0,0,0,18,5,23,18,5,23,0,283,2,1,1,3.33333,0.266667,27.2,66.9951,15,4
South Africa,190,234.274,7.4,0.373684,232.363,7.33158,0.342105,949,HM Amla,0,0,0,0,0,0,0,0,18,5,23,18,5,23,0,283,2,1,1,5.20168,0.403361,48.7899,86.9292,119,4
New Zealand,184,233.745,7.39674,0.36413,227.951,7.30435,0.353261,949,MJ Guptill,0,0,0,0,0,0,0,0,8,9,17,8,9,17,284,221,1,0,1,4.8087,0.313043,38.1217,82.7482,115,4
New Zealand,184,233.745,7.39674,0.36413,227.951,7.30435,0.353261,949,TWM Latham,0,0,0,0,0,0,0,0,8,9,17,8,9,17,284,221,1,0,1,2.76471,0.147059,25.3529,75.2182,34,4
New Zealand,184,233.745,7.39674,0.36413,227.951,7.30435,0.353261,949,KS Williamson,0,0,0,0,0,0,0,0,8,9,17,8,9,17,284,221,1,0,1,4.31707,0.390244,43.0488,82.8833,82,4
Bangladesh,160,218.438,7.70625,0.4,211.106,7.05,0.325,950,Tamim Iqbal,0,0,0,0,0,0,0,0,12,9,21,12,9,21,0,329,1,1,1,4.05344,0.274809,31.8015,76.8068,131,4
Bangladesh,160,218.438,7.70625,0.4,211.106,7.05,0.325,950,Soumya Sarkar,0,0,0,0,0,0,0,0,12,9,21,12,9,21,0,329,1,1,1,7.35714,0.357143,47.2857,99.1018,14,4
Pakistan,211,222.621,7.38389,0.393365,235.517,7.54976,0.336493,950,Azhar Ali,0,0,0,0,0,0,0,0,16,10,26,16,10,26,330,250,4,0,1,3.83333,0.3,38.5333,73.6775,30,4
Pakistan,211,222.621,7.38389,0.393365,235.517,7.54976,0.336493,950,Sarfraz Ahmed,0,0,0,0,0,0,0,0,16,10,26,16,10,26,330,250,4,0,1,2.04878,0.097561,25.4878,83.9357,41,4
Pakistan,211,222.621,7.38389,0.393365,235.517,7.54976,0.336493,951,Azhar Ali,0,0,0,0,0,0,0,0,8,10,18,8,10,18,0,239,2,0,1,3.83333,0.3,38.5333,73.6775,30,4
Pakistan,211,222.621,7.38389,0.393365,235.517,7.54976,0.336493,951,Sarfraz Ahmed,0,0,0,0,0,0,0,0,8,10,18,8,10,18,0,239,2,0,1,2.04878,0.097561,25.4878,83.9357,41,4
Bangladesh,160,218.438,7.70625,0.4,211.106,7.05,0.325,951,Tamim Iqbal,0,0,0,0,0,0,0,0,36,1,37,36,1,37,240,240,1,1,1,4.05344,0.274809,31.8015,76.8068,131,4
Bangladesh,160,218.438,7.70625,0.4,211.106,7.05,0.325,951,Soumya Sarkar,0,0,0,0,0,0,0,0,36,1,37,36,1,37,240,240,1,1,1,7.35714,0.357143,47.2857,99.1018,14,4
Bangladesh,160,218.438,7.70625,0.4,211.106,7.05,0.325,951,Mahmudullah,0,0,0,0,0,0,0,0,36,1,37,36,1,37,240,240,1,1,1,2.26531,0.153061,24.4286,70.9544,98,4
Pakistan,211,222.621,7.38389,0.393365,235.517,7.54976,0.336493,952,Azhar Ali,0,0,0,0,0,0,0,0,16,11,27,16,11,27,0,250,2,0,1,3.83333,0.3,38.5333,73.6775,30,4
Pakistan,211,222.621,7.38389,0.393365,235.517,7.54976,0.336493,952,Sami Aslam,0,0,0,0,0,0,0,0,16,11,27,16,11,27,0,250,2,0,1,7,0,44,84.6154,1,4
Bangladesh,160,218.438,7.70625,0.4,211.106,7.05,0.325,952,Tamim Iqbal,0,0,0,0,0,0,0,0,16,5,21,16,5,21,251,251,2,1,1,4.05344,0.274809,31.8015,76.8068,131,4
Bangladesh,160,218.438,7.70625,0.4,211.106,7.05,0.325,952,Soumya Sarkar,0,0,0,0,0,0,0,0,16,5,21,16,5,21,251,251,2,1,1,7.35714,0.357143,47.2857,99.1018,14,4
Sri Lanka,244,223.373,7.09016,0.344262,227.578,7.47541,0.385246,953,MDKJ Perera,0,0,0,0,0,0,0,0,4,7,11,4,7,11,0,255,7,1,1,3.30435,0.195652,25.7391,90.5199,46,0
Sri Lanka,244,223.373,7.09016,0.344262,227.578,7.47541,0.385246,953,TM Dilshan,0,0,0,0,0,0,0,0,4,7,11,4,7,11,0,255,7,1,1,4.60199,0.273632,38.3632,86.0219,201,4
Pakistan,211,222.621,7.38389,0.393365,235.517,7.54976,0.336493,953,Azhar Ali,0,0,0,0,0,0,0,0,16,8,24,16,8,24,256,259,0,0,1,3.83333,0.3,38.5333,73.6775,30,4
Pakistan,211,222.621,7.38389,0.393365,235.517,7.54976,0.336493,953,Ahmed Shehzad,0,0,0,0,0,0,0,0,16,8,24,16,8,24,256,259,0,0,1,3.67143,0.242857,33.2714,70.8118,70,4
Pakistan,211,222.621,7.38389,0.393365,235.517,7.54976,0.336493,954,Azhar Ali,0,0,0,0,0,0,0,0,0,11,11,0,11,11,0,287,5,0,1,3.83333,0.3,38.5333,73.6775,30,4
Pakistan,211,222.621,7.38389,0.393365,235.517,7.54976,0.336493,954,Ahmed Shehzad,0,0,0,0,0,0,0,0,0,11,11,0,11,11,0,287,5,0,1,3.67143,0.242857,33.2714,70.8118,70,4
Sri Lanka,244,223.373,7.09016,0.344262,227.578,7.47541,0.385246,954,MDKJ Perera,0,0,0,0,0,0,0,0,58,5,63,58,5,63,288,288,2,1,1,3.30435,0.195652,25.7391,90.5199,46,0
Sri Lanka,244,223.373,7.09016,0.344262,227.578,7.47541,0.385246,954,TM Dilshan,0,0,0,0,0,0,0,0,58,5,63,58,5,63,288,288,2,1,1,4.60199,0.273632,38.3632,86.0219,201,4
Sri Lanka,244,223.373,7.09016,0.344262,227.578,7.47541,0.385246,955,MDKJ Perera,0,0,0,0,0,0,0,0,20,6,26,20,6,26,0,256,3,1,1,3.30435,0.195652,25.7391,90.5199,46,0
Sri Lanka,244,223.373,7.09016,0.344262,227.578,7.47541,0.385246,955,TM Dilshan,0,0,0,0,0,0,0,0,20,6,26,20,6,26,0,256,3,1,1,4.60199,0.273632,38.3632,86.0219,201,4
Sri Lanka,244,223.373,7.09016,0.344262,227.578,7.47541,0.385246,955,HDRL Thirimanne,0,0,0,0,0,0,0,0,20,6,26,20,6,26,0,256,3,1,1,2.77778,0.246914,31.5802,71.4725,81,4
Pakistan,211,222.621,7.38389,0.393365,235.517,7.54976,0.336493,955,Azhar Ali,0,0,0,0,0,0,0,0,20,16,36,20,16,36,257,257,0,0,1,3.83333,0.3,38.5333,73.6775,30,4
Pakistan,211,222.621,7.38389,0.393365,235.517,7.54976,0.336493,955,Ahmed Shehzad,0,0,0,0,0,0,0,0,20,16,36,20,16,36,257,257,0,0,1,3.67143,0.242857,33.2714,70.8118,70,4
Sri Lanka,244,223.373,7.09016,0.344262,227.578,7.47541,0.385246,956,MDKJ Perera,0,0,0,0,0,0,0,0,12,10,22,12,10,22,0,368,0,1,1,3.30435,0.195652,25.7391,90.5199,46,0
Sri Lanka,244,223.373,7.09016,0.344262,227.578,7.47541,0.385246,956,TM Dilshan,0,0,0,0,0,0,0,0,12,10,22,12,10,22,0,368,0,1,1,4.60199,0.273632,38.3632,86.0219,201,4
Pakistan,211,222.621,7.38389,0.393365,235.517,7.54976,0.336493,956,Azhar Ali,0,0,0,0,0,0,0,0,4,10,14,4,10,14,369,203,3,0,1,3.83333,0.3,38.5333,73.6775,30,4
Pakistan,211,222.621,7.38389,0.393365,235.517,7.54976,0.336493,956,Ahmed Shehzad,0,0,0,0,0,0,0,0,4,10,14,4,10,14,369,203,3,0,1,3.67143,0.242857,33.2714,70.8118,70,4
Pakistan,211,222.621,7.38389,0.393365,235.517,7.54976,0.336493,957,Mohammad Hafeez,0,0,0,0,0,0,0,0,0,8,8,0,8,8,0,375,0,1,1,4.04511,0.255639,34.3534,78.0625,133,4
Pakistan,211,222.621,7.38389,0.393365,235.517,7.54976,0.336493,957,Azhar Ali,0,0,0,0,0,0,0,0,0,8,8,0,8,8,0,375,0,1,1,3.83333,0.3,38.5333,73.6775,30,4
Zimbabwe,142,212.077,7.5,0.380282,227.704,6.97887,0.316901,957,V Sibanda,0,0,0,0,0,0,0,0,16,11,27,16,11,27,376,334,0,0,1,2.9697,0.181818,23.5152,63.5545,66,1
Zimbabwe,142,212.077,7.5,0.380282,227.704,6.97887,0.316901,957,Sikandar Raza,0,0,0,0,0,0,0,0,16,11,27,16,11,27,376,334,0,0,1,3,0.131579,26.1842,81.1582,38,4
Zimbabwe,142,212.077,7.5,0.380282,227.704,6.97887,0.316901,958,V Sibanda,0,0,0,0,0,0,0,0,8,5,13,8,5,13,0,268,2,0,1,2.9697,0.181818,23.5152,63.5545,66,1
Zimbabwe,142,212.077,7.5,0.380282,227.704,6.97887,0.316901,958,CJ Chibhabha,0,0,0,0,0,0,0,0,8,5,13,8,5,13,0,268,2,0,1,2.56716,0.149254,23.5373,64.7373,67,1
Pakistan,211,222.621,7.38389,0.393365,235.517,7.54976,0.336493,958,Azhar Ali,0,0,0,0,0,0,0,0,8,10,18,8,10,18,269,269,1,1,1,3.83333,0.3,38.5333,73.6775,30,4
Pakistan,211,222.621,7.38389,0.393365,235.517,7.54976,0.336493,958,Sarfraz Ahmed,0,0,0,0,0,0,0,0,8,10,18,8,10,18,269,269,1,1,1,2.04878,0.097561,25.4878,83.9357,41,4
Bangladesh,160,218.438,7.70625,0.4,211.106,7.05,0.325,959,Tamim Iqbal,0,0,0,0,0,0,0,0,8,17,25,8,17,25,0,307,2,1,1,4.05344,0.274809,31.8015,76.8068,131,4
Bangladesh,160,218.438,7.70625,0.4,211.106,7.05,0.325,959,Soumya Sarkar,0,0,0,0,0,0,0,0,8,17,25,8,17,25,0,307,2,1,1,7.35714,0.357143,47.2857,99.1018,14,4
India,259,242.378,7.15058,0.339768,244.568,7.12741,0.30888,959,RG Sharma,0,0,0,0,0,0,0,0,4,15,19,4,15,19,308,228,9,0,1,3.82836,0.268657,35.9179,83.083,134,4
India,259,242.378,7.15058,0.339768,244.568,7.12741,0.30888,959,S Dhawan,0,0,0,0,0,0,0,0,4,15,19,4,15,19,308,228,9,0,1,5.65217,0.362319,43.2174,88.9088,69,4
India,259,242.378,7.15058,0.339768,244.568,7.12741,0.30888,960,RG Sharma,0,0,0,0,0,0,0,0,16,7,23,16,7,23,0,200,5,0,1,3.82836,0.268657,35.9179,83.083,134,4
India,259,242.378,7.15058,0.339768,244.568,7.12741,0.30888,960,V Kohli,0,0,0,0,0,0,0,0,16,7,23,16,7,23,0,200,5,0,1,4.66456,0.379747,44.9937,88.3325,158,4
India,259,242.378,7.15058,0.339768,244.568,7.12741,0.30888,960,S Dhawan,0,0,0,0,0,0,0,0,16,7,23,16,7,23,0,200,5,0,1,5.65217,0.362319,43.2174,88.9088,69,4
Bangladesh,160,218.438,7.70625,0.4,211.106,7.05,0.325,960,Tamim Iqbal,0,0,0,0,0,0,0,0,20,9,29,20,9,29,201,200,4,1,1,4.05344,0.274809,31.8015,76.8068,131,4
Bangladesh,160,218.438,7.70625,0.4,211.106,7.05,0.325,960,Soumya Sarkar,0,0,0,0,0,0,0,0,20,9,29,20,9,29,201,200,4,1,1,7.35714,0.357143,47.2857,99.1018,14,4
India,259,242.378,7.15058,0.339768,244.568,7.12741,0.30888,961,RG Sharma,0,0,0,0,0,0,0,0,8,16,24,8,16,24,0,317,2,0,1,3.82836,0.268657,35.9179,83.083,134,4
India,259,242.378,7.15058,0.339768,244.568,7.12741,0.30888,961,S Dhawan,0,0,0,0,0,0,0,0,8,16,24,8,16,24,0,317,2,0,1,5.65217,0.362319,43.2174,88.9088,69,4
Bangladesh,160,218.438,7.70625,0.4,211.106,7.05,0.325,961,Tamim Iqbal,0,0,0,0,0,0,0,0,22,7,29,22,7,29,318,240,5,1,1,4.05344,0.274809,31.8015,76.8068,131,4
Bangladesh,160,218.438,7.70625,0.4,211.106,7.05,0.325,961,Soumya Sarkar,0,0,0,0,0,0,0,0,22,7,29,22,7,29,318,240,5,1,1,7.35714,0.357143,47.2857,99.1018,14,4
Bangladesh,160,218.438,7.70625,0.4,211.106,7.05,0.325,961,Litton Das,0,0,0,0,0,0,0,0,22,7,29,22,7,29,318,240,5,1,1,2.66667,0,25.3333,72.381,3,4
India,259,242.378,7.15058,0.339768,244.568,7.12741,0.30888,962,AM Rahane,0,0,0,0,0,0,0,0,4,8,12,4,8,12,0,255,2,0,1,3.55738,0.262295,32.2295,78.0159,61,4
India,259,242.378,7.15058,0.339768,244.568,7.12741,0.30888,962,M Vijay,0,0,0,0,0,0,0,0,4,8,12,4,8,12,0,255,2,0,1,2.25,0.0625,21.1875,65.6977,16,1
India,259,242.378,7.15058,0.339768,244.568,7.12741,0.30888,962,AT Rayudu,0,0,0,0,0,0,0,0,4,8,12,4,8,12,0,255,2,0,1,3.38462,0.269231,35.6923,76.0656,26,4
Zimbabwe,142,212.077,7.5,0.380282,227.704,6.97887,0.316901,962,V Sibanda,0,0,0,0,0,0,0,0,4,7,11,4,7,11,256,251,5,1,1,2.9697,0.181818,23.5152,63.5545,66,1
Zimbabwe,142,212.077,7.5,0.380282,227.704,6.97887,0.316901,962,CJ Chibhabha,0,0,0,0,0,0,0,0,4,7,11,4,7,11,256,251,5,1,1,2.56716,0.149254,23.5373,64.7373,67,1
Zimbabwe,142,212.077,7.5,0.380282,227.704,6.97887,0.316901,962,H Masakadza,0,0,0,0,0,0,0,0,4,7,11,4,7,11,256,251,5,1,1,3.11215,0.186916,26.972,70.0485,107,4
India,259,242.378,7.15058,0.339768,244.568,7.12741,0.30888,963,AM Rahane,0,0,0,0,0,0,0,0,8,8,16,8,8,16,0,271,1,0,1,3.55738,0.262295,32.2295,78.0159,61,4
India,259,242.378,7.15058,0.339768,244.568,7.12741,0.30888,963,M Vijay,0,0,0,0,0,0,0,0,8,8,16,8,8,16,0,271,1,0,1,2.25,0.0625,21.1875,65.6977,16,1
Zimbabwe,142,212.077,7.5,0.380282,227.704,6.97887,0.316901,963,V Sibanda,0,0,0,0,0,0,0,0,16,7,23,16,7,23,272,209,1,1,1,2.9697,0.181818,23.5152,63.5545,66,1
Zimbabwe,142,212.077,7.5,0.380282,227.704,6.97887,0.316901,963,CJ Chibhabha,0,0,0,0,0,0,0,0,16,7,23,16,7,23,272,209,1,1,1,2.56716,0.149254,23.5373,64.7373,67,1
New Zealand,184,233.745,7.39674,0.36413,227.951,7.30435,0.353261,964,MJ Guptill,0,0,0,0,0,0,0,0,16,4,20,16,4,20,0,303,2,0,1,4.8087,0.313043,38.1217,82.7482,115,4
New Zealand,184,233.745,7.39674,0.36413,227.951,7.30435,0.353261,964,TWM Latham,0,0,0,0,0,0,0,0,16,4,20,16,4,20,0,303,2,0,1,2.76471,0.147059,25.3529,75.2182,34,4
New Zealand,184,233.745,7.39674,0.36413,227.951,7.30435,0.353261,964,KS Williamson,0,0,0,0,0,0,0,0,16,4,20,16,4,20,0,303,2,0,1,4.31707,0.390244,43.0488,82.8833,82,4
Zimbabwe,142,212.077,7.5,0.380282,227.704,6.97887,0.316901,964,H Masakadza,0,0,0,0,0,0,0,0,16,10,26,16,10,26,304,304,1,1,1,3.11215,0.186916,26.972,70.0485,107,4
Zimbabwe,142,212.077,7.5,0.380282,227.704,6.97887,0.316901,964,CJ Chibhabha,0,0,0,0,0,0,0,0,16,10,26,16,10,26,304,304,1,1,1,2.56716,0.149254,23.5373,64.7373,67,1
Zimbabwe,142,212.077,7.5,0.380282,227.704,6.97887,0.316901,965,H Masakadza,0,0,0,0,0,0,0,0,12,3,15,12,3,15,0,235,0,1,1,3.11215,0.186916,26.972,70.0485,107,4
Zimbabwe,142,212.077,7.5,0.380282,227.704,6.97887,0.316901,965,CJ Chibhabha,0,0,0,0,0,0,0,0,12,3,15,12,3,15,0,235,0,1,1,2.56716,0.149254,23.5373,64.7373,67,1
Zimbabwe,142,212.077,7.5,0.380282,227.704,6.97887,0.316901,965,CR Ervine,0,0,0,0,0,0,0,0,12,3,15,12,3,15,0,235,0,1,1,3.06667,0.2,30.5333,73.9903,30,4
New Zealand,184,233.745,7.39674,0.36413,227.951,7.30435,0.353261,965,MJ Guptill,0,0,0,0,0,0,0,0,8,9,17,8,9,17,236,236,0,0,1,4.8087,0.313043,38.1217,82.7482,115,4
New Zealand,184,233.745,7.39674,0.36413,227.951,7.30435,0.353261,965,TWM Latham,0,0,0,0,0,0,0,0,8,9,17,8,9,17,236,236,0,0,1,2.76471,0.147059,25.3529,75.2182,34,4
New Zealand,184,233.745,7.39674,0.36413,227.951,7.30435,0.353261,966,MJ Guptill,0,0,0,0,0,0,0,0,12,4,16,12,4,16,0,273,0,0,1,4.8087,0.313043,38.1217,82.7482,115,4
New Zealand,184,233.745,7.39674,0.36413,227.951,7.30435,0.353261,966,TWM Latham,0,0,0,0,0,0,0,0,12,4,16,12,4,16,0,273,0,0,1,2.76471,0.147059,25.3529,75.2182,34,4
Zimbabwe,142,212.077,7.5,0.380282,227.704,6.97887,0.316901,966,H Masakadza,0,0,0,0,0,0,0,0,6,3,9,6,3,9,274,235,3,1,1,3.11215,0.186916,26.972,70.0485,107,4
Zimbabwe,142,212.077,7.5,0.380282,227.704,6.97887,0.316901,966,CJ Chibhabha,0,0,0,0,0,0,0,0,6,3,9,6,3,9,274,235,3,1,1,2.56716,0.149254,23.5373,64.7373,67,1
India,259,242.378,7.15058,0.339768,244.568,7.12741,0.30888,967,RG Sharma,0,0,0,0,0,0,0,0,14,10,24,14,10,24,0,309,5,0,1,3.82836,0.268657,35.9179,83.083,134,4
India,259,242.378,7.15058,0.339768,244.568,7.12741,0.30888,967,S Dhawan,0,0,0,0,0,0,0,0,14,10,24,14,10,24,0,309,5,0,1,5.65217,0.362319,43.2174,88.9088,69,4
Australia,228,239.627,7.69737,0.372807,232.079,7.23246,0.337719,967,AJ Finch,0,0,0,0,0,0,0,0,8,11,19,8,11,19,310,310,2,1,1,4.52941,0.313725,37.2549,83.4431,51,4
Australia,228,239.627,7.69737,0.372807,232.079,7.23246,0.337719,967,DA Warner,0,0,0,0,0,0,0,0,8,11,19,8,11,19,310,310,2,1,1,4.20312,0.265625,35.2031,87.7336,64,4
Australia,228,239.627,7.69737,0.372807,232.079,7.23246,0.337719,967,SPD Smith,0,0,0,0,0,0,0,0,8,11,19,8,11,19,310,310,2,1,1,3.19298,0.22807,34.5614,87.0526,57,4
Australia,228,239.627,7.69737,0.372807,232.079,7.23246,0.337719,967,GJ Bailey,0,0,0,0,0,0,0,0,8,11,19,8,11,19,310,310,2,1,1,3.34921,0.301587,36.3492,84.658,63,4
India,259,242.378,7.15058,0.339768,244.568,7.12741,0.30888,968,RG Sharma,0,0,0,0,0,0,0,0,8,14,22,8,14,22,0,308,1,0,1,3.82836,0.268657,35.9179,83.083,134,4
India,259,242.378,7.15058,0.339768,244.568,7.12741,0.30888,968,S Dhawan,0,0,0,0,0,0,0,0,8,14,22,8,14,22,0,308,1,0,1,5.65217,0.362319,43.2174,88.9088,69,4
India,259,242.378,7.15058,0.339768,244.568,7.12741,0.30888,968,V Kohli,0,0,0,0,0,0,0,0,8,14,22,8,14,22,0,308,1,0,1,4.66456,0.379747,44.9937,88.3325,158,4
Australia,228,239.627,7.69737,0.372807,232.079,7.23246,0.337719,968,AJ Finch,0,0,0,0,0,0,0,0,12,8,20,12,8,20,309,309,5,1,1,4.52941,0.313725,37.2549,83.4431,51,4
Australia,228,239.627,7.69737,0.372807,232.079,7.23246,0.337719,968,SE Marsh,0,0,0,0,0,0,0,0,12,8,20,12,8,20,309,309,5,1,1,3.66667,0.291667,35.5417,74.7918,48,4
India,259,242.378,7.15058,0.339768,244.568,7.12741,0.30888,969,RG Sharma,0,0,0,0,0,0,0,0,8,7,15,8,7,15,0,295,1,0,1,3.82836,0.268657,35.9179,83.083,134,4
India,259,242.378,7.15058,0.339768,244.568,7.12741,0.30888,969,S Dhawan,0,0,0,0,0,0,0,0,8,7,15,8,7,15,0,295,1,0,1,5.65217,0.362319,43.2174,88.9088,69,4
India,259,242.378,7.15058,0.339768,244.568,7.12741,0.30888,969,V Kohli,0,0,0,0,0,0,0,0,8,7,15,8,7,15,0,295,1,0,1,4.66456,0.379747,44.9937,88.3325,158,4
Australia,228,239.627,7.69737,0.372807,232.079,7.23246,0.337719,969,SE Marsh,0,0,0,0,0,0,0,0,16,13,29,16,13,29,296,296,2,1,1,3.66667,0.291667,35.5417,74.7918,48,4
Australia,228,239.627,7.69737,0.372807,232.079,7.23246,0.337719,969,AJ Finch,0,0,0,0,0,0,0,0,16,13,29,16,13,29,296,296,2,1,1,4.52941,0.313725,37.2549,83.4431,51,4
Australia,228,239.627,7.69737,0.372807,232.079,7.23246,0.337719,970,DA Warner,0,0,0,0,0,0,0,0,32,8,40,32,8,40,0,348,0,1,1,4.20312,0.265625,35.2031,87.7336,64,4
Australia,228,239.627,7.69737,0.372807,232.079,7.23246,0.337719,970,AJ Finch,0,0,0,0,0,0,0,0,32,8,40,32,8,40,0,348,0,1,1,4.52941,0.313725,37.2549,83.4431,51,4
India,259,242.378,7.15058,0.339768,244.568,7.12741,0.30888,970,RG Sharma,0,0,0,0,0,0,0,0,14,16,30,14,16,30,349,323,0,0,1,3.82836,0.268657,35.9179,83.083,134,4
India,259,242.378,7.15058,0.339768,244.568,7.12741,0.30888,970,S Dhawan,0,0,0,0,0,0,0,0,14,16,30,14,16,30,349,323,0,0,1,5.65217,0.362319,43.2174,88.9088,69,4
Australia,228,239.627,7.69737,0.372807,232.079,7.23246,0.337719,971,AJ Finch,0,0,0,0,0,0,0,0,12,16,28,12,16,28,0,330,2,1,1,4.52941,0.313725,37.2549,83.4431,51,4
Australia,228,239.627,7.69737,0.372807,232.079,7.23246,0.337719,971,DA Warner,0,0,0,0,0,0,0,0,12,16,28,12,16,28,0,330,2,1,1,4.20312,0.265625,35.2031,87.7336,64,4
Australia,228,239.627,7.69737,0.372807,232.079,7.23246,0.337719,971,SPD Smith,0,0,0,0,0,0,0,0,12,16,28,12,16,28,0,330,2,1,1,3.19298,0.22807,34.5614,87.0526,57,4
India,259,242.378,7.15058,0.339768,244.568,7.12741,0.30888,971,RG Sharma,0,0,0,0,0,0,0,0,4,16,20,4,16,20,331,331,0,0,1,3.82836,0.268657,35.9179,83.083,134,4
India,259,242.378,7.15058,0.339768,244.568,7.12741,0.30888,971,S Dhawan,0,0,0,0,0,0,0,0,4,16,20,4,16,20,331,331,0,0,1,5.65217,0.362319,43.2174,88.9088,69,4
England,221,237.176,7.17647,0.289593,230.633,7.45701,0.384615,972,JJ Roy,0,0,0,0,0,0,0,0,12,7,19,12,7,19,0,216,0,0,1,4.36842,0.210526,29.3684,95.3846,19,0
England,221,237.176,7.17647,0.289593,230.633,7.45701,0.384615,972,JE Root,0,0,0,0,0,0,0,0,12,7,19,12,7,19,0,216,0,0,1,3.68852,0.327869,41.6721,83.3443,61,4
England,221,237.176,7.17647,0.289593,230.633,7.45701,0.384615,972,AD Hales,0,0,0,0,0,0,0,0,12,7,19,12,7,19,0,216,0,0,1,4.2963,0.296296,34.1111,85.1201,27,4
England,221,237.176,7.17647,0.289593,230.633,7.45701,0.384615,972,EJG Morgan,0,0,0,0,0,0,0,0,12,7,19,12,7,19,0,216,0,0,1,3.19549,0.233083,30.0526,86.9291,133,4
England,221,237.176,7.17647,0.289593,230.633,7.45701,0.384615,972,JWA Taylor,0,0,0,0,0,0,0,0,12,7,19,12,7,19,0,216,0,0,1,3.375,0.333333,35.9167,79.8888,24,4
Pakistan,211,222.621,7.38389,0.393365,235.517,7.54976,0.336493,972,Azhar Ali,0,0,0,0,0,0,0,0,16,4,20,16,4,20,217,217,3,0,1,3.83333,0.3,38.5333,73.6775,30,4
Pakistan,211,222.621,7.38389,0.393365,235.517,7.54976,0.336493,972,Bilal Asif,0,0,0,0,0,0,0,0,16,4,20,16,4,20,217,217,3,0,1,2.33333,0,13.3333,76.9231,3,1
Pakistan,211,222.621,7.38389,0.393365,235.517,7.54976,0.336493,972,Mohammad Hafeez,0,0,0,0,0,0,0,0,16,4,20,16,4,20,217,217,3,0,1,4.04511,0.255639,34.3534,78.0625,133,4
Pakistan,211,222.621,7.38389,0.393365,235.517,7.54976,0.336493,972,Younis Khan,0,0,0,0,0,0,0,0,16,4,20,16,4,20,217,217,3,0,1,2.64655,0.215517,28.5,73.2713,116,4
Pakistan,211,222.621,7.38389,0.393365,235.517,7.54976,0.336493,973,Azhar Ali,0,0,0,0,0,0,0,0,4,10,14,4,10,14,0,208,1,0,1,3.83333,0.3,38.5333,73.6775,30,4
Pakistan,211,222.621,7.38389,0.393365,235.517,7.54976,0.336493,973,Babar Azam,0,0,0,0,0,0,0,0,4,10,14,4,10,14,0,208,1,0,1,4.375,0.5,40.125,88.9197,8,4
England,221,237.176,7.17647,0.289593,230.633,7.45701,0.384615,973,JJ Roy,0,0,0,0,0,0,0,0,12,11,23,12,11,23,209,210,0,0,1,4.36842,0.210526,29.3684,95.3846,19,0
England,221,237.176,7.17647,0.289593,230.633,7.45701,0.384615,973,AD Hales,0,0,0,0,0,0,0,0,12,11,23,12,11,23,209,210,0,0,1,4.2963,0.296296,34.1111,85.1201,27,4
England,221,237.176,7.17647,0.289593,230.633,7.45701,0.384615,973,JE Root,0,0,0,0,0,0,0,0,12,11,23,12,11,23,209,210,0,0,1,3.68852,0.327869,41.6721,83.3443,61,4
England,221,237.176,7.17647,0.289593,230.633,7.45701,0.384615,974,JJ Roy,0,0,0,0,0,0,0,0,4,17,21,4,17,21,0,355,3,0,1,4.36842,0.210526,29.3684,95.3846,19,0
England,221,237.176,7.17647,0.289593,230.633,7.45701,0.384615,974,AD Hales,0,0,0,0,0,0,0,0,4,17,21,4,17,21,0,355,3,0,1,4.2963,0.296296,34.1111,85.1201,27,4
Pakistan,211,222.621,7.38389,0.393365,235.517,7.54976,0.336493,974,Azhar Ali,0,0,0,0,0,0,0,0,16,14,30,16,14,30,356,271,3,0,1,3.83333,0.3,38.5333,73.6775,30,4
Pakistan,211,222.621,7.38389,0.393365,235.517,7.54976,0.336493,974,Ahmed Shehzad,0,0,0,0,0,0,0,0,16,14,30,16,14,30,356,271,3,0,1,3.67143,0.242857,33.2714,70.8118,70,4
South Africa,190,234.274,7.4,0.373684,232.363,7.33158,0.342105,975,Q de Kock,0,0,0,0,0,0,0,0,12,9,21,12,9,21,0,303,2,0,1,5.12963,0.240741,39.1111,91.2311,54,4
South Africa,190,234.274,7.4,0.373684,232.363,7.33158,0.342105,975,HM Amla,0,0,0,0,0,0,0,0,12,9,21,12,9,21,0,303,2,0,1,5.20168,0.403361,48.7899,86.9292,119,4
India,259,242.378,7.15058,0.339768,244.568,7.12741,0.30888,975,RG Sharma,0,0,0,0,0,0,0,0,20,5,25,20,5,25,304,298,1,1,1,3.82836,0.268657,35.9179,83.083,134,4
India,259,242.378,7.15058,0.339768,244.568,7.12741,0.30888,975,S Dhawan,0,0,0,0,0,0,0,0,20,5,25,20,5,25,304,298,1,1,1,5.65217,0.362319,43.2174,88.9088,69,4
India,259,242.378,7.15058,0.339768,244.568,7.12741,0.30888,976,RG Sharma,0,0,0,0,0,0,0,0,16,4,20,16,4,20,0,247,0,1,1,3.82836,0.268657,35.9179,83.083,134,4
India,259,242.378,7.15058,0.339768,244.568,7.12741,0.30888,976,AM Rahane,0,0,0,0,0,0,0,0,16,4,20,16,4,20,0,247,0,1,1,3.55738,0.262295,32.2295,78.0159,61,4
India,259,242.378,7.15058,0.339768,244.568,7.12741,0.30888,976,S Dhawan,0,0,0,0,0,0,0,0,16,4,20,16,4,20,0,247,0,1,1,5.65217,0.362319,43.2174,88.9088,69,4
South Africa,190,234.274,7.4,0.373684,232.363,7.33158,0.342105,976,HM Amla,0,0,0,0,0,0,0,0,20,12,32,20,12,32,248,225,0,0,1,5.20168,0.403361,48.7899,86.9292,119,4
South Africa,190,234.274,7.4,0.373684,232.363,7.33158,0.342105,976,Q de Kock,0,0,0,0,0,0,0,0,20,12,32,20,12,32,248,225,0,0,1,5.12963,0.240741,39.1111,91.2311,54,4
South Africa,190,234.274,7.4,0.373684,232.363,7.33158,0.342105,977,Q de Kock,0,0,0,0,0,0,0,0,14,14,28,14,14,28,0,270,2,0,1,5.12963,0.240741,39.1111,91.2311,54,4
South Africa,190,234.274,7.4,0.373684,232.363,7.33158,0.342105,977,DA Miller,0,0,0,0,0,0,0,0,14,14,28,14,14,28,0,270,2,0,1,2.57353,0.132353,24.9412,97.2477,68,0
India,259,242.378,7.15058,0.339768,244.568,7.12741,0.30888,977,RG Sharma,0,0,0,0,0,0,0,0,12,5,17,12,5,17,271,252,1,1,1,3.82836,0.268657,35.9179,83.083,134,4
India,259,242.378,7.15058,0.339768,244.568,7.12741,0.30888,977,S Dhawan,0,0,0,0,0,0,0,0,12,5,17,12,5,17,271,252,1,1,1,5.65217,0.362319,43.2174,88.9088,69,4
India,259,242.378,7.15058,0.339768,244.568,7.12741,0.30888,978,RG Sharma,0,0,0,0,0,0,0,0,16,13,29,16,13,29,0,299,0,1,1,3.82836,0.268657,35.9179,83.083,134,4
India,259,242.378,7.15058,0.339768,244.568,7.12741,0.30888,978,S Dhawan,0,0,0,0,0,0,0,0,16,13,29,16,13,29,0,299,0,1,1,5.65217,0.362319,43.2174,88.9088,69,4
India,259,242.378,7.15058,0.339768,244.568,7.12741,0.30888,978,V Kohli,0,0,0,0,0,0,0,0,16,13,29,16,13,29,0,299,0,1,1,4.66456,0.379747,44.9937,88.3325,158,4
South Africa,190,234.274,7.4,0.373684,232.363,7.33158,0.342105,978,Q de Kock,0,0,0,0,0,0,0,0,16,16,32,16,16,32,300,264,4,0,1,5.12963,0.240741,39.1111,91.2311,54,4
South Africa,190,234.274,7.4,0.373684,232.363,7.33158,0.342105,978,HM Amla,0,0,0,0,0,0,0,0,16,16,32,16,16,32,300,264,4,0,1,5.20168,0.403361,48.7899,86.9292,119,4
South Africa,190,234.274,7.4,0.373684,232.363,7.33158,0.342105,979,Q de Kock,0,0,0,0,0,0,0,0,36,7,43,36,7,43,0,438,1,0,1,5.12963,0.240741,39.1111,91.2311,54,4
South Africa,190,234.274,7.4,0.373684,232.363,7.33158,0.342105,979,HM Amla,0,0,0,0,0,0,0,0,36,7,43,36,7,43,0,438,1,0,1,5.20168,0.403361,48.7899,86.9292,119,4
India,259,242.378,7.15058,0.339768,244.568,7.12741,0.30888,979,RG Sharma,0,0,0,0,0,0,0,0,16,6,22,16,6,22,439,224,0,1,1,3.82836,0.268657,35.9179,83.083,134,4
India,259,242.378,7.15058,0.339768,244.568,7.12741,0.30888,979,S Dhawan,0,0,0,0,0,0,0,0,16,6,22,16,6,22,439,224,0,1,1,5.65217,0.362319,43.2174,88.9088,69,4
Sri Lanka,244,223.373,7.09016,0.344262,227.578,7.47541,0.385246,981,MD Gunathilaka,0,0,0,0,0,0,0,0,8,10,18,8,10,18,0,188,2,0,1,3.6,0.2,23.4,83.5714,5,4
Sri Lanka,244,223.373,7.09016,0.344262,227.578,7.47541,0.385246,981,TM Dilshan,0,0,0,0,0,0,0,0,8,10,18,8,10,18,0,188,2,0,1,4.60199,0.273632,38.3632,86.0219,201,4
Sri Lanka,244,223.373,7.09016,0.344262,227.578,7.47541,0.385246,981,HDRL Thirimanne,0,0,0,0,0,0,0,0,8,10,18,8,10,18,0,188,2,0,1,2.77778,0.246914,31.5802,71.4725,81,4
New Zealand,184,233.745,7.39674,0.36413,227.951,7.30435,0.353261,981,MJ Guptill,0,0,0,0,0,0,0,0,30,9,39,30,9,39,189,191,2,1,1,4.8087,0.313043,38.1217,82.7482,115,4
New Zealand,184,233.745,7.39674,0.36413,227.951,7.30435,0.353261,981,BB McCullum,0,0,0,0,0,0,0,0,30,9,39,30,9,39,189,191,2,1,1,3.98611,0.201389,29.9028,98.4004,144,0
New Zealand,184,233.745,7.39674,0.36413,227.951,7.30435,0.353261,982,MJ Guptill,0,0,0,0,0,0,0,0,14,10,24,14,10,24,0,276,0,1,1,4.8087,0.313043,38.1217,82.7482,115,4
New Zealand,184,233.745,7.39674,0.36413,227.951,7.30435,0.353261,982,TWM Latham,0,0,0,0,0,0,0,0,14,10,24,14,10,24,0,276,0,1,1,2.76471,0.147059,25.3529,75.2182,34,4
Sri Lanka,244,223.373,7.09016,0.344262,227.578,7.47541,0.385246,982,MD Gunathilaka,0,0,0,0,0,0,0,0,30,11,41,30,11,41,277,277,4,0,1,3.6,0.2,23.4,83.5714,5,4
Sri Lanka,244,223.373,7.09016,0.344262,227.578,7.47541,0.385246,982,TM Dilshan,0,0,0,0,0,0,0,0,30,11,41,30,11,41,277,277,4,0,1,4.60199,0.273632,38.3632,86.0219,201,4
New Zealand,184,233.745,7.39674,0.36413,227.951,7.30435,0.353261,983,MJ Guptill,0,0,0,0,0,0,0,0,8,9,17,8,9,17,0,294,2,1,1,4.8087,0.313043,38.1217,82.7482,115,4
New Zealand,184,233.745,7.39674,0.36413,227.951,7.30435,0.353261,983,TWM Latham,0,0,0,0,0,0,0,0,8,9,17,8,9,17,0,294,2,1,1,2.76471,0.147059,25.3529,75.2182,34,4
New Zealand,184,233.745,7.39674,0.36413,227.951,7.30435,0.353261,983,KS Williamson,0,0,0,0,0,0,0,0,8,9,17,8,9,17,0,294,2,1,1,4.31707,0.390244,43.0488,82.8833,82,4
Sri Lanka,244,223.373,7.09016,0.344262,227.578,7.47541,0.385246,983,MD Gunathilaka,0,0,0,0,0,0,0,0,16,9,25,16,9,25,295,258,1,0,1,3.6,0.2,23.4,83.5714,5,4
Sri Lanka,244,223.373,7.09016,0.344262,227.578,7.47541,0.385246,983,TM Dilshan,0,0,0,0,0,0,0,0,16,9,25,16,9,25,295,258,1,0,1,4.60199,0.273632,38.3632,86.0219,201,4
Sri Lanka,244,223.373,7.09016,0.344262,227.578,7.47541,0.385246,983,HDRL Thirimanne,0,0,0,0,0,0,0,0,16,9,25,16,9,25,295,258,1,0,1,2.77778,0.246914,31.5802,71.4725,81,4
Sri Lanka,244,223.373,7.09016,0.344262,227.578,7.47541,0.385246,983,LD Chandimal,0,0,0,0,0,0,0,0,16,9,25,16,9,25,295,258,1,0,1,2.18478,0.184783,25.7391,73.8615,92,4
New Zealand,184,233.745,7.39674,0.36413,227.951,7.30435,0.353261,984,MJ Guptill,0,0,0,0,0,0,0,0,14,6,20,14,6,20,0,280,3,1,1,4.8087,0.313043,38.1217,82.7482,115,4
New Zealand,184,233.745,7.39674,0.36413,227.951,7.30435,0.353261,984,TWM Latham,0,0,0,0,0,0,0,0,14,6,20,14,6,20,0,280,3,1,1,2.76471,0.147059,25.3529,75.2182,34,4
Pakistan,211,222.621,7.38389,0.393365,235.517,7.54976,0.336493,984,Azhar Ali,0,0,0,0,0,0,0,0,4,11,15,4,11,15,281,210,2,0,1,3.83333,0.3,38.5333,73.6775,30,4
Pakistan,211,222.621,7.38389,0.393365,235.517,7.54976,0.336493,984,Ahmed Shehzad,0,0,0,0,0,0,0,0,4,11,15,4,11,15,281,210,2,0,1,3.67143,0.242857,33.2714,70.8118,70,4
New Zealand,184,233.745,7.39674,0.36413,227.951,7.30435,0.353261,985,MJ Guptill,0,0,0,0,0,0,0,0,26,2,28,26,2,28,0,307,0,1,1,4.8087,0.313043,38.1217,82.7482,115,4
New Zealand,184,233.745,7.39674,0.36413,227.951,7.30435,0.353261,985,BB McCullum,0,0,0,0,0,0,0,0,26,2,28,26,2,28,0,307,0,1,1,3.98611,0.201389,29.9028,98.4004,144,0
Australia,228,239.627,7.69737,0.372807,232.079,7.23246,0.337719,985,SE Marsh,0,0,0,0,0,0,0,0,16,11,27,16,11,27,308,148,2,0,1,3.66667,0.291667,35.5417,74.7918,48,4
Australia,228,239.627,7.69737,0.372807,232.079,7.23246,0.337719,985,DA Warner,0,0,0,0,0,0,0,0,16,11,27,16,11,27,308,148,2,0,1,4.20312,0.265625,35.2031,87.7336,64,4
Australia,228,239.627,7.69737,0.372807,232.079,7.23246,0.337719,985,SPD Smith,0,0,0,0,0,0,0,0,16,11,27,16,11,27,308,148,2,0,1,3.19298,0.22807,34.5614,87.0526,57,4
New Zealand,184,233.745,7.39674,0.36413,227.951,7.30435,0.353261,986,MJ Guptill,0,0,0,0,0,0,0,0,26,8,34,26,8,34,0,281,2,1,1,4.8087,0.313043,38.1217,82.7482,115,4
New Zealand,184,233.745,7.39674,0.36413,227.951,7.30435,0.353261,986,BB McCullum,0,0,0,0,0,0,0,0,26,8,34,26,8,34,0,281,2,1,1,3.98611,0.201389,29.9028,98.4004,144,0
New Zealand,184,233.745,7.39674,0.36413,227.951,7.30435,0.353261,986,KS Williamson,0,0,0,0,0,0,0,0,26,8,34,26,8,34,0,281,2,1,1,4.31707,0.390244,43.0488,82.8833,82,4
Australia,228,239.627,7.69737,0.372807,232.079,7.23246,0.337719,986,UT Khawaja,0,0,0,0,0,0,0,0,26,9,35,26,9,35,282,283,2,0,1,2.8,0.2,21.6,84.375,5,4
Australia,228,239.627,7.69737,0.372807,232.079,7.23246,0.337719,986,DA Warner,0,0,0,0,0,0,0,0,26,9,35,26,9,35,282,283,2,0,1,4.20312,0.265625,35.2031,87.7336,64,4
New Zealand,184,233.745,7.39674,0.36413,227.951,7.30435,0.353261,987,MJ Guptill,0,0,0,0,0,0,0,0,26,8,34,26,8,34,0,246,0,1,1,4.8087,0.313043,38.1217,82.7482,115,4
New Zealand,184,233.745,7.39674,0.36413,227.951,7.30435,0.353261,987,BB McCullum,0,0,0,0,0,0,0,0,26,8,34,26,8,34,0,246,0,1,1,3.98611,0.201389,29.9028,98.4004,144,0
Australia,228,239.627,7.69737,0.372807,232.079,7.23246,0.337719,987,UT Khawaja,0,0,0,0,0,0,0,0,26,13,39,26,13,39,247,191,0,0,1,2.8,0.2,21.6,84.375,5,4
Australia,228,239.627,7.69737,0.372807,232.079,7.23246,0.337719,987,DA Warner,0,0,0,0,0,0,0,0,26,13,39,26,13,39,247,191,0,0,1,4.20312,0.265625,35.2031,87.7336,64,4
Pakistan,211,222.621,7.38389,0.393365,235.517,7.54976,0.336493,988,Azhar Ali,0,0,0,0,0,0,0,0,12,7,19,12,7,19,0,290,1,0,1,3.83333,0.3,38.5333,73.6775,30,4
Pakistan,211,222.621,7.38389,0.393365,235.517,7.54976,0.336493,988,Ahmed Shehzad,0,0,0,0,0,0,0,0,12,7,19,12,7,19,0,290,1,0,1,3.67143,0.242857,33.2714,70.8118,70,4
Pakistan,211,222.621,7.38389,0.393365,235.517,7.54976,0.336493,988,Mohammad Hafeez,0,0,0,0,0,0,0,0,12,7,19,12,7,19,0,290,1,0,1,4.04511,0.255639,34.3534,78.0625,133,4
New Zealand,184,233.745,7.39674,0.36413,227.951,7.30435,0.353261,988,MJ Guptill,0,0,0,0,0,0,0,0,18,4,22,18,4,22,291,265,7,1,1,4.8087,0.313043,38.1217,82.7482,115,4
New Zealand,184,233.745,7.39674,0.36413,227.951,7.30435,0.353261,988,BB McCullum,0,0,0,0,0,0,0,0,18,4,22,18,4,22,291,265,7,1,1,3.98611,0.201389,29.9028,98.4004,144,0
New Zealand,184,233.745,7.39674,0.36413,227.951,7.30435,0.353261,988,KS Williamson,0,0,0,0,0,0,0,0,18,4,22,18,4,22,291,265,7,1,1,4.31707,0.390244,43.0488,82.8833,82,4
West Indies,176,217.33,7.15909,0.3125,225.278,7.57386,0.380682,989,ADS Fletcher,0,0,0,0,0,0,0,0,8,7,15,8,7,15,0,159,6,0,1,1.8125,0.125,13.5,62.6087,16,1
West Indies,176,217.33,7.15909,0.3125,225.278,7.57386,0.380682,989,J Charles,0,0,0,0,0,0,0,0,8,7,15,8,7,15,0,159,6,0,1,3.82353,0.147059,28.2353,81.2183,34,4
West Indies,176,217.33,7.15909,0.3125,225.278,7.57386,0.380682,989,DM Bravo,0,0,0,0,0,0,0,0,8,7,15,8,7,15,0,159,6,0,1,3,0.226667,28.52,67.4551,75,4
West Indies,176,217.33,7.15909,0.3125,225.278,7.57386,0.380682,989,MN Samuels,0,0,0,0,0,0,0,0,8,7,15,8,7,15,0,159,6,0,1,3.74757,0.23301,31.6214,74.5821,103,4
Sri Lanka,244,223.373,7.09016,0.344262,227.578,7.47541,0.385246,989,MDKJ Perera,0,0,0,0,0,0,0,0,34,13,47,34,13,47,160,164,1,1,1,3.30435,0.195652,25.7391,90.5199,46,0
Sri Lanka,244,223.373,7.09016,0.344262,227.578,7.47541,0.385246,989,TM Dilshan,0,0,0,0,0,0,0,0,34,13,47,34,13,47,160,164,1,1,1,4.60199,0.273632,38.3632,86.0219,201,4
Sri Lanka,244,223.373,7.09016,0.344262,227.578,7.47541,0.385246,989,HDRL Thirimanne,0,0,0,0,0,0,0,0,34,13,47,34,13,47,160,164,1,1,1,2.77778,0.246914,31.5802,71.4725,81,4
West Indies,176,217.33,7.15909,0.3125,225.278,7.57386,0.380682,990,J Charles,0,0,0,0,0,0,0,0,12,12,24,12,12,24,0,214,6,0,1,3.82353,0.147059,28.2353,81.2183,34,4
West Indies,176,217.33,7.15909,0.3125,225.278,7.57386,0.380682,990,ADS Fletcher,0,0,0,0,0,0,0,0,12,12,24,12,12,24,0,214,6,0,1,1.8125,0.125,13.5,62.6087,16,1
West Indies,176,217.33,7.15909,0.3125,225.278,7.57386,0.380682,990,J Blackwood,0,0,0,0,0,0,0,0,12,12,24,12,12,24,0,214,6,0,1,0.5,0,5.5,44,2,3
West Indies,176,217.33,7.15909,0.3125,225.278,7.57386,0.380682,990,DM Bravo,0,0,0,0,0,0,0,0,12,12,24,12,12,24,0,214,6,0,1,3,0.226667,28.52,67.4551,75,4
Sri Lanka,244,223.373,7.09016,0.344262,227.578,7.47541,0.385246,990,MDKJ Perera,0,0,0,0,0,0,0,0,30,10,40,30,10,40,215,225,6,1,1,3.30435,0.195652,25.7391,90.5199,46,0
Sri Lanka,244,223.373,7.09016,0.344262,227.578,7.47541,0.385246,990,TM Dilshan,0,0,0,0,0,0,0,0,30,10,40,30,10,40,215,225,6,1,1,4.60199,0.273632,38.3632,86.0219,201,4
Sri Lanka,244,223.373,7.09016,0.344262,227.578,7.47541,0.385246,990,HDRL Thirimanne,0,0,0,0,0,0,0,0,30,10,40,30,10,40,215,225,6,1,1,2.77778,0.246914,31.5802,71.4725,81,4
Pakistan,211,222.621,7.38389,0.393365,235.517,7.54976,0.336493,991,Azhar Ali,0,0,0,0,0,0,0,0,4,7,11,4,7,11,0,259,1,0,1,3.83333,0.3,38.5333,73.6775,30,4
Pakistan,211,222.621,7.38389,0.393365,235.517,7.54976,0.336493,991,Ahmed Shehzad,0,0,0,0,0,0,0,0,4,7,11,4,7,11,0,259,1,0,1,3.67143,0.242857,33.2714,70.8118,70,4
Zimbabwe,142,212.077,7.5,0.380282,227.704,6.97887,0.316901,991,BB Chari,0,0,0,0,0,0,0,0,4,6,10,4,6,10,260,128,1,1,1,1,0,19,45.509,4,3
Zimbabwe,142,212.077,7.5,0.380282,227.704,6.97887,0.316901,991,CJ Chibhabha,0,0,0,0,0,0,0,0,4,6,10,4,6,10,260,128,1,1,1,2.56716,0.149254,23.5373,64.7373,67,1
Zimbabwe,142,212.077,7.5,0.380282,227.704,6.97887,0.316901,992,H Masakadza,0,0,0,0,0,0,0,0,8,7,15,8,7,15,0,276,1,1,1,3.11215,0.186916,26.972,70.0485,107,4
Zimbabwe,142,212.077,7.5,0.380282,227.704,6.97887,0.316901,992,CJ Chibhabha,0,0,0,0,0,0,0,0,8,7,15,8,7,15,0,276,1,1,1,2.56716,0.149254,23.5373,64.7373,67,1
Pakistan,211,222.621,7.38389,0.393365,235.517,7.54976,0.336493,992,Azhar Ali,0,0,0,0,0,0,0,0,12,3,15,12,3,15,277,256,2,0,1,3.83333,0.3,38.5333,73.6775,30,4
Pakistan,211,222.621,7.38389,0.393365,235.517,7.54976,0.336493,992,Bilal Asif,0,0,0,0,0,0,0,0,12,3,15,12,3,15,277,256,2,0,1,2.33333,0,13.3333,76.9231,3,1
Pakistan,211,222.621,7.38389,0.393365,235.517,7.54976,0.336493,992,Mohammad Hafeez,0,0,0,0,0,0,0,0,12,3,15,12,3,15,277,256,2,0,1,4.04511,0.255639,34.3534,78.0625,133,4
Pakistan,211,222.621,7.38389,0.393365,235.517,7.54976,0.336493,992,Asad Shafiq,0,0,0,0,0,0,0,0,12,3,15,12,3,15,277,256,2,0,1,2.07843,0.176471,24.7843,67.1269,51,4
Zimbabwe,142,212.077,7.5,0.380282,227.704,6.97887,0.316901,993,CJ Chibhabha,0,0,0,0,0,0,0,0,8,9,17,8,9,17,0,161,0,1,1,2.56716,0.149254,23.5373,64.7373,67,1
Zimbabwe,142,212.077,7.5,0.380282,227.704,6.97887,0.316901,993,R Mutumbami,0,0,0,0,0,0,0,0,8,9,17,8,9,17,0,161,0,1,1,1.93333,0.0666667,15.4667,69.8795,15,1
Pakistan,211,222.621,7.38389,0.393365,235.517,7.54976,0.336493,993,Ahmed Shehzad,0,0,0,0,0,0,0,0,16,6,22,16,6,22,162,162,1,0,1,3.67143,0.242857,33.2714,70.8118,70,4
Pakistan,211,222.621,7.38389,0.393365,235.517,7.54976,0.336493,993,Bilal Asif,0,0,0,0,0,0,0,0,16,6,22,16,6,22,162,162,1,0,1,2.33333,0,13.3333,76.9231,3,1
Ireland,55,219.527,7.65455,0.290909,202.727,7.56364,0.4,994,WTS Porterfield,0,0,0,0,0,0,0,0,12,4,16,12,4,16,0,219,0,0,1,2.6,0.142857,24.6857,56.2866,35,3
Ireland,55,219.527,7.65455,0.290909,202.727,7.56364,0.4,994,PR Stirling,0,0,0,0,0,0,0,0,12,4,16,12,4,16,0,219,0,0,1,3.47826,0.173913,24.2174,88.1329,23,0
Zimbabwe,142,212.077,7.5,0.380282,227.704,6.97887,0.316901,994,CJ Chibhabha,0,0,0,0,0,0,0,0,12,6,18,12,6,18,220,222,1,1,1,2.56716,0.149254,23.5373,64.7373,67,1
Zimbabwe,142,212.077,7.5,0.380282,227.704,6.97887,0.316901,994,R Mutumbami,0,0,0,0,0,0,0,0,12,6,18,12,6,18,220,222,1,1,1,1.93333,0.0666667,15.4667,69.8795,15,1
Zimbabwe,142,212.077,7.5,0.380282,227.704,6.97887,0.316901,994,CR Ervine,0,0,0,0,0,0,0,0,12,6,18,12,6,18,220,222,1,1,1,3.06667,0.2,30.5333,73.9903,30,4
Ireland,55,219.527,7.65455,0.290909,202.727,7.56364,0.4,995,WTS Porterfield,0,0,0,0,0,0,0,0,8,4,12,8,4,12,0,268,0,0,1,2.6,0.142857,24.6857,56.2866,35,3
Ireland,55,219.527,7.65455,0.290909,202.727,7.56364,0.4,995,PR Stirling,0,0,0,0,0,0,0,0,8,4,12,8,4,12,0,268,0,0,1,3.47826,0.173913,24.2174,88.1329,23,0
Zimbabwe,142,212.077,7.5,0.380282,227.704,6.97887,0.316901,995,CJ Chibhabha,0,0,0,0,0,0,0,0,12,10,22,12,10,22,269,270,7,1,1,2.56716,0.149254,23.5373,64.7373,67,1
Zimbabwe,142,212.077,7.5,0.380282,227.704,6.97887,0.316901,995,R Mutumbami,0,0,0,0,0,0,0,0,12,10,22,12,10,22,269,270,7,1,1,1.93333,0.0666667,15.4667,69.8795,15,1
Zimbabwe,142,212.077,7.5,0.380282,227.704,6.97887,0.316901,996,CJ Chibhabha,0,0,0,0,0,0,0,0,0,7,7,0,7,7,0,187,2,1,1,2.56716,0.149254,23.5373,64.7373,67,1
Zimbabwe,142,212.077,7.5,0.380282,227.704,6.97887,0.316901,996,R Mutumbami,0,0,0,0,0,0,0,0,0,7,7,0,7,7,0,187,2,1,1,1.93333,0.0666667,15.4667,69.8795,15,1
Zimbabwe,142,212.077,7.5,0.380282,227.704,6.97887,0.316901,996,BB Chari,0,0,0,0,0,0,0,0,0,7,7,0,7,7,0,187,2,1,1,1,0,19,45.509,4,3
Zimbabwe,142,212.077,7.5,0.380282,227.704,6.97887,0.316901,996,SC Williams,0,0,0,0,0,0,0,0,0,7,7,0,7,7,0,187,2,1,1,2.56923,0.276923,28.5385,80.7927,65,4
Ireland,55,219.527,7.65455,0.290909,202.727,7.56364,0.4,996,WTS Porterfield,0,0,0,0,0,0,0,0,16,14,30,16,14,30,188,189,1,0,1,2.6,0.142857,24.6857,56.2866,35,3
Ireland,55,219.527,7.65455,0.290909,202.727,7.56364,0.4,996,PR Stirling,0,0,0,0,0,0,0,0,16,14,30,16,14,30,188,189,1,0,1,3.47826,0.173913,24.2174,88.1329,23,0
Bangladesh,160,218.438,7.70625,0.4,211.106,7.05,0.325,1000,Tamim Iqbal,0,0,0,0,0,0,0,0,12,9,21,12,9,21,0,241,0,1,1,4.05344,0.274809,31.8015,76.8068,131,4
Bangladesh,160,218.438,7.70625,0.4,211.106,7.05,0.325,1000,Imrul Kayes,0,0,0,0,0,0,0,0,12,9,21,12,9,21,0,241,0,1,1,3,0.207547,26.2642,63.6488,53,4
Zimbabwe,142,212.077,7.5,0.380282,227.704,6.97887,0.316901,1000,CJ Chibhabha,0,0,0,0,0,0,0,0,10,5,15,10,5,15,242,183,8,0,1,2.56716,0.149254,23.5373,64.7373,67,1
Zimbabwe,142,212.077,7.5,0.380282,227.704,6.97887,0.316901,1000,RW Chakabva,0,0,0,0,0,0,0,0,10,5,15,10,5,15,242,183,8,0,1,0.846154,0,13.2692,51.3393,26,3
Zimbabwe,142,212.077,7.5,0.380282,227.704,6.97887,0.316901,1000,CR Ervine,0,0,0,0,0,0,0,0,10,5,15,10,5,15,242,183,8,0,1,3.06667,0.2,30.5333,73.9903,30,4
Bangladesh,160,218.438,7.70625,0.4,211.106,7.05,0.325,1001,Tamim Iqbal,0,0,0,0,0,0,0,0,14,7,21,14,7,21,0,276,0,1,1,4.05344,0.274809,31.8015,76.8068,131,4
Bangladesh,160,218.438,7.70625,0.4,211.106,7.05,0.325,1001,Imrul Kayes,0,0,0,0,0,0,0,0,14,7,21,14,7,21,0,276,0,1,1,3,0.207547,26.2642,63.6488,53,4
Zimbabwe,142,212.077,7.5,0.380282,227.704,6.97887,0.316901,1001,CJ Chibhabha,0,0,0,0,0,0,0,0,20,7,27,20,7,27,277,215,3,0,1,2.56716,0.149254,23.5373,64.7373,67,1
Zimbabwe,142,212.077,7.5,0.380282,227.704,6.97887,0.316901,1001,CR Ervine,0,0,0,0,0,0,0,0,20,7,27,20,7,27,277,215,3,0,1,3.06667,0.2,30.5333,73.9903,30,4
Zimbabwe,142,212.077,7.5,0.380282,227.704,6.97887,0.316901,1001,RW Chakabva,0,0,0,0,0,0,0,0,20,7,27,20,7,27,277,215,3,0,1,0.846154,0,13.2692,51.3393,26,3
