Team,Total Matches Played,Runs Scored,Wickets Lost,Got All Out,Runs Conceded,Opponent Wickets Taken,Opponent All Out,Match Index,Batsman,Player Total Runs,Player Home Runs,Player Non Home Runs,Balls Faced,R0,W0,R1,W1,Current_HR,Current_NHR,Total Runs in Segment,Total HR till Segment,Total NHR till Segment,Total Runs Till Segment,Target,Final Runs Made,Extras,Home,Segment,Home Run Hitting Ability,Milestone Reaching Ability,Batting Average,Strike Rate,Matches Played,ClusterID
England,221,237.176,7.17647,0.289593,230.633,7.45701,0.384615,1,IR Bell,80,16,64,105,191,3,39,1,22,19,41,102,169,271,0,301,30,0,10,3.63433,0.246269,35.3806,75.6623,134,4
England,221,237.176,7.17647,0.289593,230.633,7.45701,0.384615,1,GO Jones,0,0,0,0,191,3,39,1,22,19,41,102,169,271,0,301,30,0,10,1.5,0,15.5,110.714,6,0
England,221,237.176,7.17647,0.289593,230.633,7.45701,0.384615,1,JWM Dalrymple,13,0,13,13,191,3,39,1,22,19,41,102,169,271,0,301,30,0,10,1.41667,0.0833333,19,73.7864,24,1
England,221,237.176,7.17647,0.289593,230.633,7.45701,0.384615,1,G Chapple,0,0,0,0,191,3,39,1,22,19,41,102,169,271,0,301,30,0,10,2,0,13,185.714,1,2
England,221,237.176,7.17647,0.289593,230.633,7.45701,0.384615,1,LE Plunkett,0,0,0,0,191,3,39,1,22,19,41,102,169,271,0,301,30,0,10,1.38095,0,13.1905,113.992,21,0
Ireland,55,219.527,7.65455,0.290909,202.727,7.56364,0.4,1,D Langford-Smith,5,0,5,6,155,6,38,2,8,30,38,90,141,231,302,263,32,1,10,0.888889,0,8.66667,92.8571,9,0
Ireland,55,219.527,7.65455,0.290909,202.727,7.56364,0.4,1,JF Mooney,10,6,4,8,155,6,38,2,8,30,38,90,141,231,302,263,32,1,10,1.47619,0,13.7619,72.796,21,1
Ireland,55,219.527,7.65455,0.290909,202.727,7.56364,0.4,1,PJK Mooney,0,0,0,0,155,6,38,2,8,30,38,90,141,231,302,263,32,1,10,0.5,0,4.5,112.5,2,0
England,221,237.176,7.17647,0.289593,230.633,7.45701,0.384615,3,CMW Read,1,0,1,3,192,4,32,2,16,23,39,108,155,263,0,271,8,1,10,1,0,10,80,6,1
England,221,237.176,7.17647,0.289593,230.633,7.45701,0.384615,3,PD Collingwood,49,16,33,56,192,4,32,2,16,23,39,108,155,263,0,271,8,1,10,2.62366,0.193548,30.5161,76.8065,93,4
England,221,237.176,7.17647,0.289593,230.633,7.45701,0.384615,3,J Lewis,0,0,0,0,192,4,32,2,16,23,39,108,155,263,0,271,8,1,10,0.571429,0,6,85.7143,7,1
England,221,237.176,7.17647,0.289593,230.633,7.45701,0.384615,3,SCJ Broad,0,0,0,0,192,4,32,2,16,23,39,108,155,263,0,271,8,1,10,0.725806,0,8.04839,74.0356,62,1
Pakistan,211,222.621,7.38389,0.393365,235.517,7.54976,0.336493,3,Abdul Razzaq,10,0,10,13,200,4,27,1,12,12,24,124,127,251,272,274,23,0,10,2.225,0.075,20.475,82.0641,40,4
Pakistan,211,222.621,7.38389,0.393365,235.517,7.54976,0.336493,3,Inzamam-ul-Haq,35,20,15,26,200,4,27,1,12,12,24,124,127,251,272,274,23,0,10,3.16667,0,26.9167,70.989,12,4
Pakistan,211,222.621,7.38389,0.393365,235.517,7.54976,0.336493,3,Kamran Akmal,0,0,0,0,200,4,27,1,12,12,24,124,127,251,272,274,23,0,10,3.01124,0.11236,23.0787,81.4433,89,4
Pakistan,211,222.621,7.38389,0.393365,235.517,7.54976,0.336493,3,Naved-ul-Hasan,0,0,0,0,200,4,27,1,12,12,24,124,127,251,272,274,23,0,10,1.15,0,11.35,83.4559,20,1
Pakistan,211,222.621,7.38389,0.393365,235.517,7.54976,0.336493,3,Shoaib Akhtar,0,0,0,0,200,4,27,1,12,12,24,124,127,251,272,274,23,0,10,0.421053,0,3.21053,67.033,19,1
Pakistan,211,222.621,7.38389,0.393365,235.517,7.54976,0.336493,4,Shoaib Akhtar,10,6,4,17,135,7,20,0,46,10,56,110,101,211,0,235,24,0,10,0.421053,0,3.21053,67.033,19,1
Pakistan,211,222.621,7.38389,0.393365,235.517,7.54976,0.336493,4,Abdul Razzaq,28,8,20,53,135,7,20,0,46,10,56,110,101,211,0,235,24,0,10,2.225,0.075,20.475,82.0641,40,4
Pakistan,211,222.621,7.38389,0.393365,235.517,7.54976,0.336493,4,Naved-ul-Hasan,0,0,0,0,135,7,20,0,46,10,56,110,101,211,0,235,24,0,10,1.15,0,11.35,83.4559,20,1
England,221,237.176,7.17647,0.289593,230.633,7.45701,0.384615,4,IR Bell,80,36,44,110,185,2,23,0,8,2,10,116,102,218,236,237,19,1,10,3.63433,0.246269,35.3806,75.6623,134,4
England,221,237.176,7.17647,0.289593,230.633,7.45701,0.384615,4,KP Pietersen,37,24,13,46,185,2,23,0,8,2,10,116,102,218,236,237,19,1,10,3.69892,0.236559,33.4946,82.2117,93,4
Pakistan,211,222.621,7.38389,0.393365,235.517,7.54976,0.336493,5,Iftikhar Anjum,3,0,3,19,102,8,13,1,4,11,15,38,92,130,0,154,24,0,10,0.666667,0,7.33333,58.7786,21,3
Sri Lanka,244,223.373,7.09016,0.344262,227.578,7.47541,0.385246,6,WPUJC Vaas,8,0,8,14,174,6,17,0,8,16,24,82,133,215,0,257,42,0,10,0.653846,0,8.65385,66.1765,26,1
Sri Lanka,244,223.373,7.09016,0.344262,227.578,7.47541,0.385246,6,WU Tharanga,111,52,59,154,174,6,17,0,8,16,24,82,133,215,0,257,42,0,10,3.93985,0.263158,32.9699,71.6035,133,4
Sri Lanka,244,223.373,7.09016,0.344262,227.578,7.47541,0.385246,6,SL Malinga,0,0,0,0,174,6,17,0,8,16,24,82,133,215,0,257,42,0,10,0.617284,0.0123457,4.97531,74.6296,81,1
Sri Lanka,244,223.373,7.09016,0.344262,227.578,7.47541,0.385246,6,CRD Fernando,0,0,0,0,174,6,17,0,8,16,24,82,133,215,0,257,42,0,10,0.571429,0,5.42857,64.7727,21,1
Sri Lanka,244,223.373,7.09016,0.344262,227.578,7.47541,0.385246,6,M Muralitharan,0,0,0,0,174,6,17,0,8,16,24,82,133,215,0,257,42,0,10,0.69697,0,5.63636,99.4652,33,0
England,221,237.176,7.17647,0.289593,230.633,7.45701,0.384615,6,TT Bresnan,15,4,11,19,168,6,28,0,4,25,29,70,155,225,258,237,12,1,10,1.52381,0.015873,13.8095,88.4146,63,0
England,221,237.176,7.17647,0.289593,230.633,7.45701,0.384615,6,JWM Dalrymple,66,20,46,85,168,6,28,0,4,25,29,70,155,225,258,237,12,1,10,1.41667,0.0833333,19,73.7864,24,1
England,221,237.176,7.17647,0.289593,230.633,7.45701,0.384615,6,SI Mahmood,0,0,0,0,168,6,28,0,4,25,29,70,155,225,258,237,12,1,10,0.888889,0,7.11111,81.0127,9,1
England,221,237.176,7.17647,0.289593,230.633,7.45701,0.384615,6,LE Plunkett,0,0,0,0,168,6,28,0,4,25,29,70,155,225,258,237,12,1,10,1.38095,0,13.1905,113.992,21,0
England,221,237.176,7.17647,0.289593,230.633,7.45701,0.384615,6,SJ Harmison,0,0,0,0,168,6,28,0,4,25,29,70,155,225,258,237,12,1,10,0.142857,0,5.14286,72,7,1
Sri Lanka,244,223.373,7.09016,0.344262,227.578,7.47541,0.385246,7,TM Dilshan,8,4,4,8,218,2,36,1,16,16,32,144,142,286,0,319,33,0,10,4.60199,0.273632,38.3632,86.0219,201,4
Sri Lanka,244,223.373,7.09016,0.344262,227.578,7.47541,0.385246,7,KC Sangakkara,41,18,23,36,218,2,36,1,16,16,32,144,142,286,0,319,33,0,10,4.33659,0.360976,41.9854,80.6276,205,4
Sri Lanka,244,223.373,7.09016,0.344262,227.578,7.47541,0.385246,7,RP Arnold,0,0,0,0,218,2,36,1,16,16,32,144,142,286,0,319,33,0,10,1.14286,0.142857,16.4286,73.2484,14,1
Sri Lanka,244,223.373,7.09016,0.344262,227.578,7.47541,0.385246,7,WPUJC Vaas,0,0,0,0,218,2,36,1,16,16,32,144,142,286,0,319,33,0,10,0.653846,0,8.65385,66.1765,26,1
Sri Lanka,244,223.373,7.09016,0.344262,227.578,7.47541,0.385246,7,SL Malinga,0,0,0,0,218,2,36,1,16,16,32,144,142,286,0,319,33,0,10,0.617284,0.0123457,4.97531,74.6296,81,1
Sri Lanka,244,223.373,7.09016,0.344262,227.578,7.47541,0.385246,7,M Muralitharan,0,0,0,0,218,2,36,1,16,16,32,144,142,286,0,319,33,0,10,0.69697,0,5.63636,99.4652,33,0
England,221,237.176,7.17647,0.289593,230.633,7.45701,0.384615,7,TT Bresnan,3,0,3,5,213,5,35,3,6,7,13,118,143,261,320,273,12,1,10,1.52381,0.015873,13.8095,88.4146,63,0
England,221,237.176,7.17647,0.289593,230.633,7.45701,0.384615,7,LE Plunkett,0,0,0,0,213,5,35,3,6,7,13,118,143,261,320,273,12,1,10,1.38095,0,13.1905,113.992,21,0
England,221,237.176,7.17647,0.289593,230.633,7.45701,0.384615,7,SJ Harmison,0,0,0,0,213,5,35,3,6,7,13,118,143,261,320,273,12,1,10,0.142857,0,5.14286,72,7,1
England,221,237.176,7.17647,0.289593,230.633,7.45701,0.384615,8,IR Bell,59,8,51,102,162,4,40,1,20,25,45,98,149,247,0,261,14,1,10,3.63433,0.246269,35.3806,75.6623,134,4
England,221,237.176,7.17647,0.289593,230.633,7.45701,0.384615,8,GO Jones,1,0,1,1,162,4,40,1,20,25,45,98,149,247,0,261,14,1,10,1.5,0,15.5,110.714,6,0
England,221,237.176,7.17647,0.289593,230.633,7.45701,0.384615,8,LE Plunkett,0,0,0,0,162,4,40,1,20,25,45,98,149,247,0,261,14,1,10,1.38095,0,13.1905,113.992,21,0
Sri Lanka,244,223.373,7.09016,0.344262,227.578,7.47541,0.385246,9,HMCM Bandara,4,0,4,5,208,6,25,1,42,13,55,122,166,288,0,318,30,0,10,1,0,12.2857,80.3738,7,1
Sri Lanka,244,223.373,7.09016,0.344262,227.578,7.47541,0.385246,9,MF Maharoof,27,8,19,38,208,6,25,1,42,13,55,122,166,288,0,318,30,0,10,1.38889,0.0277778,14.3611,81.2893,36,1
England,221,237.176,7.17647,0.289593,230.633,7.45701,0.384615,9,LE Plunkett,6,0,6,5,211,6,35,1,16,13,29,128,147,275,319,285,10,1,10,1.38095,0,13.1905,113.992,21,0
England,221,237.176,7.17647,0.289593,230.633,7.45701,0.384615,9,JWM Dalrymple,29,4,25,46,211,6,35,1,16,13,29,128,147,275,319,285,10,1,10,1.41667,0.0833333,19,73.7864,24,1
England,221,237.176,7.17647,0.289593,230.633,7.45701,0.384615,9,SJ Harmison,0,0,0,0,211,6,35,1,16,13,29,128,147,275,319,285,10,1,10,0.142857,0,5.14286,72,7,1
India,259,242.378,7.15058,0.339768,244.568,7.12741,0.30888,10,AB Agarkar,2,0,2,4,200,5,11,2,0,18,18,82,147,229,0,245,16,0,10,0.3125,0,5.75,44.6602,16,3
India,259,242.378,7.15058,0.339768,244.568,7.12741,0.30888,10,Harbhajan Singh,0,0,0,0,200,5,11,2,0,18,18,82,147,229,0,245,16,0,10,0.901639,0,9.98361,76.4115,61,1
India,259,242.378,7.15058,0.339768,244.568,7.12741,0.30888,10,S Sreesanth,0,0,0,0,200,5,11,2,0,18,18,82,147,229,0,245,16,0,10,0.125,0,2.4375,32.5,16,3
West Indies,176,217.33,7.15909,0.3125,225.278,7.57386,0.380682,10,S Chanderpaul,48,18,30,57,165,4,31,0,12,23,35,108,123,231,246,248,17,1,10,3.57143,0.396825,40.8254,68.0783,63,4
West Indies,176,217.33,7.15909,0.3125,225.278,7.57386,0.380682,10,RR Sarwan,92,44,48,108,165,4,31,0,12,23,35,108,123,231,246,248,17,1,10,2.8254,0.222222,29.1429,69.1005,63,4
West Indies,176,217.33,7.15909,0.3125,225.278,7.57386,0.380682,10,DJ Bravo,0,0,0,0,165,4,31,0,12,23,35,108,123,231,246,248,17,1,10,2.35514,0.11215,23.1589,80.9011,107,4
West Indies,176,217.33,7.15909,0.3125,225.278,7.57386,0.380682,10,CS Baugh,0,0,0,0,165,4,31,0,12,23,35,108,123,231,246,248,17,1,10,1.04545,0,14,60.9901,22,1
India,259,242.378,7.15058,0.339768,244.568,7.12741,0.30888,11,MS Dhoni,23,8,15,45,145,4,18,0,20,18,38,80,121,201,0,217,16,0,10,3.47872,0.292553,36.7713,84.1612,188,4
India,259,242.378,7.15058,0.339768,244.568,7.12741,0.30888,11,M Kaif,55,20,35,80,145,4,18,0,20,18,38,80,121,201,0,217,16,0,10,1.77778,0.222222,23.8889,61.4286,9,1
India,259,242.378,7.15058,0.339768,244.568,7.12741,0.30888,11,IK Pathan,0,0,0,0,145,4,18,0,20,18,38,80,121,201,0,217,16,0,10,1.875,0.025,16.85,78.2811,40,1
India,259,242.378,7.15058,0.339768,244.568,7.12741,0.30888,11,AB Agarkar,0,0,0,0,145,4,18,0,20,18,38,80,121,201,0,217,16,0,10,0.3125,0,5.75,44.6602,16,3
West Indies,176,217.33,7.15909,0.3125,225.278,7.57386,0.380682,12,WW Hinds,15,0,15,24,155,4,31,0,20,29,49,78,157,235,0,255,20,1,10,1.11111,0,12,38.9892,9,3
West Indies,176,217.33,7.15909,0.3125,225.278,7.57386,0.380682,12,DJ Bravo,32,4,28,29,155,4,31,0,20,29,49,78,157,235,0,255,20,1,10,2.35514,0.11215,23.1589,80.9011,107,4
West Indies,176,217.33,7.15909,0.3125,225.278,7.57386,0.380682,12,DR Smith,0,0,0,0,155,4,31,0,20,29,49,78,157,235,0,255,20,1,10,2.5,0.12,17.96,84.5574,50,1
West Indies,176,217.33,7.15909,0.3125,225.278,7.57386,0.380682,12,D Ramdin,0,0,0,0,155,4,31,0,20,29,49,78,157,235,0,255,20,1,10,1.7439,0.097561,19.1951,81.1759,82,1
India,259,242.378,7.15058,0.339768,244.568,7.12741,0.30888,12,Harbhajan Singh,19,8,11,26,178,7,23,0,4,11,15,90,126,216,256,236,20,0,10,0.901639,0,9.98361,76.4115,61,1
India,259,242.378,7.15058,0.339768,244.568,7.12741,0.30888,12,AB Agarkar,15,0,15,26,178,7,23,0,4,11,15,90,126,216,256,236,20,0,10,0.3125,0,5.75,44.6602,16,3
India,259,242.378,7.15058,0.339768,244.568,7.12741,0.30888,12,MM Patel,0,0,0,0,178,7,23,0,4,11,15,90,126,216,256,236,20,0,10,0.363636,0,3.22727,66.9811,22,1
India,259,242.378,7.15058,0.339768,244.568,7.12741,0.30888,12,S Sreesanth,0,0,0,0,178,7,23,0,4,11,15,90,126,216,256,236,20,0,10,0.125,0,2.4375,32.5,16,3
West Indies,176,217.33,7.15909,0.3125,225.278,7.57386,0.380682,13,DR Smith,1,0,1,1,148,3,28,3,38,16,54,138,92,230,0,241,11,1,10,2.5,0.12,17.96,84.5574,50,1
West Indies,176,217.33,7.15909,0.3125,225.278,7.57386,0.380682,13,DJ Bravo,4,0,4,8,148,3,28,3,38,16,54,138,92,230,0,241,11,1,10,2.35514,0.11215,23.1589,80.9011,107,4
West Indies,176,217.33,7.15909,0.3125,225.278,7.57386,0.380682,13,JE Taylor,0,0,0,0,148,3,28,3,38,16,54,138,92,230,0,241,11,1,10,0.903226,0,6.96774,83.3977,31,1
West Indies,176,217.33,7.15909,0.3125,225.278,7.57386,0.380682,13,DBL Powell,0,0,0,0,148,3,28,3,38,16,54,138,92,230,0,241,11,1,10,0.529412,0,5.76471,77.1654,17,1
West Indies,176,217.33,7.15909,0.3125,225.278,7.57386,0.380682,13,CD Collymore,0,0,0,0,148,3,28,3,38,16,54,138,92,230,0,241,11,1,10,0.333333,0,3.22222,59.1837,9,3
Pakistan,211,222.621,7.38389,0.393365,235.517,7.54976,0.336493,13,Shoaib Malik,54,26,28,46,140,6,31,1,4,8,12,72,111,183,242,187,4,0,10,2.77551,0.193878,28.7041,81.4418,98,4
Pakistan,211,222.621,7.38389,0.393365,235.517,7.54976,0.336493,13,Iftikhar Anjum,7,0,7,14,140,6,31,1,4,8,12,72,111,183,242,187,4,0,10,0.666667,0,7.33333,58.7786,21,3
Pakistan,211,222.621,7.38389,0.393365,235.517,7.54976,0.336493,13,Umar Gul,0,0,0,0,140,6,31,1,4,8,12,72,111,183,242,187,4,0,10,0.77193,0,7.14035,68.2886,57,1
Ireland,55,219.527,7.65455,0.290909,202.727,7.56364,0.4,16,JP Bray,91,44,47,122,152,6,20,2,12,27,39,100,111,211,0,221,10,0,10,2.7,0.1,23.4,63.0728,10,1
Ireland,55,219.527,7.65455,0.290909,202.727,7.56364,0.4,16,D Langford-Smith,0,0,0,3,152,6,20,2,12,27,39,100,111,211,0,221,10,0,10,0.888889,0,8.66667,92.8571,9,0
Zimbabwe,142,212.077,7.5,0.380282,227.704,6.97887,0.316901,16,GB Brent,1,0,1,6,166,5,32,1,0,13,13,110,101,211,222,221,10,0,10,0.75,0.0625,10.5,61.5385,16,1
Zimbabwe,142,212.077,7.5,0.380282,227.704,6.97887,0.316901,16,S Matsikenyeri,64,42,22,62,166,5,32,1,0,13,13,110,101,211,222,221,10,0,10,2,0.106383,19.9787,75.7869,47,1
Zimbabwe,142,212.077,7.5,0.380282,227.704,6.97887,0.316901,16,P Utseya,0,0,0,0,166,5,32,1,0,13,13,110,101,211,222,221,10,0,10,0.842105,0.0263158,11.8289,55.8385,76,3
England,221,237.176,7.17647,0.289593,230.633,7.45701,0.384615,18,PA Nixon,16,4,12,25,134,7,17,0,22,23,45,72,124,196,0,209,13,0,10,1.35294,0,16,79.3003,17,1
England,221,237.176,7.17647,0.289593,230.633,7.45701,0.384615,18,LE Plunkett,10,4,6,19,134,7,17,0,22,23,45,72,124,196,0,209,13,0,10,1.38095,0,13.1905,113.992,21,0
Pakistan,211,222.621,7.38389,0.393365,235.517,7.54976,0.336493,19,Iftikhar Anjum,7,0,7,43,97,8,5,1,0,1,1,52,51,103,0,132,29,0,10,0.666667,0,7.33333,58.7786,21,3
Pakistan,211,222.621,7.38389,0.393365,235.517,7.54976,0.336493,19,Umar Gul,1,0,1,11,97,8,5,1,0,1,1,52,51,103,0,132,29,0,10,0.77193,0,7.14035,68.2886,57,1
Zimbabwe,142,212.077,7.5,0.380282,227.704,6.97887,0.316901,23,SC Williams,58,24,34,76,124,4,25,1,16,14,30,74,105,179,0,202,23,0,10,2.56923,0.276923,28.5385,80.7927,65,4
Zimbabwe,142,212.077,7.5,0.380282,227.704,6.97887,0.316901,23,E Chigumbura,12,8,4,14,124,4,25,1,16,14,30,74,105,179,0,202,23,0,10,2.28947,0.114035,22.7895,77.7844,114,4
West Indies,176,217.33,7.15909,0.3125,225.278,7.57386,0.380682,23,BC Lara,30,4,26,57,143,4,20,0,14,5,19,100,82,182,203,204,22,1,10,3.35714,0.178571,29.3571,75.7604,28,4
West Indies,176,217.33,7.15909,0.3125,225.278,7.57386,0.380682,23,DJ Bravo,32,20,12,43,143,4,20,0,14,5,19,100,82,182,203,204,22,1,10,2.35514,0.11215,23.1589,80.9011,107,4
Sri Lanka,244,223.373,7.09016,0.344262,227.578,7.47541,0.385246,26,LPC Silva,29,18,11,32,206,2,35,1,36,17,53,152,142,294,0,318,24,0,10,2.55556,0.244444,26.0222,69.4543,45,4
Sri Lanka,244,223.373,7.09016,0.344262,227.578,7.47541,0.385246,26,ST Jayasuriya,84,48,36,80,206,2,35,1,36,17,53,152,142,294,0,318,24,0,10,4.91549,0.211268,33.9859,98.4898,71,0
Sri Lanka,244,223.373,7.09016,0.344262,227.578,7.47541,0.385246,26,RP Arnold,0,0,0,0,206,2,35,1,36,17,53,152,142,294,0,318,24,0,10,1.14286,0.142857,16.4286,73.2484,14,1
Pakistan,211,222.621,7.38389,0.393365,235.517,7.54976,0.336493,27,Mohammad Sami,4,0,4,6,238,4,47,3,32,16,48,204,129,333,0,349,16,0,10,1.75,0,16,56.6372,4,3
Pakistan,211,222.621,7.38389,0.393365,235.517,7.54976,0.336493,27,Iftikhar Anjum,1,0,1,1,238,4,47,3,32,16,48,204,129,333,0,349,16,0,10,0.666667,0,7.33333,58.7786,21,3
Pakistan,211,222.621,7.38389,0.393365,235.517,7.54976,0.336493,27,Umar Gul,0,0,0,0,238,4,47,3,32,16,48,204,129,333,0,349,16,0,10,0.77193,0,7.14035,68.2886,57,1
Pakistan,211,222.621,7.38389,0.393365,235.517,7.54976,0.336493,27,Danish Kaneria,0,0,0,0,238,4,47,3,32,16,48,204,129,333,0,349,16,0,10,1,0,2,50,1,3
Sri Lanka,244,223.373,7.09016,0.344262,227.578,7.47541,0.385246,29,TM Dilshan,34,8,26,38,154,4,31,0,30,12,42,94,133,227,0,254,27,0,10,4.60199,0.273632,38.3632,86.0219,201,4
Sri Lanka,244,223.373,7.09016,0.344262,227.578,7.47541,0.385246,29,RP Arnold,0,0,0,0,154,4,31,0,30,12,42,94,133,227,0,254,27,0,10,1.14286,0.142857,16.4286,73.2484,14,1
Sri Lanka,244,223.373,7.09016,0.344262,227.578,7.47541,0.385246,29,LPC Silva,59,20,39,70,154,4,31,0,30,12,42,94,133,227,0,254,27,0,10,2.55556,0.244444,26.0222,69.4543,45,4
Sri Lanka,244,223.373,7.09016,0.344262,227.578,7.47541,0.385246,29,WPUJC Vaas,0,0,0,0,154,4,31,0,30,12,42,94,133,227,0,254,27,0,10,0.653846,0,8.65385,66.1765,26,1
Ireland,55,219.527,7.65455,0.290909,202.727,7.56364,0.4,30,AR White,13,0,13,26,122,6,16,0,8,15,23,68,93,161,0,183,22,0,10,1.17647,0,14.1765,59.9502,17,1
Ireland,55,219.527,7.65455,0.290909,202.727,7.56364,0.4,30,WK McCallan,10,4,6,17,122,6,16,0,8,15,23,68,93,161,0,183,22,0,10,0.692308,0,7.69231,56.8182,13,3
Ireland,55,219.527,7.65455,0.290909,202.727,7.56364,0.4,30,JF Mooney,0,0,0,0,122,6,16,0,8,15,23,68,93,161,0,183,22,0,10,1.47619,0,13.7619,72.796,21,1
Ireland,55,219.527,7.65455,0.290909,202.727,7.56364,0.4,30,D Langford-Smith,0,0,0,0,122,6,16,0,8,15,23,68,93,161,0,183,22,0,10,0.888889,0,8.66667,92.8571,9,0
Australia,228,239.627,7.69737,0.372807,232.079,7.23246,0.337719,31,RT Ponting,91,44,47,92,274,2,40,0,30,19,49,226,137,363,0,377,14,0,10,4.17431,0.33945,38.1009,80.8606,109,4
Australia,228,239.627,7.69737,0.372807,232.079,7.23246,0.337719,31,A Symonds,0,0,0,0,274,2,40,0,30,19,49,226,137,363,0,377,14,0,10,3.44186,0.302326,32.0465,91.5615,43,4
Australia,228,239.627,7.69737,0.372807,232.079,7.23246,0.337719,31,MJ Clarke,80,42,38,72,274,2,40,0,30,19,49,226,137,363,0,377,14,0,10,3.10294,0.301471,35.9265,74.0303,136,4
Australia,228,239.627,7.69737,0.372807,232.079,7.23246,0.337719,31,MEK Hussey,0,0,0,0,274,2,40,0,30,19,49,226,137,363,0,377,14,0,10,2.7563,0.260504,34.084,82.4893,119,4
Australia,228,239.627,7.69737,0.372807,232.079,7.23246,0.337719,31,SR Watson,0,0,0,0,274,2,40,0,30,19,49,226,137,363,0,377,14,0,10,4.71318,0.286822,37.7907,90.0943,129,4
South Africa,190,234.274,7.4,0.373684,232.363,7.33158,0.342105,31,AJ Hall,0,0,0,3,244,4,18,4,4,11,15,164,113,277,378,294,17,0,10,1.4,0.1,14.4,87.8049,10,0
South Africa,190,234.274,7.4,0.373684,232.363,7.33158,0.342105,31,CK Langeveldt,0,0,0,5,244,4,18,4,4,11,15,164,113,277,378,294,17,0,10,0.571429,0,4.71429,59.4595,14,3
South Africa,190,234.274,7.4,0.373684,232.363,7.33158,0.342105,31,M Ntini,0,0,0,0,244,4,18,4,4,11,15,164,113,277,378,294,17,0,10,0.375,0,3.25,63.4146,16,1
Australia,228,239.627,7.69737,0.372807,232.079,7.23246,0.337719,34,SR Watson,10,0,10,11,208,4,44,1,36,13,49,144,157,301,0,322,21,0,10,4.71318,0.286822,37.7907,90.0943,129,4
Australia,228,239.627,7.69737,0.372807,232.079,7.23246,0.337719,34,ML Hayden,137,62,75,136,208,4,44,1,36,13,49,144,157,301,0,322,21,0,10,6.37838,0.378378,50.6757,83.3333,37,4
Australia,228,239.627,7.69737,0.372807,232.079,7.23246,0.337719,34,GB Hogg,0,0,0,0,208,4,44,1,36,13,49,144,157,301,0,322,21,0,10,0.769231,0,13.6923,69.5312,13,1
West Indies,176,217.33,7.15909,0.3125,225.278,7.57386,0.380682,34,DBL Powell,5,0,5,7,172,7,31,2,0,0,0,84,119,203,323,219,16,1,10,0.529412,0,5.76471,77.1654,17,1
Sri Lanka,244,223.373,7.09016,0.344262,227.578,7.47541,0.385246,35,TM Dilshan,57,16,41,73,155,5,26,0,4,16,20,72,129,201,0,209,8,0,10,4.60199,0.273632,38.3632,86.0219,201,4
Sri Lanka,244,223.373,7.09016,0.344262,227.578,7.47541,0.385246,35,RP Arnold,37,4,33,63,155,5,26,0,4,16,20,72,129,201,0,209,8,0,10,1.14286,0.142857,16.4286,73.2484,14,1
Sri Lanka,244,223.373,7.09016,0.344262,227.578,7.47541,0.385246,35,MF Maharoof,0,0,0,0,155,5,26,0,4,16,20,72,129,201,0,209,8,0,10,1.38889,0.0277778,14.3611,81.2893,36,1
Sri Lanka,244,223.373,7.09016,0.344262,227.578,7.47541,0.385246,35,WPUJC Vaas,0,0,0,0,155,5,26,0,4,16,20,72,129,201,0,209,8,0,10,0.653846,0,8.65385,66.1765,26,1
Sri Lanka,244,223.373,7.09016,0.344262,227.578,7.47541,0.385246,35,M Muralitharan,0,0,0,0,155,5,26,0,4,16,20,72,129,201,0,209,8,0,10,0.69697,0,5.63636,99.4652,33,0
Sri Lanka,244,223.373,7.09016,0.344262,227.578,7.47541,0.385246,35,SL Malinga,0,0,0,0,155,5,26,0,4,16,20,72,129,201,0,209,8,0,10,0.617284,0.0123457,4.97531,74.6296,81,1
South Africa,190,234.274,7.4,0.373684,232.363,7.33158,0.342105,35,JH Kallis,85,16,69,109,174,5,19,2,4,2,6,62,137,199,210,212,13,0,10,3.58621,0.356322,37.2644,76.4442,87,4
South Africa,190,234.274,7.4,0.373684,232.363,7.33158,0.342105,35,RJ Peterson,0,0,0,0,174,5,19,2,4,2,6,62,137,199,210,212,13,0,10,1.62069,0.0344828,15.7931,83.5766,29,1
South Africa,190,234.274,7.4,0.373684,232.363,7.33158,0.342105,35,M Ntini,0,0,0,0,174,5,19,2,4,2,6,62,137,199,210,212,13,0,10,0.375,0,3.25,63.4146,16,1
South Africa,190,234.274,7.4,0.373684,232.363,7.33158,0.342105,35,CK Langeveldt,0,0,0,0,174,5,19,2,4,2,6,62,137,199,210,212,13,0,10,0.571429,0,4.71429,59.4595,14,3
Sri Lanka,244,223.373,7.09016,0.344262,227.578,7.47541,0.385246,38,TM Dilshan,4,0,4,3,204,3,30,1,20,24,44,106,172,278,0,303,25,0,10,4.60199,0.273632,38.3632,86.0219,201,4
Sri Lanka,244,223.373,7.09016,0.344262,227.578,7.47541,0.385246,38,LPC Silva,18,0,18,24,204,3,30,1,20,24,44,106,172,278,0,303,25,0,10,2.55556,0.244444,26.0222,69.4543,45,4
Sri Lanka,244,223.373,7.09016,0.344262,227.578,7.47541,0.385246,38,RP Arnold,0,0,0,0,204,3,30,1,20,24,44,106,172,278,0,303,25,0,10,1.14286,0.142857,16.4286,73.2484,14,1
Bangladesh,160,218.438,7.70625,0.4,211.106,7.05,0.325,39,Mohammad Rafique,22,16,6,25,118,7,27,2,0,12,12,64,93,157,0,174,17,0,10,0.5,0,8.16667,63.2258,12,1
Bangladesh,160,218.438,7.70625,0.4,211.106,7.05,0.325,39,Syed Rasel,6,4,2,8,118,7,27,2,0,12,12,64,93,157,0,174,17,0,10,0.222222,0,2.88889,37.6812,18,3
Sri Lanka,244,223.373,7.09016,0.344262,227.578,7.47541,0.385246,41,RP Arnold,13,4,9,11,173,4,25,1,0,20,20,66,152,218,0,235,17,0,10,1.14286,0.142857,16.4286,73.2484,14,1
Sri Lanka,244,223.373,7.09016,0.344262,227.578,7.47541,0.385246,41,LPC Silva,20,8,12,33,173,4,25,1,0,20,20,66,152,218,0,235,17,0,10,2.55556,0.244444,26.0222,69.4543,45,4
Sri Lanka,244,223.373,7.09016,0.344262,227.578,7.47541,0.385246,41,WPUJC Vaas,0,0,0,0,173,4,25,1,0,20,20,66,152,218,0,235,17,0,10,0.653846,0,8.65385,66.1765,26,1
Sri Lanka,244,223.373,7.09016,0.344262,227.578,7.47541,0.385246,41,SL Malinga,0,0,0,0,173,4,25,1,0,20,20,66,152,218,0,235,17,0,10,0.617284,0.0123457,4.97531,74.6296,81,1
Sri Lanka,244,223.373,7.09016,0.344262,227.578,7.47541,0.385246,41,M Muralitharan,0,0,0,0,173,4,25,1,0,20,20,66,152,218,0,235,17,0,10,0.69697,0,5.63636,99.4652,33,0
Sri Lanka,244,223.373,7.09016,0.344262,227.578,7.47541,0.385246,41,CRD Fernando,0,0,0,0,173,4,25,1,0,20,20,66,152,218,0,235,17,0,10,0.571429,0,5.42857,64.7727,21,1
England,221,237.176,7.17647,0.289593,230.633,7.45701,0.384615,41,PA Nixon,19,0,19,33,154,6,27,0,22,24,46,84,143,227,236,233,6,0,10,1.35294,0,16,79.3003,17,1
England,221,237.176,7.17647,0.289593,230.633,7.45701,0.384615,41,RS Bopara,31,8,23,38,154,6,27,0,22,24,46,84,143,227,236,233,6,0,10,2.22115,0.144231,25.1538,75.9361,104,4
England,221,237.176,7.17647,0.289593,230.633,7.45701,0.384615,41,SI Mahmood,0,0,0,0,154,6,27,0,22,24,46,84,143,227,236,233,6,0,10,0.888889,0,7.11111,81.0127,9,1
Bangladesh,160,218.438,7.70625,0.4,211.106,7.05,0.325,42,Mohammad Ashraful,62,32,30,71,149,5,36,1,26,16,42,122,105,227,0,251,24,0,10,2.17722,0.113924,19.4557,63.9085,79,1
Bangladesh,160,218.438,7.70625,0.4,211.106,7.05,0.325,42,Mashrafe Mortaza,13,8,5,10,149,5,36,1,26,16,42,122,105,227,0,251,24,0,10,1.27536,0,11.1594,76.9231,69,1
Bangladesh,160,218.438,7.70625,0.4,211.106,7.05,0.325,42,Mohammad Rafique,0,0,0,0,149,5,36,1,26,16,42,122,105,227,0,251,24,0,10,0.5,0,8.16667,63.2258,12,1
Bangladesh,160,218.438,7.70625,0.4,211.106,7.05,0.325,42,Abdur Razzak,0,0,0,0,149,5,36,1,26,16,42,122,105,227,0,251,24,0,10,0.849315,0.0136986,8.39726,73.8554,73,1
South Africa,190,234.274,7.4,0.373684,232.363,7.33158,0.342105,42,HH Gibbs,45,10,35,53,133,8,15,0,10,12,22,58,112,170,252,184,14,0,10,4.61538,0.307692,35.6923,83.4157,52,4
South Africa,190,234.274,7.4,0.373684,232.363,7.33158,0.342105,42,CK Langeveldt,6,0,6,28,133,8,15,0,10,12,22,58,112,170,252,184,14,0,10,0.571429,0,4.71429,59.4595,14,3
South Africa,190,234.274,7.4,0.373684,232.363,7.33158,0.342105,42,M Ntini,0,0,0,0,133,8,15,0,10,12,22,58,112,170,252,184,14,0,10,0.375,0,3.25,63.4146,16,1
England,221,237.176,7.17647,0.289593,230.633,7.45701,0.384615,43,KP Pietersen,92,30,62,109,180,5,26,0,6,17,23,84,145,229,0,247,18,0,10,3.69892,0.236559,33.4946,82.2117,93,4
England,221,237.176,7.17647,0.289593,230.633,7.45701,0.384615,43,RS Bopara,19,8,11,32,180,5,26,0,6,17,23,84,145,229,0,247,18,0,10,2.22115,0.144231,25.1538,75.9361,104,4
England,221,237.176,7.17647,0.289593,230.633,7.45701,0.384615,43,PA Nixon,0,0,0,0,180,5,26,0,6,17,23,84,145,229,0,247,18,0,10,1.35294,0,16,79.3003,17,1
England,221,237.176,7.17647,0.289593,230.633,7.45701,0.384615,43,SI Mahmood,0,0,0,0,180,5,26,0,6,17,23,84,145,229,0,247,18,0,10,0.888889,0,7.11111,81.0127,9,1
England,221,237.176,7.17647,0.289593,230.633,7.45701,0.384615,43,MS Panesar,0,0,0,0,180,5,26,0,6,17,23,84,145,229,0,247,18,0,10,0.285714,0,3.71429,28.2609,7,3
England,221,237.176,7.17647,0.289593,230.633,7.45701,0.384615,43,JM Anderson,0,0,0,0,180,5,26,0,6,17,23,84,145,229,0,247,18,0,10,0.365385,0,3.92308,52.7132,52,3
Australia,228,239.627,7.69737,0.372807,232.079,7.23246,0.337719,43,A Symonds,19,14,5,17,194,2,30,1,8,5,13,118,119,237,248,248,11,0,10,3.44186,0.302326,32.0465,91.5615,43,4
Australia,228,239.627,7.69737,0.372807,232.079,7.23246,0.337719,43,MJ Clarke,51,8,43,60,194,2,30,1,8,5,13,118,119,237,248,248,11,0,10,3.10294,0.301471,35.9265,74.0303,136,4
New Zealand,184,233.745,7.39674,0.36413,227.951,7.30435,0.353261,44,BB McCullum,19,0,19,23,164,5,25,2,32,26,58,94,153,247,0,263,16,0,10,3.98611,0.201389,29.9028,98.4004,144,0
New Zealand,184,233.745,7.39674,0.36413,227.951,7.30435,0.353261,44,JEC Franklin,4,0,4,7,164,5,25,2,32,26,58,94,153,247,0,263,16,0,10,1.67308,0.0769231,18.7115,77.5299,52,1
South Africa,190,234.274,7.4,0.373684,232.363,7.33158,0.342105,45,MV Boucher,7,4,3,5,214,2,64,1,48,21,69,180,167,347,0,356,9,0,10,2.21053,0.0877193,22.2281,89.3512,57,0
South Africa,190,234.274,7.4,0.373684,232.363,7.33158,0.342105,45,HH Gibbs,37,20,17,28,214,2,64,1,48,21,69,180,167,347,0,356,9,0,10,4.61538,0.307692,35.6923,83.4157,52,4
West Indies,176,217.33,7.15909,0.3125,225.278,7.57386,0.380682,45,DBL Powell,26,14,12,20,215,8,33,0,18,16,34,118,164,282,357,289,7,1,10,0.529412,0,5.76471,77.1654,17,1
West Indies,176,217.33,7.15909,0.3125,225.278,7.57386,0.380682,45,IDR Bradshaw,20,4,16,44,215,8,33,0,18,16,34,118,164,282,357,289,7,1,10,0.571429,0,7.14286,47.619,7,3
West Indies,176,217.33,7.15909,0.3125,225.278,7.57386,0.380682,45,CD Collymore,0,0,0,0,215,8,33,0,18,16,34,118,164,282,357,289,7,1,10,0.333333,0,3.22222,59.1837,9,3
New Zealand,184,233.745,7.39674,0.36413,227.951,7.30435,0.353261,46,JEC Franklin,7,0,7,10,145,6,21,1,14,22,36,60,142,202,0,219,17,0,10,1.67308,0.0769231,18.7115,77.5299,52,1
New Zealand,184,233.745,7.39674,0.36413,227.951,7.30435,0.353261,46,SB Styris,93,24,69,144,145,6,21,1,14,22,36,60,142,202,0,219,17,0,10,3.20755,0.264151,33.8302,78.7094,53,4
Sri Lanka,244,223.373,7.09016,0.344262,227.578,7.47541,0.385246,46,KC Sangakkara,65,8,57,104,165,4,27,0,4,0,4,66,130,196,220,222,26,0,10,4.33659,0.360976,41.9854,80.6276,205,4
South Africa,190,234.274,7.4,0.373684,232.363,7.33158,0.342105,48,SM Pollock,4,0,4,14,127,4,20,2,14,21,35,50,132,182,0,193,11,0,10,1.58621,0.0689655,16.931,82.3826,29,1
South Africa,190,234.274,7.4,0.373684,232.363,7.33158,0.342105,48,AJ Hall,7,0,7,7,127,4,20,2,14,21,35,50,132,182,0,193,11,0,10,1.4,0.1,14.4,87.8049,10,0
South Africa,190,234.274,7.4,0.373684,232.363,7.33158,0.342105,48,RJ Peterson,0,0,0,0,127,4,20,2,14,21,35,50,132,182,0,193,11,0,10,1.62069,0.0344828,15.7931,83.5766,29,1
New Zealand,184,233.745,7.39674,0.36413,227.951,7.30435,0.353261,48,CD McMillan,37,14,23,49,143,3,28,1,8,5,13,78,106,184,194,196,12,0,10,3.8125,0.1875,29.75,83.9506,16,4
New Zealand,184,233.745,7.39674,0.36413,227.951,7.30435,0.353261,48,JDP Oram,2,0,2,6,143,3,28,1,8,5,13,78,106,184,194,196,12,0,10,2.70833,0.1875,25.0417,95.8533,48,0
New Zealand,184,233.745,7.39674,0.36413,227.951,7.30435,0.353261,48,BB McCullum,0,0,0,0,143,3,28,1,8,5,13,78,106,184,194,196,12,0,10,3.98611,0.201389,29.9028,98.4004,144,0
Ireland,55,219.527,7.65455,0.290909,202.727,7.56364,0.4,49,DT Johnston,7,0,7,10,149,3,23,1,24,24,48,58,162,220,0,243,23,0,10,1.27273,0,12.1818,74.2382,22,1
Ireland,55,219.527,7.65455,0.290909,202.727,7.56364,0.4,49,KJ O'Brien,34,14,20,38,149,3,23,1,24,24,48,58,162,220,0,243,23,0,10,2.64706,0.0588235,22.3824,79.4363,34,4
Ireland,55,219.527,7.65455,0.290909,202.727,7.56364,0.4,49,AR White,0,0,0,0,149,3,23,1,24,24,48,58,162,220,0,243,23,0,10,1.17647,0,14.1765,59.9502,17,1
Ireland,55,219.527,7.65455,0.290909,202.727,7.56364,0.4,49,D Langford-Smith,0,0,0,0,149,3,23,1,24,24,48,58,162,220,0,243,23,0,10,0.888889,0,8.66667,92.8571,9,0
Ireland,55,219.527,7.65455,0.290909,202.727,7.56364,0.4,49,AC Botha,0,0,0,0,149,3,23,1,24,24,48,58,162,220,0,243,23,0,10,1.25,0.0833333,14.3333,53.75,12,3
Sri Lanka,244,223.373,7.09016,0.344262,227.578,7.47541,0.385246,50,MF Maharoof,3,0,3,6,158,5,12,3,28,9,37,86,121,207,0,226,19,0,10,1.38889,0.0277778,14.3611,81.2893,36,1
Sri Lanka,244,223.373,7.09016,0.344262,227.578,7.47541,0.385246,50,HMCM Bandara,2,0,2,7,158,5,12,3,28,9,37,86,121,207,0,226,19,0,10,1,0,12.2857,80.3738,7,1
England,221,237.176,7.17647,0.289593,230.633,7.45701,0.384615,51,RS Bopara,20,12,8,29,122,8,9,1,4,3,7,58,80,138,0,154,16,0,10,2.22115,0.144231,25.1538,75.9361,104,4
England,221,237.176,7.17647,0.289593,230.633,7.45701,0.384615,51,JM Anderson,0,0,0,3,122,8,9,1,4,3,7,58,80,138,0,154,16,0,10,0.365385,0,3.92308,52.7132,52,3
West Indies,176,217.33,7.15909,0.3125,225.278,7.57386,0.380682,53,RR Sarwan,66,22,44,75,143,4,34,0,16,27,43,76,144,220,0,230,10,1,10,2.8254,0.222222,29.1429,69.1005,63,4
West Indies,176,217.33,7.15909,0.3125,225.278,7.57386,0.380682,53,BC Lara,24,10,14,22,143,4,34,0,16,27,43,76,144,220,0,230,10,1,10,3.35714,0.178571,29.3571,75.7604,28,4
West Indies,176,217.33,7.15909,0.3125,225.278,7.57386,0.380682,53,DJ Bravo,0,0,0,0,143,4,34,0,16,27,43,76,144,220,0,230,10,1,10,2.35514,0.11215,23.1589,80.9011,107,4
Australia,228,239.627,7.69737,0.372807,232.079,7.23246,0.337719,54,SR Watson,11,0,11,13,244,4,24,1,44,20,64,160,172,332,0,348,16,0,10,4.71318,0.286822,37.7907,90.0943,129,4
Australia,228,239.627,7.69737,0.372807,232.079,7.23246,0.337719,54,MEK Hussey,27,4,23,32,244,4,24,1,44,20,64,160,172,332,0,348,16,0,10,2.7563,0.260504,34.084,82.4893,119,4
Sri Lanka,244,223.373,7.09016,0.344262,227.578,7.47541,0.385246,55,TM Dilshan,30,12,18,26,175,4,45,0,38,14,52,134,138,272,0,289,17,0,10,4.60199,0.273632,38.3632,86.0219,201,4
Sri Lanka,244,223.373,7.09016,0.344262,227.578,7.47541,0.385246,55,RP Arnold,0,0,0,0,175,4,45,0,38,14,52,134,138,272,0,289,17,0,10,1.14286,0.142857,16.4286,73.2484,14,1
Sri Lanka,244,223.373,7.09016,0.344262,227.578,7.47541,0.385246,55,DPMD Jayawardene,77,28,49,93,175,4,45,0,38,14,52,134,138,272,0,289,17,0,10,3.20833,0.244792,31.6979,79.1109,192,4
Zimbabwe,142,212.077,7.5,0.380282,227.704,6.97887,0.316901,58,P Utseya,6,4,2,9,153,3,19,3,0,10,10,64,118,182,0,197,15,1,10,0.842105,0.0263158,11.8289,55.8385,76,3
Zimbabwe,142,212.077,7.5,0.380282,227.704,6.97887,0.316901,58,S Matsikenyeri,9,0,9,10,153,3,19,3,0,10,10,64,118,182,0,197,15,1,10,2,0.106383,19.9787,75.7869,47,1
Zimbabwe,142,212.077,7.5,0.380282,227.704,6.97887,0.316901,58,AJ Ireland,0,0,0,0,153,3,19,3,0,10,10,64,118,182,0,197,15,1,10,0.2,0,2.2,17.7419,5,3
South Africa,190,234.274,7.4,0.373684,232.363,7.33158,0.342105,59,JM Kemp,8,0,8,14,179,4,20,1,22,17,39,116,122,238,0,248,10,1,10,2.3,0.15,23.55,66.5254,20,1
South Africa,190,234.274,7.4,0.373684,232.363,7.33158,0.342105,59,SM Pollock,0,0,0,0,179,4,20,1,22,17,39,116,122,238,0,248,10,1,10,1.58621,0.0689655,16.931,82.3826,29,1
South Africa,190,234.274,7.4,0.373684,232.363,7.33158,0.342105,59,A Nel,0,0,0,0,179,4,20,1,22,17,39,116,122,238,0,248,10,1,10,1.06667,0,7.66667,81.5603,15,1
South Africa,190,234.274,7.4,0.373684,232.363,7.33158,0.342105,59,JH Kallis,102,52,50,146,179,4,20,1,22,17,39,116,122,238,0,248,10,1,10,3.58621,0.356322,37.2644,76.4442,87,4
South Africa,190,234.274,7.4,0.373684,232.363,7.33158,0.342105,60,AJ Hall,29,16,13,32,156,7,52,0,34,21,55,166,97,263,0,274,11,1,10,1.4,0.1,14.4,87.8049,10,0
South Africa,190,234.274,7.4,0.373684,232.363,7.33158,0.342105,60,JM Kemp,72,44,28,78,156,7,52,0,34,21,55,166,97,263,0,274,11,1,10,2.3,0.15,23.55,66.5254,20,1
South Africa,190,234.274,7.4,0.373684,232.363,7.33158,0.342105,61,SM Pollock,29,14,15,38,170,6,25,0,20,19,39,108,126,234,0,243,9,1,10,1.58621,0.0689655,16.931,82.3826,29,1
South Africa,190,234.274,7.4,0.373684,232.363,7.33158,0.342105,61,HH Gibbs,75,24,51,110,170,6,25,0,20,19,39,108,126,234,0,243,9,1,10,4.61538,0.307692,35.6923,83.4157,52,4
South Africa,190,234.274,7.4,0.373684,232.363,7.33158,0.342105,61,AJ Hall,0,0,0,0,170,6,25,0,20,19,39,108,126,234,0,243,9,1,10,1.4,0.1,14.4,87.8049,10,0
South Africa,190,234.274,7.4,0.373684,232.363,7.33158,0.342105,61,A Nel,0,0,0,0,170,6,25,0,20,19,39,108,126,234,0,243,9,1,10,1.06667,0,7.66667,81.5603,15,1
India,259,242.378,7.15058,0.339768,244.568,7.12741,0.30888,62,IK Pathan,5,0,5,5,127,4,29,1,18,13,31,90,97,187,0,200,13,0,10,1.875,0.025,16.85,78.2811,40,1
India,259,242.378,7.15058,0.339768,244.568,7.12741,0.30888,62,MS Dhoni,33,12,21,41,127,4,29,1,18,13,31,90,97,187,0,200,13,0,10,3.47872,0.292553,36.7713,84.1612,188,4
India,259,242.378,7.15058,0.339768,244.568,7.12741,0.30888,62,Harbhajan Singh,0,0,0,0,127,4,29,1,18,13,31,90,97,187,0,200,13,0,10,0.901639,0,9.98361,76.4115,61,1
India,259,242.378,7.15058,0.339768,244.568,7.12741,0.30888,62,Z Khan,0,0,0,0,127,4,29,1,18,13,31,90,97,187,0,200,13,0,10,0.974359,0,8.35897,60.9346,39,1
Australia,228,239.627,7.69737,0.372807,232.079,7.23246,0.337719,63,A Symonds,48,12,36,59,181,4,35,1,26,26,52,126,142,268,0,289,21,1,10,3.44186,0.302326,32.0465,91.5615,43,4
Australia,228,239.627,7.69737,0.372807,232.079,7.23246,0.337719,63,CL White,17,12,5,16,181,4,35,1,26,26,52,126,142,268,0,289,21,1,10,2.66176,0.191176,28.8235,80.1308,68,4
Australia,228,239.627,7.69737,0.372807,232.079,7.23246,0.337719,63,NW Bracken,0,0,0,0,181,4,35,1,26,26,52,126,142,268,0,289,21,1,10,0.391304,0,4.91304,62.4309,23,1
Australia,228,239.627,7.69737,0.372807,232.079,7.23246,0.337719,63,SR Clark,0,0,0,0,181,4,35,1,26,26,52,126,142,268,0,289,21,1,10,0.285714,0,4,54.902,7,3
Australia,228,239.627,7.69737,0.372807,232.079,7.23246,0.337719,63,MG Johnson,0,0,0,0,181,4,35,1,26,26,52,126,142,268,0,289,21,1,10,1.18519,0.0246914,10.7901,94.181,81,0
Australia,228,239.627,7.69737,0.372807,232.079,7.23246,0.337719,64,MEK Hussey,1,0,1,1,225,2,43,2,28,25,53,150,171,321,0,343,22,1,10,2.7563,0.260504,34.084,82.4893,119,4
Australia,228,239.627,7.69737,0.372807,232.079,7.23246,0.337719,64,A Symonds,19,12,7,9,225,2,43,2,28,25,53,150,171,321,0,343,22,1,10,3.44186,0.302326,32.0465,91.5615,43,4
Australia,228,239.627,7.69737,0.372807,232.079,7.23246,0.337719,64,CL White,0,0,0,0,225,2,43,2,28,25,53,150,171,321,0,343,22,1,10,2.66176,0.191176,28.8235,80.1308,68,4
New Zealand,184,233.745,7.39674,0.36413,227.951,7.30435,0.353261,64,JDP Oram,70,40,30,57,217,5,40,0,22,29,51,164,144,308,344,335,27,0,10,2.70833,0.1875,25.0417,95.8533,48,0
New Zealand,184,233.745,7.39674,0.36413,227.951,7.30435,0.353261,64,BB McCullum,26,12,14,28,217,5,40,0,22,29,51,164,144,308,344,335,27,0,10,3.98611,0.201389,29.9028,98.4004,144,0
New Zealand,184,233.745,7.39674,0.36413,227.951,7.30435,0.353261,65,BB McCullum,0,0,0,0,185,3,31,2,18,30,48,86,178,264,0,290,26,0,10,3.98611,0.201389,29.9028,98.4004,144,0
New Zealand,184,233.745,7.39674,0.36413,227.951,7.30435,0.353261,65,SB Styris,21,4,17,27,185,3,31,2,18,30,48,86,178,264,0,290,26,0,10,3.20755,0.264151,33.8302,78.7094,53,4
New Zealand,184,233.745,7.39674,0.36413,227.951,7.30435,0.353261,65,DL Vettori,0,0,0,0,185,3,31,2,18,30,48,86,178,264,0,290,26,0,10,1.43662,0.028169,15.7606,86.0108,71,0
New Zealand,184,233.745,7.39674,0.36413,227.951,7.30435,0.353261,65,JEC Franklin,0,0,0,0,185,3,31,2,18,30,48,86,178,264,0,290,26,0,10,1.67308,0.0769231,18.7115,77.5299,52,1
Australia,228,239.627,7.69737,0.372807,232.079,7.23246,0.337719,65,BJ Hodge,76,26,50,76,204,3,40,0,12,22,34,92,186,278,291,291,13,1,10,2.76923,0.153846,26.4615,83.9024,13,4
Australia,228,239.627,7.69737,0.372807,232.079,7.23246,0.337719,65,RT Ponting,102,30,72,109,204,3,40,0,12,22,34,92,186,278,291,291,13,1,10,4.17431,0.33945,38.1009,80.8606,109,4
Australia,228,239.627,7.69737,0.372807,232.079,7.23246,0.337719,65,MEK Hussey,0,0,0,0,204,3,40,0,12,22,34,92,186,278,291,291,13,1,10,2.7563,0.260504,34.084,82.4893,119,4
Australia,228,239.627,7.69737,0.372807,232.079,7.23246,0.337719,65,CL White,0,0,0,0,204,3,40,0,12,22,34,92,186,278,291,291,13,1,10,2.66176,0.191176,28.8235,80.1308,68,4
England,221,237.176,7.17647,0.289593,230.633,7.45701,0.384615,66,A Flintoff,24,12,12,25,175,4,27,2,8,26,34,90,146,236,0,242,6,0,10,2.4375,0.09375,22.5,86.5385,32,4
England,221,237.176,7.17647,0.289593,230.633,7.45701,0.384615,66,JWM Dalrymple,0,0,0,1,175,4,27,2,8,26,34,90,146,236,0,242,6,0,10,1.41667,0.0833333,19,73.7864,24,1
England,221,237.176,7.17647,0.289593,230.633,7.45701,0.384615,66,J Lewis,0,0,0,0,175,4,27,2,8,26,34,90,146,236,0,242,6,0,10,0.571429,0,6,85.7143,7,1
Australia,228,239.627,7.69737,0.372807,232.079,7.23246,0.337719,66,MJ Clarke,53,12,41,72,204,2,19,0,4,0,4,98,129,227,243,246,19,1,10,3.10294,0.301471,35.9265,74.0303,136,4
England,221,237.176,7.17647,0.289593,230.633,7.45701,0.384615,69,EC Joyce,104,40,64,142,180,3,43,1,26,18,44,116,151,267,0,292,25,0,10,3.08571,0.2,28.3429,68.6505,35,4
England,221,237.176,7.17647,0.289593,230.633,7.45701,0.384615,69,JWM Dalrymple,10,4,6,7,180,3,43,1,26,18,44,116,151,267,0,292,25,0,10,1.41667,0.0833333,19,73.7864,24,1
England,221,237.176,7.17647,0.289593,230.633,7.45701,0.384615,69,PA Nixon,0,0,0,0,180,3,43,1,26,18,44,116,151,267,0,292,25,0,10,1.35294,0,16,79.3003,17,1
England,221,237.176,7.17647,0.289593,230.633,7.45701,0.384615,69,RS Bopara,0,0,0,0,180,3,43,1,26,18,44,116,151,267,0,292,25,0,10,2.22115,0.144231,25.1538,75.9361,104,4
England,221,237.176,7.17647,0.289593,230.633,7.45701,0.384615,69,LE Plunkett,0,0,0,0,180,3,43,1,26,18,44,116,151,267,0,292,25,0,10,1.38095,0,13.1905,113.992,21,0
New Zealand,184,233.745,7.39674,0.36413,227.951,7.30435,0.353261,70,JEC Franklin,16,0,16,26,142,7,12,0,8,24,32,72,114,186,0,205,19,0,10,1.67308,0.0769231,18.7115,77.5299,52,1
New Zealand,184,233.745,7.39674,0.36413,227.951,7.30435,0.353261,70,SE Bond,4,0,4,22,142,7,12,0,8,24,32,72,114,186,0,205,19,0,10,0.5,0,7,71.7949,20,1
New Zealand,184,233.745,7.39674,0.36413,227.951,7.30435,0.353261,70,MR Gillespie,0,0,0,0,142,7,12,0,8,24,32,72,114,186,0,205,19,0,10,0.9,0,8,84.2105,10,1
England,221,237.176,7.17647,0.289593,230.633,7.45701,0.384615,70,A Flintoff,50,20,30,59,146,5,19,0,8,22,30,60,135,195,206,206,11,0,10,2.4375,0.09375,22.5,86.5385,32,4
England,221,237.176,7.17647,0.289593,230.633,7.45701,0.384615,70,PA Nixon,10,0,10,18,146,5,19,0,8,22,30,60,135,195,206,206,11,0,10,1.35294,0,16,79.3003,17,1
England,221,237.176,7.17647,0.289593,230.633,7.45701,0.384615,70,JWM Dalrymple,0,0,0,0,146,5,19,0,8,22,30,60,135,195,206,206,11,0,10,1.41667,0.0833333,19,73.7864,24,1
England,221,237.176,7.17647,0.289593,230.633,7.45701,0.384615,70,J Lewis,0,0,0,0,146,5,19,0,8,22,30,60,135,195,206,206,11,0,10,0.571429,0,6,85.7143,7,1
New Zealand,184,233.745,7.39674,0.36413,227.951,7.30435,0.353261,71,BB McCullum,26,0,26,50,125,5,37,0,14,21,35,74,123,197,0,210,13,0,10,3.98611,0.201389,29.9028,98.4004,144,0
New Zealand,184,233.745,7.39674,0.36413,227.951,7.30435,0.353261,71,JDP Oram,74,28,46,85,125,5,37,0,14,21,35,74,123,197,0,210,13,0,10,2.70833,0.1875,25.0417,95.8533,48,0
New Zealand,184,233.745,7.39674,0.36413,227.951,7.30435,0.353261,71,JEC Franklin,0,0,0,0,125,5,37,0,14,21,35,74,123,197,0,210,13,0,10,1.67308,0.0769231,18.7115,77.5299,52,1
New Zealand,184,233.745,7.39674,0.36413,227.951,7.30435,0.353261,71,DL Vettori,0,0,0,0,125,5,37,0,14,21,35,74,123,197,0,210,13,0,10,1.43662,0.028169,15.7606,86.0108,71,0
New Zealand,184,233.745,7.39674,0.36413,227.951,7.30435,0.353261,71,SE Bond,0,0,0,0,125,5,37,0,14,21,35,74,123,197,0,210,13,0,10,0.5,0,7,71.7949,20,1
New Zealand,184,233.745,7.39674,0.36413,227.951,7.30435,0.353261,71,MR Gillespie,0,0,0,0,125,5,37,0,14,21,35,74,123,197,0,210,13,0,10,0.9,0,8,84.2105,10,1
New Zealand,184,233.745,7.39674,0.36413,227.951,7.30435,0.353261,72,JDP Oram,7,0,7,15,191,4,27,2,40,23,63,140,141,281,0,318,37,0,10,2.70833,0.1875,25.0417,95.8533,48,0
New Zealand,184,233.745,7.39674,0.36413,227.951,7.30435,0.353261,72,JEC Franklin,4,0,4,4,191,4,27,2,40,23,63,140,141,281,0,318,37,0,10,1.67308,0.0769231,18.7115,77.5299,52,1
New Zealand,184,233.745,7.39674,0.36413,227.951,7.30435,0.353261,72,DL Vettori,0,0,0,0,191,4,27,2,40,23,63,140,141,281,0,318,37,0,10,1.43662,0.028169,15.7606,86.0108,71,0
England,221,237.176,7.17647,0.289593,230.633,7.45701,0.384615,72,LE Plunkett,5,0,5,10,171,6,37,1,16,18,34,96,146,242,319,260,18,0,10,1.38095,0,13.1905,113.992,21,0
England,221,237.176,7.17647,0.289593,230.633,7.45701,0.384615,72,PA Nixon,35,12,23,32,171,6,37,1,16,18,34,96,146,242,319,260,18,0,10,1.35294,0,16,79.3003,17,1
Australia,228,239.627,7.69737,0.372807,232.079,7.23246,0.337719,73,GB Hogg,8,4,4,8,207,4,23,2,0,9,9,70,169,239,0,252,13,1,10,0.769231,0,13.6923,69.5312,13,1
Australia,228,239.627,7.69737,0.372807,232.079,7.23246,0.337719,73,SR Watson,5,0,5,8,207,4,23,2,0,9,9,70,169,239,0,252,13,1,10,4.71318,0.286822,37.7907,90.0943,129,4
Australia,228,239.627,7.69737,0.372807,232.079,7.23246,0.337719,73,B Lee,0,0,0,0,207,4,23,2,0,9,9,70,169,239,0,252,13,1,10,1.09091,0.0227273,10.8182,81.5068,44,1
Australia,228,239.627,7.69737,0.372807,232.079,7.23246,0.337719,73,NW Bracken,0,0,0,0,207,4,23,2,0,9,9,70,169,239,0,252,13,1,10,0.391304,0,4.91304,62.4309,23,1
England,221,237.176,7.17647,0.289593,230.633,7.45701,0.384615,73,PD Collingwood,102,22,80,127,179,4,29,0,12,20,32,56,184,240,253,253,13,0,10,2.62366,0.193548,30.5161,76.8065,93,4
England,221,237.176,7.17647,0.289593,230.633,7.45701,0.384615,73,A Flintoff,35,6,29,35,179,4,29,0,12,20,32,56,184,240,253,253,13,0,10,2.4375,0.09375,22.5,86.5385,32,4
England,221,237.176,7.17647,0.289593,230.633,7.45701,0.384615,73,JWM Dalrymple,0,0,0,0,179,4,29,0,12,20,32,56,184,240,253,253,13,0,10,1.41667,0.0833333,19,73.7864,24,1
England,221,237.176,7.17647,0.289593,230.633,7.45701,0.384615,73,PA Nixon,0,0,0,0,179,4,29,0,12,20,32,56,184,240,253,253,13,0,10,1.35294,0,16,79.3003,17,1
England,221,237.176,7.17647,0.289593,230.633,7.45701,0.384615,74,PD Collingwood,61,8,53,88,168,4,30,1,0,25,25,78,145,223,0,246,23,0,10,2.62366,0.193548,30.5161,76.8065,93,4
England,221,237.176,7.17647,0.289593,230.633,7.45701,0.384615,74,JWM Dalrymple,3,0,3,5,168,4,30,1,0,25,25,78,145,223,0,246,23,0,10,1.41667,0.0833333,19,73.7864,24,1
England,221,237.176,7.17647,0.289593,230.633,7.45701,0.384615,74,PA Nixon,0,0,0,0,168,4,30,1,0,25,25,78,145,223,0,246,23,0,10,1.35294,0,16,79.3003,17,1
England,221,237.176,7.17647,0.289593,230.633,7.45701,0.384615,74,LE Plunkett,0,0,0,0,168,4,30,1,0,25,25,78,145,223,0,246,23,0,10,1.38095,0,13.1905,113.992,21,0
Sri Lanka,244,223.373,7.09016,0.344262,227.578,7.47541,0.385246,78,TM Dilshan,9,4,5,7,212,3,30,2,18,21,39,154,127,281,0,302,21,0,10,4.60199,0.273632,38.3632,86.0219,201,4
Sri Lanka,244,223.373,7.09016,0.344262,227.578,7.47541,0.385246,78,MF Maharoof,0,0,0,0,212,3,30,2,18,21,39,154,127,281,0,302,21,0,10,1.38889,0.0277778,14.3611,81.2893,36,1
Sri Lanka,244,223.373,7.09016,0.344262,227.578,7.47541,0.385246,78,WPUJC Vaas,0,0,0,0,212,3,30,2,18,21,39,154,127,281,0,302,21,0,10,0.653846,0,8.65385,66.1765,26,1
Sri Lanka,244,223.373,7.09016,0.344262,227.578,7.47541,0.385246,78,M Muralitharan,0,0,0,0,212,3,30,2,18,21,39,154,127,281,0,302,21,0,10,0.69697,0,5.63636,99.4652,33,0
Sri Lanka,244,223.373,7.09016,0.344262,227.578,7.47541,0.385246,78,SL Malinga,0,0,0,0,212,3,30,2,18,21,39,154,127,281,0,302,21,0,10,0.617284,0.0123457,4.97531,74.6296,81,1
Bangladesh,160,218.438,7.70625,0.4,211.106,7.05,0.325,78,Shakib Al Hasan,51,20,31,102,157,7,34,1,16,22,38,114,115,229,303,265,36,0,10,2.86992,0.252033,29.9106,79.0163,123,4
Bangladesh,160,218.438,7.70625,0.4,211.106,7.05,0.325,78,Abdur Razzak,0,0,0,0,157,7,34,1,16,22,38,114,115,229,303,265,36,0,10,0.849315,0.0136986,8.39726,73.8554,73,1
Bangladesh,160,218.438,7.70625,0.4,211.106,7.05,0.325,78,Syed Rasel,0,0,0,0,157,7,34,1,16,22,38,114,115,229,303,265,36,0,10,0.222222,0,2.88889,37.6812,18,3
Sri Lanka,244,223.373,7.09016,0.344262,227.578,7.47541,0.385246,80,MF Maharoof,9,4,5,13,206,4,30,1,8,26,34,106,164,270,0,285,15,0,10,1.38889,0.0277778,14.3611,81.2893,36,1
Sri Lanka,244,223.373,7.09016,0.344262,227.578,7.47541,0.385246,80,MS Atapattu,18,8,10,17,206,4,30,1,8,26,34,106,164,270,0,285,15,0,10,2.63636,0,24.4545,66.9154,11,4
Sri Lanka,244,223.373,7.09016,0.344262,227.578,7.47541,0.385246,80,M Muralitharan,0,0,0,0,206,4,30,1,8,26,34,106,164,270,0,285,15,0,10,0.69697,0,5.63636,99.4652,33,0
Sri Lanka,244,223.373,7.09016,0.344262,227.578,7.47541,0.385246,80,SL Malinga,0,0,0,0,206,4,30,1,8,26,34,106,164,270,0,285,15,0,10,0.617284,0.0123457,4.97531,74.6296,81,1
Bangladesh,160,218.438,7.70625,0.4,211.106,7.05,0.325,81,Khaled Mashud,19,0,19,54,143,8,7,1,0,4,4,68,86,154,0,161,7,0,10,0.333333,0,13.6667,43.1579,3,3
Bangladesh,160,218.438,7.70625,0.4,211.106,7.05,0.325,81,Syed Rasel,2,0,2,13,143,8,7,1,0,4,4,68,86,154,0,161,7,0,10,0.222222,0,2.88889,37.6812,18,3
New Zealand,184,233.745,7.39674,0.36413,227.951,7.30435,0.353261,84,JS Patel,1,0,1,4,156,7,18,2,0,1,1,80,95,175,0,195,20,0,10,0.7,0,8.4,60,10,3
New Zealand,184,233.745,7.39674,0.36413,227.951,7.30435,0.353261,84,KD Mills,4,0,4,10,156,7,18,2,0,1,1,80,95,175,0,195,20,0,10,1.52542,0.0338983,12.8644,90.7895,59,0
Sri Lanka,244,223.373,7.09016,0.344262,227.578,7.47541,0.385246,85,MF Maharoof,21,8,13,42,202,5,18,1,4,12,16,104,132,236,0,253,17,0,10,1.38889,0.0277778,14.3611,81.2893,36,1
Sri Lanka,244,223.373,7.09016,0.344262,227.578,7.47541,0.385246,85,WPUJC Vaas,4,0,4,6,202,5,18,1,4,12,16,104,132,236,0,253,17,0,10,0.653846,0,8.65385,66.1765,26,1
Sri Lanka,244,223.373,7.09016,0.344262,227.578,7.47541,0.385246,85,M Muralitharan,0,0,0,0,202,5,18,1,4,12,16,104,132,236,0,253,17,0,10,0.69697,0,5.63636,99.4652,33,0
Sri Lanka,244,223.373,7.09016,0.344262,227.578,7.47541,0.385246,85,SL Malinga,0,0,0,0,202,5,18,1,4,12,16,104,132,236,0,253,17,0,10,0.617284,0.0123457,4.97531,74.6296,81,1
Sri Lanka,244,223.373,7.09016,0.344262,227.578,7.47541,0.385246,85,CRD Fernando,0,0,0,0,202,5,18,1,4,12,16,104,132,236,0,253,17,0,10,0.571429,0,5.42857,64.7727,21,1
Pakistan,211,222.621,7.38389,0.393365,235.517,7.54976,0.336493,85,Abdul Razzaq,7,0,7,10,171,5,28,1,24,13,37,102,134,236,254,255,19,0,10,2.225,0.075,20.475,82.0641,40,4
Pakistan,211,222.621,7.38389,0.393365,235.517,7.54976,0.336493,85,Shoaib Malik,40,6,34,56,171,5,28,1,24,13,37,102,134,236,254,255,19,0,10,2.77551,0.193878,28.7041,81.4418,98,4
West Indies,176,217.33,7.15909,0.3125,225.278,7.57386,0.380682,86,CS Baugh,5,4,1,3,160,4,40,1,10,19,29,118,111,229,0,234,5,0,10,1.04545,0,14,60.9901,22,1
West Indies,176,217.33,7.15909,0.3125,225.278,7.57386,0.380682,86,RS Morton,70,24,46,89,160,4,40,1,10,19,29,118,111,229,0,234,5,0,10,2.2963,0.222222,28.8889,67.0103,27,4
West Indies,176,217.33,7.15909,0.3125,225.278,7.57386,0.380682,86,MN Samuels,0,0,0,0,160,4,40,1,10,19,29,118,111,229,0,234,5,0,10,3.74757,0.23301,31.6214,74.5821,103,4
Australia,228,239.627,7.69737,0.372807,232.079,7.23246,0.337719,86,MJ Clarke,46,16,30,83,156,4,27,1,4,17,21,92,112,204,235,224,20,0,10,3.10294,0.301471,35.9265,74.0303,136,4
Australia,228,239.627,7.69737,0.372807,232.079,7.23246,0.337719,86,MEK Hussey,9,4,5,9,156,4,27,1,4,17,21,92,112,204,235,224,20,0,10,2.7563,0.260504,34.084,82.4893,119,4
Australia,228,239.627,7.69737,0.372807,232.079,7.23246,0.337719,86,GB Hogg,0,0,0,0,156,4,27,1,4,17,21,92,112,204,235,224,20,0,10,0.769231,0,13.6923,69.5312,13,1
Australia,228,239.627,7.69737,0.372807,232.079,7.23246,0.337719,86,B Lee,0,0,0,0,156,4,27,1,4,17,21,92,112,204,235,224,20,0,10,1.09091,0.0227273,10.8182,81.5068,44,1
Australia,228,239.627,7.69737,0.372807,232.079,7.23246,0.337719,86,NW Bracken,0,0,0,0,156,4,27,1,4,17,21,92,112,204,235,224,20,0,10,0.391304,0,4.91304,62.4309,23,1
New Zealand,184,233.745,7.39674,0.36413,227.951,7.30435,0.353261,87,JS Patel,7,0,7,29,100,9,10,0,16,14,30,56,84,140,0,165,25,0,10,0.7,0,8.4,60,10,3
New Zealand,184,233.745,7.39674,0.36413,227.951,7.30435,0.353261,87,DL Vettori,19,4,15,37,100,9,10,0,16,14,30,56,84,140,0,165,25,0,10,1.43662,0.028169,15.7606,86.0108,71,0
South Africa,190,234.274,7.4,0.373684,232.363,7.33158,0.342105,89,MV Boucher,29,6,23,39,142,5,25,1,24,15,39,72,134,206,0,219,13,0,10,2.21053,0.0877193,22.2281,89.3512,57,0
South Africa,190,234.274,7.4,0.373684,232.363,7.33158,0.342105,89,RJ Peterson,0,0,0,0,142,5,25,1,24,15,39,72,134,206,0,219,13,0,10,1.62069,0.0344828,15.7931,83.5766,29,1
South Africa,190,234.274,7.4,0.373684,232.363,7.33158,0.342105,89,SM Pollock,5,0,5,6,142,5,25,1,24,15,39,72,134,206,0,219,13,0,10,1.58621,0.0689655,16.931,82.3826,29,1
South Africa,190,234.274,7.4,0.373684,232.363,7.33158,0.342105,89,A Nel,0,0,0,0,142,5,25,1,24,15,39,72,134,206,0,219,13,0,10,1.06667,0,7.66667,81.5603,15,1
South Africa,190,234.274,7.4,0.373684,232.363,7.33158,0.342105,89,M Ntini,0,0,0,0,142,5,25,1,24,15,39,72,134,206,0,219,13,0,10,0.375,0,3.25,63.4146,16,1
New Zealand,184,233.745,7.39674,0.36413,227.951,7.30435,0.353261,90,JDP Oram,27,18,9,24,163,4,40,0,34,21,55,138,120,258,0,274,16,0,10,2.70833,0.1875,25.0417,95.8533,48,0
New Zealand,184,233.745,7.39674,0.36413,227.951,7.30435,0.353261,90,SB Styris,71,32,39,105,163,4,40,0,34,21,55,138,120,258,0,274,16,0,10,3.20755,0.264151,33.8302,78.7094,53,4
New Zealand,184,233.745,7.39674,0.36413,227.951,7.30435,0.353261,90,BB McCullum,0,0,0,0,163,4,40,0,34,21,55,138,120,258,0,274,16,0,10,3.98611,0.201389,29.9028,98.4004,144,0
New Zealand,184,233.745,7.39674,0.36413,227.951,7.30435,0.353261,90,JEC Franklin,0,0,0,0,163,4,40,0,34,21,55,138,120,258,0,274,16,0,10,1.67308,0.0769231,18.7115,77.5299,52,1
Pakistan,211,222.621,7.38389,0.393365,235.517,7.54976,0.336493,90,Umar Gul,4,0,4,8,180,5,22,3,0,7,7,92,117,209,275,223,14,0,10,0.77193,0,7.14035,68.2886,57,1
Pakistan,211,222.621,7.38389,0.393365,235.517,7.54976,0.336493,90,Kamran Akmal,13,4,9,10,180,5,22,3,0,7,7,92,117,209,275,223,14,0,10,3.01124,0.11236,23.0787,81.4433,89,4
South Africa,190,234.274,7.4,0.373684,232.363,7.33158,0.342105,91,JM Kemp,50,22,28,98,138,5,22,1,14,13,27,88,99,187,0,213,26,0,10,2.3,0.15,23.55,66.5254,20,1
South Africa,190,234.274,7.4,0.373684,232.363,7.33158,0.342105,91,SM Pollock,1,0,1,4,138,5,22,1,14,13,27,88,99,187,0,213,26,0,10,1.58621,0.0689655,16.931,82.3826,29,1
South Africa,190,234.274,7.4,0.373684,232.363,7.33158,0.342105,91,A Nel,0,0,0,0,138,5,22,1,14,13,27,88,99,187,0,213,26,0,10,1.06667,0,7.66667,81.5603,15,1
South Africa,190,234.274,7.4,0.373684,232.363,7.33158,0.342105,91,M Ntini,0,0,0,0,138,5,22,1,14,13,27,88,99,187,0,213,26,0,10,0.375,0,3.25,63.4146,16,1
West Indies,176,217.33,7.15909,0.3125,225.278,7.57386,0.380682,92,DJ Bravo,92,50,42,116,189,1,30,1,20,22,42,134,127,261,0,272,11,0,10,2.35514,0.11215,23.1589,80.9011,107,4
West Indies,176,217.33,7.15909,0.3125,225.278,7.57386,0.380682,92,RR Sarwan,13,10,3,9,189,1,30,1,20,22,42,134,127,261,0,272,11,0,10,2.8254,0.222222,29.1429,69.1005,63,4
West Indies,176,217.33,7.15909,0.3125,225.278,7.57386,0.380682,92,BC Lara,0,0,0,0,189,1,30,1,20,22,42,134,127,261,0,272,11,0,10,3.35714,0.178571,29.3571,75.7604,28,4
West Indies,176,217.33,7.15909,0.3125,225.278,7.57386,0.380682,92,MN Samuels,0,0,0,0,189,1,30,1,20,22,42,134,127,261,0,272,11,0,10,3.74757,0.23301,31.6214,74.5821,103,4
England,221,237.176,7.17647,0.289593,230.633,7.45701,0.384615,92,KP Pietersen,65,24,41,77,184,5,30,2,26,11,37,126,125,251,273,276,25,0,10,3.69892,0.236559,33.4946,82.2117,93,4
England,221,237.176,7.17647,0.289593,230.633,7.45701,0.384615,92,SI Mahmood,2,0,2,2,184,5,30,2,26,11,37,126,125,251,273,276,25,0,10,0.888889,0,7.11111,81.0127,9,1
India,259,242.378,7.15058,0.339768,244.568,7.12741,0.30888,93,MS Dhoni,9,4,5,9,166,3,23,2,12,30,42,108,123,231,0,249,18,1,10,3.47872,0.292553,36.7713,84.1612,188,4
India,259,242.378,7.15058,0.339768,244.568,7.12741,0.30888,93,SK Raina,5,4,1,15,166,3,23,2,12,30,42,108,123,231,0,249,18,1,10,3.11111,0.216374,28.9064,91.8944,171,0
India,259,242.378,7.15058,0.339768,244.568,7.12741,0.30888,93,IK Pathan,0,0,0,0,166,3,23,2,12,30,42,108,123,231,0,249,18,1,10,1.875,0.025,16.85,78.2811,40,1
India,259,242.378,7.15058,0.339768,244.568,7.12741,0.30888,93,Harbhajan Singh,0,0,0,0,166,3,23,2,12,30,42,108,123,231,0,249,18,1,10,0.901639,0,9.98361,76.4115,61,1
Australia,228,239.627,7.69737,0.372807,232.079,7.23246,0.337719,93,MJ Clarke,1,0,1,5,193,3,26,1,4,3,7,124,102,226,250,252,26,0,10,3.10294,0.301471,35.9265,74.0303,136,4
Australia,228,239.627,7.69737,0.372807,232.079,7.23246,0.337719,93,DR Martyn,67,28,39,105,193,3,26,1,4,3,7,124,102,226,250,252,26,0,10,5.71429,0.428571,44.5714,65.1357,7,4
Australia,228,239.627,7.69737,0.372807,232.079,7.23246,0.337719,94,MJ Clarke,9,0,9,17,168,4,19,1,14,16,30,92,125,217,0,240,23,0,10,3.10294,0.301471,35.9265,74.0303,136,4
Australia,228,239.627,7.69737,0.372807,232.079,7.23246,0.337719,94,A Symonds,56,18,38,57,168,4,19,1,14,16,30,92,125,217,0,240,23,0,10,3.44186,0.302326,32.0465,91.5615,43,4
Australia,228,239.627,7.69737,0.372807,232.079,7.23246,0.337719,94,B Lee,0,0,0,0,168,4,19,1,14,16,30,92,125,217,0,240,23,0,10,1.09091,0.0227273,10.8182,81.5068,44,1
Australia,228,239.627,7.69737,0.372807,232.079,7.23246,0.337719,94,MG Johnson,0,0,0,0,168,4,19,1,14,16,30,92,125,217,0,240,23,0,10,1.18519,0.0246914,10.7901,94.181,81,0
Australia,228,239.627,7.69737,0.372807,232.079,7.23246,0.337719,94,NW Bracken,0,0,0,0,168,4,19,1,14,16,30,92,125,217,0,240,23,0,10,0.391304,0,4.91304,62.4309,23,1
New Zealand,184,233.745,7.39674,0.36413,227.951,7.30435,0.353261,94,KD Mills,16,10,6,12,143,8,35,1,4,2,6,78,106,184,241,206,22,0,10,1.52542,0.0338983,12.8644,90.7895,59,0
New Zealand,184,233.745,7.39674,0.36413,227.951,7.30435,0.353261,94,SE Bond,8,4,4,10,143,8,35,1,4,2,6,78,106,184,241,206,22,0,10,0.5,0,7,71.7949,20,1
South Africa,190,234.274,7.4,0.373684,232.363,7.33158,0.342105,95,MV Boucher,10,4,6,9,167,3,30,2,16,22,38,96,139,235,0,258,23,0,10,2.21053,0.0877193,22.2281,89.3512,57,0
South Africa,190,234.274,7.4,0.373684,232.363,7.33158,0.342105,95,HH Gibbs,64,16,48,81,167,3,30,2,16,22,38,96,139,235,0,258,23,0,10,4.61538,0.307692,35.6923,83.4157,52,4
South Africa,190,234.274,7.4,0.373684,232.363,7.33158,0.342105,95,SM Pollock,0,0,0,0,167,3,30,2,16,22,38,96,139,235,0,258,23,0,10,1.58621,0.0689655,16.931,82.3826,29,1
South Africa,190,234.274,7.4,0.373684,232.363,7.33158,0.342105,95,RJ Peterson,0,0,0,0,167,3,30,2,16,22,38,96,139,235,0,258,23,0,10,1.62069,0.0344828,15.7931,83.5766,29,1
South Africa,190,234.274,7.4,0.373684,232.363,7.33158,0.342105,95,A Nel,0,0,0,0,167,3,30,2,16,22,38,96,139,235,0,258,23,0,10,1.06667,0,7.66667,81.5603,15,1
South Africa,190,234.274,7.4,0.373684,232.363,7.33158,0.342105,97,MV Boucher,55,40,15,29,227,4,60,0,56,18,74,216,145,361,0,392,31,1,10,2.21053,0.0877193,22.2281,89.3512,57,0
South Africa,190,234.274,7.4,0.373684,232.363,7.33158,0.342105,97,JH Kallis,50,4,46,70,227,4,60,0,56,18,74,216,145,361,0,392,31,1,10,3.58621,0.356322,37.2644,76.4442,87,4
South Africa,190,234.274,7.4,0.373684,232.363,7.33158,0.342105,97,JM Kemp,0,0,0,0,227,4,60,0,56,18,74,216,145,361,0,392,31,1,10,2.3,0.15,23.55,66.5254,20,1
South Africa,190,234.274,7.4,0.373684,232.363,7.33158,0.342105,97,SM Pollock,0,0,0,0,227,4,60,0,56,18,74,216,145,361,0,392,31,1,10,1.58621,0.0689655,16.931,82.3826,29,1
Pakistan,211,222.621,7.38389,0.393365,235.517,7.54976,0.336493,97,Shoaib Malik,50,24,26,85,195,9,27,0,0,2,2,134,90,224,393,228,4,0,10,2.77551,0.193878,28.7041,81.4418,98,4
Pakistan,211,222.621,7.38389,0.393365,235.517,7.54976,0.336493,98,Shahid Afridi,46,36,10,19,222,4,73,0,28,18,46,206,135,341,0,351,10,0,10,2.72917,0.0972222,21.4097,127.766,144,0
Pakistan,211,222.621,7.38389,0.393365,235.517,7.54976,0.336493,98,Mohammad Yousuf,86,40,46,99,222,4,73,0,28,18,46,206,135,341,0,351,10,0,10,3.27586,0.275862,36.7931,73.9176,58,4
Pakistan,211,222.621,7.38389,0.393365,235.517,7.54976,0.336493,99,Inzamam-ul-Haq,44,16,28,95,95,8,5,1,0,1,1,36,65,101,0,107,6,0,10,3.16667,0,26.9167,70.989,12,4
New Zealand,184,233.745,7.39674,0.36413,227.951,7.30435,0.353261,100,HJH Marshall,12,4,8,14,218,3,16,2,22,17,39,138,135,273,0,285,12,1,10,1.1,0.1,11.4,69.5122,10,1
New Zealand,184,233.745,7.39674,0.36413,227.951,7.30435,0.353261,100,LRPL Taylor,100,54,46,116,218,3,16,2,22,17,39,138,135,273,0,285,12,1,10,3.68382,0.301471,36.7206,79.3959,136,4
New Zealand,184,233.745,7.39674,0.36413,227.951,7.30435,0.353261,100,JEC Franklin,0,0,0,0,218,3,16,2,22,17,39,138,135,273,0,285,12,1,10,1.67308,0.0769231,18.7115,77.5299,52,1
New Zealand,184,233.745,7.39674,0.36413,227.951,7.30435,0.353261,100,MR Gillespie,0,0,0,0,218,3,16,2,22,17,39,138,135,273,0,285,12,1,10,0.9,0,8,84.2105,10,1
Sri Lanka,244,223.373,7.09016,0.344262,227.578,7.47541,0.385246,102,KC Sangakkara,62,24,38,95,172,3,19,1,34,16,50,132,109,241,0,262,21,0,10,4.33659,0.360976,41.9854,80.6276,205,4
Sri Lanka,244,223.373,7.09016,0.344262,227.578,7.47541,0.385246,102,CK Kapugedera,3,0,3,9,172,3,19,1,34,16,50,132,109,241,0,262,21,0,10,1.74138,0.12069,21.1379,68.6066,58,1
Sri Lanka,244,223.373,7.09016,0.344262,227.578,7.47541,0.385246,102,MF Maharoof,0,0,0,0,172,3,19,1,34,16,50,132,109,241,0,262,21,0,10,1.38889,0.0277778,14.3611,81.2893,36,1
Sri Lanka,244,223.373,7.09016,0.344262,227.578,7.47541,0.385246,102,WPUJC Vaas,0,0,0,0,172,3,19,1,34,16,50,132,109,241,0,262,21,0,10,0.653846,0,8.65385,66.1765,26,1
Australia,228,239.627,7.69737,0.372807,232.079,7.23246,0.337719,103,MG Johnson,5,4,1,8,106,6,16,1,4,13,17,48,91,139,0,148,9,0,10,1.18519,0.0246914,10.7901,94.181,81,0
Australia,228,239.627,7.69737,0.372807,232.079,7.23246,0.337719,103,GB Hogg,11,4,7,15,106,6,16,1,4,13,17,48,91,139,0,148,9,0,10,0.769231,0,13.6923,69.5312,13,1
Australia,228,239.627,7.69737,0.372807,232.079,7.23246,0.337719,103,NW Bracken,0,0,0,0,106,6,16,1,4,13,17,48,91,139,0,148,9,0,10,0.391304,0,4.91304,62.4309,23,1
Australia,228,239.627,7.69737,0.372807,232.079,7.23246,0.337719,104,BJ Hodge,68,38,30,67,213,3,50,1,34,23,57,202,118,320,0,336,16,0,10,2.76923,0.153846,26.4615,83.9024,13,4
Australia,228,239.627,7.69737,0.372807,232.079,7.23246,0.337719,104,CL White,14,10,4,7,213,3,50,1,34,23,57,202,118,320,0,336,16,0,10,2.66176,0.191176,28.8235,80.1308,68,4
New Zealand,184,233.745,7.39674,0.36413,227.951,7.30435,0.353261,104,PG Fulton,69,32,37,59,224,4,56,0,16,20,36,178,138,316,337,340,24,1,10,2.75,0.1875,27.4062,67.4615,32,4
New Zealand,184,233.745,7.39674,0.36413,227.951,7.30435,0.353261,104,CD McMillan,45,34,11,26,224,4,56,0,16,20,36,178,138,316,337,340,24,1,10,3.8125,0.1875,29.75,83.9506,16,4
New Zealand,184,233.745,7.39674,0.36413,227.951,7.30435,0.353261,104,BB McCullum,0,0,0,0,224,4,56,0,16,20,36,178,138,316,337,340,24,1,10,3.98611,0.201389,29.9028,98.4004,144,0
Australia,228,239.627,7.69737,0.372807,232.079,7.23246,0.337719,105,ML Hayden,146,78,68,152,220,2,57,2,44,20,64,188,153,341,0,346,5,0,10,6.37838,0.378378,50.6757,83.3333,37,4
Australia,228,239.627,7.69737,0.372807,232.079,7.23246,0.337719,105,CL White,0,0,0,2,220,2,57,2,44,20,64,188,153,341,0,346,5,0,10,2.66176,0.191176,28.8235,80.1308,68,4
Australia,228,239.627,7.69737,0.372807,232.079,7.23246,0.337719,105,AC Voges,0,0,0,0,220,2,57,2,44,20,64,188,153,341,0,346,5,0,10,2.29167,0.125,29.625,84.142,24,4
New Zealand,184,233.745,7.39674,0.36413,227.951,7.30435,0.353261,105,BB McCullum,67,22,45,79,247,5,29,3,22,25,47,192,131,323,347,350,27,1,10,3.98611,0.201389,29.9028,98.4004,144,0
New Zealand,184,233.745,7.39674,0.36413,227.951,7.30435,0.353261,105,MR Gillespie,0,0,0,1,247,5,29,3,22,25,47,192,131,323,347,350,27,1,10,0.9,0,8,84.2105,10,1
Zimbabwe,142,212.077,7.5,0.380282,227.704,6.97887,0.316901,106,P Utseya,9,4,5,17,143,5,11,1,8,23,31,70,115,185,0,201,16,0,10,0.842105,0.0263158,11.8289,55.8385,76,3
Zimbabwe,142,212.077,7.5,0.380282,227.704,6.97887,0.316901,106,E Chigumbura,2,0,2,12,143,5,11,1,8,23,31,70,115,185,0,201,16,0,10,2.28947,0.114035,22.7895,77.7844,114,4
Zimbabwe,142,212.077,7.5,0.380282,227.704,6.97887,0.316901,106,T Mupariwa,0,0,0,0,143,5,11,1,8,23,31,70,115,185,0,201,16,0,10,0.416667,0,3.58333,39.0909,12,3
India,259,242.378,7.15058,0.339768,244.568,7.12741,0.30888,107,SK Raina,13,4,9,14,202,3,23,1,36,16,52,152,125,277,0,309,32,0,10,3.11111,0.216374,28.9064,91.8944,171,0
India,259,242.378,7.15058,0.339768,244.568,7.12741,0.30888,107,SR Tendulkar,111,58,53,138,202,3,23,1,36,16,52,152,125,277,0,309,32,0,10,5.89773,0.363636,45.6023,84.5376,88,4
India,259,242.378,7.15058,0.339768,244.568,7.12741,0.30888,107,M Kaif,0,0,0,0,202,3,23,1,36,16,52,152,125,277,0,309,32,0,10,1.77778,0.222222,23.8889,61.4286,9,1
Australia,228,239.627,7.69737,0.372807,232.079,7.23246,0.337719,108,BJ Haddin,56,28,28,66,172,5,36,0,34,18,52,134,126,260,0,272,12,0,10,3.14737,0.147368,26.7789,81.382,95,4
Australia,228,239.627,7.69737,0.372807,232.079,7.23246,0.337719,108,MEK Hussey,72,32,40,76,172,5,36,0,34,18,52,134,126,260,0,272,12,0,10,2.7563,0.260504,34.084,82.4893,119,4
Australia,228,239.627,7.69737,0.372807,232.079,7.23246,0.337719,108,B Lee,0,0,0,0,172,5,36,0,34,18,52,134,126,260,0,272,12,0,10,1.09091,0.0227273,10.8182,81.5068,44,1
West Indies,176,217.33,7.15909,0.3125,225.278,7.57386,0.380682,108,DJ Bravo,27,8,19,49,210,3,13,4,10,7,17,138,102,240,273,273,33,0,10,2.35514,0.11215,23.1589,80.9011,107,4
West Indies,176,217.33,7.15909,0.3125,225.278,7.57386,0.380682,108,CS Baugh,0,0,0,7,210,3,13,4,10,7,17,138,102,240,273,273,33,0,10,1.04545,0,14,60.9901,22,1
Australia,228,239.627,7.69737,0.372807,232.079,7.23246,0.337719,109,GB Hogg,34,14,20,43,154,6,27,1,0,13,13,96,98,194,0,213,19,0,10,0.769231,0,13.6923,69.5312,13,1
Australia,228,239.627,7.69737,0.372807,232.079,7.23246,0.337719,109,B Lee,0,0,0,0,154,6,27,1,0,13,13,96,98,194,0,213,19,0,10,1.09091,0.0227273,10.8182,81.5068,44,1
Australia,228,239.627,7.69737,0.372807,232.079,7.23246,0.337719,109,SR Clark,0,0,0,0,154,6,27,1,0,13,13,96,98,194,0,213,19,0,10,0.285714,0,4,54.902,7,3
Australia,228,239.627,7.69737,0.372807,232.079,7.23246,0.337719,110,MEK Hussey,6,0,6,10,153,4,26,1,20,24,44,82,141,223,0,240,17,0,10,2.7563,0.260504,34.084,82.4893,119,4
Australia,228,239.627,7.69737,0.372807,232.079,7.23246,0.337719,110,MJ Clarke,20,0,20,22,153,4,26,1,20,24,44,82,141,223,0,240,17,0,10,3.10294,0.301471,35.9265,74.0303,136,4
Australia,228,239.627,7.69737,0.372807,232.079,7.23246,0.337719,110,BJ Haddin,0,0,0,0,153,4,26,1,20,24,44,82,141,223,0,240,17,0,10,3.14737,0.147368,26.7789,81.382,95,4
South Africa,190,234.274,7.4,0.373684,232.363,7.33158,0.342105,111,JP Duminy,6,0,6,6,297,3,56,2,22,29,51,234,170,404,0,418,14,1,10,2.3252,0.186992,29.9675,80.2351,123,4
South Africa,190,234.274,7.4,0.373684,232.363,7.33158,0.342105,111,MV Boucher,114,78,36,50,297,3,56,2,22,29,51,234,170,404,0,418,14,1,10,2.21053,0.0877193,22.2281,89.3512,57,0
Zimbabwe,142,212.077,7.5,0.380282,227.704,6.97887,0.316901,111,S Matsikenyeri,1,0,1,1,157,2,33,2,12,22,34,86,138,224,419,247,23,0,10,2,0.106383,19.9787,75.7869,47,1
Zimbabwe,142,212.077,7.5,0.380282,227.704,6.97887,0.316901,111,BRM Taylor,0,0,0,5,157,2,33,2,12,22,34,86,138,224,419,247,23,0,10,3.3,0.26,33.56,76.3421,100,4
West Indies,176,217.33,7.15909,0.3125,225.278,7.57386,0.380682,112,D Ramdin,16,6,10,31,97,6,20,0,12,14,26,42,101,143,0,151,8,0,10,1.7439,0.097561,19.1951,81.1759,82,1
West Indies,176,217.33,7.15909,0.3125,225.278,7.57386,0.380682,112,RS Morton,29,8,21,56,97,6,20,0,12,14,26,42,101,143,0,151,8,0,10,2.2963,0.222222,28.8889,67.0103,27,4
West Indies,176,217.33,7.15909,0.3125,225.278,7.57386,0.380682,112,IDR Bradshaw,0,0,0,0,97,6,20,0,12,14,26,42,101,143,0,151,8,0,10,0.571429,0,7.14286,47.619,7,3
West Indies,176,217.33,7.15909,0.3125,225.278,7.57386,0.380682,112,JE Taylor,0,0,0,0,97,6,20,0,12,14,26,42,101,143,0,151,8,0,10,0.903226,0,6.96774,83.3977,31,1
West Indies,176,217.33,7.15909,0.3125,225.278,7.57386,0.380682,112,CD Collymore,0,0,0,0,97,6,20,0,12,14,26,42,101,143,0,151,8,0,10,0.333333,0,3.22222,59.1837,9,3
Pakistan,211,222.621,7.38389,0.393365,235.517,7.54976,0.336493,112,Inzamam-ul-Haq,36,12,24,85,102,5,26,2,4,7,11,48,91,139,152,154,15,1,10,3.16667,0,26.9167,70.989,12,4
Pakistan,211,222.621,7.38389,0.393365,235.517,7.54976,0.336493,112,Abdur Rehman,5,0,5,9,102,5,26,2,4,7,11,48,91,139,152,154,15,1,10,0.52381,0,6.04762,55.7018,21,3
Pakistan,211,222.621,7.38389,0.393365,235.517,7.54976,0.336493,112,Iftikhar Anjum,0,0,0,0,102,5,26,2,4,7,11,48,91,139,152,154,15,1,10,0.666667,0,7.33333,58.7786,21,3
West Indies,176,217.33,7.15909,0.3125,225.278,7.57386,0.380682,113,LMP Simmons,69,28,41,130,147,5,28,1,8,1,9,92,92,184,0,207,23,0,10,3.3125,0.28125,30.5938,71.4338,64,4
West Indies,176,217.33,7.15909,0.3125,225.278,7.57386,0.380682,113,D Ramdin,2,0,2,2,147,5,28,1,8,1,9,92,92,184,0,207,23,0,10,1.7439,0.097561,19.1951,81.1759,82,1
West Indies,176,217.33,7.15909,0.3125,225.278,7.57386,0.380682,113,IDR Bradshaw,0,0,0,0,147,5,28,1,8,1,9,92,92,184,0,207,23,0,10,0.571429,0,7.14286,47.619,7,3
Pakistan,211,222.621,7.38389,0.393365,235.517,7.54976,0.336493,114,Abdul Razzaq,14,0,14,31,123,5,31,2,8,25,33,50,137,187,0,209,22,1,10,2.225,0.075,20.475,82.0641,40,4
Pakistan,211,222.621,7.38389,0.393365,235.517,7.54976,0.336493,114,Naved-ul-Hasan,13,10,3,9,123,5,31,2,8,25,33,50,137,187,0,209,22,1,10,1.15,0,11.35,83.4559,20,1
Pakistan,211,222.621,7.38389,0.393365,235.517,7.54976,0.336493,114,Mohammad Sami,0,0,0,0,123,5,31,2,8,25,33,50,137,187,0,209,22,1,10,1.75,0,16,56.6372,4,3
Pakistan,211,222.621,7.38389,0.393365,235.517,7.54976,0.336493,114,Iftikhar Anjum,0,0,0,0,123,5,31,2,8,25,33,50,137,187,0,209,22,1,10,0.666667,0,7.33333,58.7786,21,3
West Indies,176,217.33,7.15909,0.3125,225.278,7.57386,0.380682,115,S Chanderpaul,92,28,64,133,167,3,22,2,10,14,24,74,139,213,0,238,25,0,10,3.57143,0.396825,40.8254,68.0783,63,4
West Indies,176,217.33,7.15909,0.3125,225.278,7.57386,0.380682,115,RS Morton,0,0,0,1,167,3,22,2,10,14,24,74,139,213,0,238,25,0,10,2.2963,0.222222,28.8889,67.0103,27,4
West Indies,176,217.33,7.15909,0.3125,225.278,7.57386,0.380682,115,DR Smith,0,0,0,0,167,3,22,2,10,14,24,74,139,213,0,238,25,0,10,2.5,0.12,17.96,84.5574,50,1
Pakistan,211,222.621,7.38389,0.393365,235.517,7.54976,0.336493,115,Abdul Razzaq,1,0,1,3,189,2,27,1,4,10,14,94,136,230,239,239,9,0,10,2.225,0.075,20.475,82.0641,40,4
Pakistan,211,222.621,7.38389,0.393365,235.517,7.54976,0.336493,115,Shoaib Malik,26,12,14,31,189,2,27,1,4,10,14,94,136,230,239,239,9,0,10,2.77551,0.193878,28.7041,81.4418,98,4
England,221,237.176,7.17647,0.289593,230.633,7.45701,0.384615,116,AD Mascarenhas,1,0,1,3,149,3,29,2,12,16,28,48,158,206,0,225,19,1,10,1.83333,0.0833333,18.5,89.5161,12,0
England,221,237.176,7.17647,0.289593,230.633,7.45701,0.384615,116,OA Shah,20,4,16,26,149,3,29,2,12,16,28,48,158,206,0,225,19,1,10,3.13043,0.23913,32.6739,81.1994,46,4
England,221,237.176,7.17647,0.289593,230.633,7.45701,0.384615,116,LE Plunkett,0,0,0,0,149,3,29,2,12,16,28,48,158,206,0,225,19,1,10,1.38095,0,13.1905,113.992,21,0
England,221,237.176,7.17647,0.289593,230.633,7.45701,0.384615,116,SCJ Broad,0,0,0,0,149,3,29,2,12,16,28,48,158,206,0,225,19,1,10,0.725806,0,8.04839,74.0356,62,1
England,221,237.176,7.17647,0.289593,230.633,7.45701,0.384615,116,MS Panesar,0,0,0,0,149,3,29,2,12,16,28,48,158,206,0,225,19,1,10,0.285714,0,3.71429,28.2609,7,3
England,221,237.176,7.17647,0.289593,230.633,7.45701,0.384615,116,JM Anderson,0,0,0,0,149,3,29,2,12,16,28,48,158,206,0,225,19,1,10,0.365385,0,3.92308,52.7132,52,3
West Indies,176,217.33,7.15909,0.3125,225.278,7.57386,0.380682,117,MN Samuels,76,34,42,102,160,2,60,0,20,18,38,132,126,258,0,278,20,0,10,3.74757,0.23301,31.6214,74.5821,103,4
West Indies,176,217.33,7.15909,0.3125,225.278,7.57386,0.380682,117,S Chanderpaul,91,44,47,113,160,2,60,0,20,18,38,132,126,258,0,278,20,0,10,3.57143,0.396825,40.8254,68.0783,63,4
West Indies,176,217.33,7.15909,0.3125,225.278,7.57386,0.380682,117,DR Smith,0,0,0,0,160,2,60,0,20,18,38,132,126,258,0,278,20,0,10,2.5,0.12,17.96,84.5574,50,1
West Indies,176,217.33,7.15909,0.3125,225.278,7.57386,0.380682,117,RS Morton,0,0,0,0,160,2,60,0,20,18,38,132,126,258,0,278,20,0,10,2.2963,0.222222,28.8889,67.0103,27,4
West Indies,176,217.33,7.15909,0.3125,225.278,7.57386,0.380682,117,D Ramdin,0,0,0,0,160,2,60,0,20,18,38,132,126,258,0,278,20,0,10,1.7439,0.097561,19.1951,81.1759,82,1
England,221,237.176,7.17647,0.289593,230.633,7.45701,0.384615,117,JM Anderson,1,0,1,13,155,8,33,1,0,2,2,68,122,190,279,217,27,1,10,0.365385,0,3.92308,52.7132,52,3
England,221,237.176,7.17647,0.289593,230.633,7.45701,0.384615,118,IR Bell,103,38,65,103,203,1,35,1,12,30,42,96,184,280,0,288,8,1,10,3.63433,0.246269,35.3806,75.6623,134,4
England,221,237.176,7.17647,0.289593,230.633,7.45701,0.384615,118,KP Pietersen,14,8,6,11,203,1,35,1,12,30,42,96,184,280,0,288,8,1,10,3.69892,0.236559,33.4946,82.2117,93,4
India,259,242.378,7.15058,0.339768,244.568,7.12741,0.30888,118,KD Karthik,32,12,20,35,115,7,21,1,16,12,28,58,106,164,289,184,20,0,10,2.46429,0.107143,21.6786,71.8769,56,1
India,259,242.378,7.15058,0.339768,244.568,7.12741,0.30888,118,Z Khan,4,4,0,13,115,7,21,1,16,12,28,58,106,164,289,184,20,0,10,0.974359,0,8.35897,60.9346,39,1
India,259,242.378,7.15058,0.339768,244.568,7.12741,0.30888,118,RP Singh,0,0,0,0,115,7,21,1,16,12,28,58,106,164,289,184,20,0,10,0.333333,0,5.6,39.8104,15,3
India,259,242.378,7.15058,0.339768,244.568,7.12741,0.30888,119,MS Dhoni,18,12,6,14,216,2,44,1,22,22,44,178,126,304,0,329,25,0,10,3.47872,0.292553,36.7713,84.1612,188,4
India,259,242.378,7.15058,0.339768,244.568,7.12741,0.30888,119,R Dravid,55,28,27,47,216,2,44,1,22,22,44,178,126,304,0,329,25,0,10,2.83721,0.255814,29.8605,72.7067,43,4
India,259,242.378,7.15058,0.339768,244.568,7.12741,0.30888,119,KD Karthik,0,0,0,0,216,2,44,1,22,22,44,178,126,304,0,329,25,0,10,2.46429,0.107143,21.6786,71.8769,56,1
India,259,242.378,7.15058,0.339768,244.568,7.12741,0.30888,119,AB Agarkar,0,0,0,0,216,2,44,1,22,22,44,178,126,304,0,329,25,0,10,0.3125,0,5.75,44.6602,16,3
India,259,242.378,7.15058,0.339768,244.568,7.12741,0.30888,119,RR Powar,0,0,0,0,216,2,44,1,22,22,44,178,126,304,0,329,25,0,10,0.333333,0,5.77778,51.4851,9,3
India,259,242.378,7.15058,0.339768,244.568,7.12741,0.30888,119,PP Chawla,0,0,0,0,216,2,44,1,22,22,44,178,126,304,0,329,25,0,10,0.25,0,3.16667,63.3333,12,1
England,221,237.176,7.17647,0.289593,230.633,7.45701,0.384615,119,SCJ Broad,6,0,6,11,210,6,36,1,36,10,46,180,112,292,330,320,28,1,10,0.725806,0,8.04839,74.0356,62,1
England,221,237.176,7.17647,0.289593,230.633,7.45701,0.384615,119,AD Mascarenhas,29,18,11,23,210,6,36,1,36,10,46,180,112,292,330,320,28,1,10,1.83333,0.0833333,18.5,89.5161,12,0
England,221,237.176,7.17647,0.289593,230.633,7.45701,0.384615,119,CT Tremlett,0,0,0,0,210,6,36,1,36,10,46,180,112,292,330,320,28,1,10,0.4,0,4.2,57.5342,10,3
England,221,237.176,7.17647,0.289593,230.633,7.45701,0.384615,120,RS Bopara,4,0,4,6,185,4,39,1,18,22,40,94,170,264,0,281,17,1,10,2.22115,0.144231,25.1538,75.9361,104,4
England,221,237.176,7.17647,0.289593,230.633,7.45701,0.384615,120,SCJ Broad,0,0,0,0,185,4,39,1,18,22,40,94,170,264,0,281,17,1,10,0.725806,0,8.04839,74.0356,62,1
England,221,237.176,7.17647,0.289593,230.633,7.45701,0.384615,120,IR Bell,74,20,54,83,185,4,39,1,18,22,40,94,170,264,0,281,17,1,10,3.63433,0.246269,35.3806,75.6623,134,4
England,221,237.176,7.17647,0.289593,230.633,7.45701,0.384615,120,CT Tremlett,0,0,0,0,185,4,39,1,18,22,40,94,170,264,0,281,17,1,10,0.4,0,4.2,57.5342,10,3
India,259,242.378,7.15058,0.339768,244.568,7.12741,0.30888,120,Z Khan,5,4,1,7,185,5,25,3,4,10,14,110,114,224,282,239,15,0,10,0.974359,0,8.35897,60.9346,39,1
India,259,242.378,7.15058,0.339768,244.568,7.12741,0.30888,120,RP Singh,5,0,5,5,185,5,25,3,4,10,14,110,114,224,282,239,15,0,10,0.333333,0,5.6,39.8104,15,3
India,259,242.378,7.15058,0.339768,244.568,7.12741,0.30888,120,MM Patel,0,0,0,0,185,5,25,3,4,10,14,110,114,224,282,239,15,0,10,0.363636,0,3.22727,66.9811,22,1
India,259,242.378,7.15058,0.339768,244.568,7.12741,0.30888,121,PP Chawla,1,0,1,1,136,6,31,2,16,16,32,98,101,199,0,212,13,0,10,0.25,0,3.16667,63.3333,12,1
India,259,242.378,7.15058,0.339768,244.568,7.12741,0.30888,121,Z Khan,0,0,0,2,136,6,31,2,16,16,32,98,101,199,0,212,13,0,10,0.974359,0,8.35897,60.9346,39,1
India,259,242.378,7.15058,0.339768,244.568,7.12741,0.30888,121,RP Singh,0,0,0,0,136,6,31,2,16,16,32,98,101,199,0,212,13,0,10,0.333333,0,5.6,39.8104,15,3
England,221,237.176,7.17647,0.289593,230.633,7.45701,0.384615,121,SCJ Broad,38,16,22,66,162,7,22,0,0,10,10,92,102,194,213,213,19,1,10,0.725806,0,8.04839,74.0356,62,1
England,221,237.176,7.17647,0.289593,230.633,7.45701,0.384615,121,RS Bopara,40,12,28,77,162,7,22,0,0,10,10,92,102,194,213,213,19,1,10,2.22115,0.144231,25.1538,75.9361,104,4
India,259,242.378,7.15058,0.339768,244.568,7.12741,0.30888,122,MS Dhoni,6,0,6,8,220,2,40,2,34,13,47,198,109,307,0,324,17,0,10,3.47872,0.292553,36.7713,84.1612,188,4
India,259,242.378,7.15058,0.339768,244.568,7.12741,0.30888,122,R Dravid,1,0,1,2,220,2,40,2,34,13,47,198,109,307,0,324,17,0,10,2.83721,0.255814,29.8605,72.7067,43,4
India,259,242.378,7.15058,0.339768,244.568,7.12741,0.30888,122,KD Karthik,0,0,0,0,220,2,40,2,34,13,47,198,109,307,0,324,17,0,10,2.46429,0.107143,21.6786,71.8769,56,1
India,259,242.378,7.15058,0.339768,244.568,7.12741,0.30888,122,Z Khan,0,0,0,0,220,2,40,2,34,13,47,198,109,307,0,324,17,0,10,0.974359,0,8.35897,60.9346,39,1
England,221,237.176,7.17647,0.289593,230.633,7.45701,0.384615,123,AD Mascarenhas,1,0,1,2,192,5,43,1,50,17,67,180,122,302,0,316,14,1,10,1.83333,0.0833333,18.5,89.5161,12,0
England,221,237.176,7.17647,0.289593,230.633,7.45701,0.384615,123,OA Shah,75,36,39,80,192,5,43,1,50,17,67,180,122,302,0,316,14,1,10,3.13043,0.23913,32.6739,81.1994,46,4
India,259,242.378,7.15058,0.339768,244.568,7.12741,0.30888,123,RV Uthappa,14,8,6,15,220,4,32,1,28,19,47,170,129,299,317,317,18,0,10,3,0.117647,22.1471,89.0071,34,0
India,259,242.378,7.15058,0.339768,244.568,7.12741,0.30888,123,MS Dhoni,22,8,14,29,220,4,32,1,28,19,47,170,129,299,317,317,18,0,10,3.47872,0.292553,36.7713,84.1612,188,4
India,259,242.378,7.15058,0.339768,244.568,7.12741,0.30888,123,AB Agarkar,0,0,0,0,220,4,32,1,28,19,47,170,129,299,317,317,18,0,10,0.3125,0,5.75,44.6602,16,3
India,259,242.378,7.15058,0.339768,244.568,7.12741,0.30888,124,MS Dhoni,32,8,24,59,143,8,14,1,14,4,18,72,103,175,0,187,12,0,10,3.47872,0.292553,36.7713,84.1612,188,4
India,259,242.378,7.15058,0.339768,244.568,7.12741,0.30888,124,RP Singh,1,0,1,4,143,8,14,1,14,4,18,72,103,175,0,187,12,0,10,0.333333,0,5.6,39.8104,15,3
Zimbabwe,142,212.077,7.5,0.380282,227.704,6.97887,0.316901,128,P Utseya,4,0,4,12,112,6,9,2,10,11,21,64,78,142,0,152,10,0,10,0.842105,0.0263158,11.8289,55.8385,76,3
Zimbabwe,142,212.077,7.5,0.380282,227.704,6.97887,0.316901,128,AJ Ireland,1,0,1,10,112,6,9,2,10,11,21,64,78,142,0,152,10,0,10,0.2,0,2.2,17.7419,5,3
Zimbabwe,142,212.077,7.5,0.380282,227.704,6.97887,0.316901,129,GB Brent,2,0,2,5,152,4,25,2,4,15,19,78,118,196,0,217,21,0,10,0.75,0.0625,10.5,61.5385,16,1
Zimbabwe,142,212.077,7.5,0.380282,227.704,6.97887,0.316901,129,KM Dabengwa,6,0,6,7,152,4,25,2,4,15,19,78,118,196,0,217,21,0,10,1.2,0,16.7,61.1722,20,1
Zimbabwe,142,212.077,7.5,0.380282,227.704,6.97887,0.316901,129,P Utseya,0,0,0,0,152,4,25,2,4,15,19,78,118,196,0,217,21,0,10,0.842105,0.0263158,11.8289,55.8385,76,3
Bangladesh,160,218.438,7.70625,0.4,211.106,7.05,0.325,130,Mohammad Ashraful,36,12,24,51,150,5,20,2,20,11,31,100,101,201,0,220,19,1,10,2.17722,0.113924,19.4557,63.9085,79,1
Bangladesh,160,218.438,7.70625,0.4,211.106,7.05,0.325,130,Mashrafe Mortaza,2,0,2,5,150,5,20,2,20,11,31,100,101,201,0,220,19,1,10,1.27536,0,11.1594,76.9231,69,1
Bangladesh,160,218.438,7.70625,0.4,211.106,7.05,0.325,130,Abdur Razzak,0,0,0,0,150,5,20,2,20,11,31,100,101,201,0,220,19,1,10,0.849315,0.0136986,8.39726,73.8554,73,1
Bangladesh,160,218.438,7.70625,0.4,211.106,7.05,0.325,130,Shahadat Hossain,0,0,0,0,150,5,20,2,20,11,31,100,101,201,0,220,19,1,10,0.375,0,3.5625,50.4425,16,3
Zimbabwe,142,212.077,7.5,0.380282,227.704,6.97887,0.316901,130,KM Dabengwa,23,8,15,29,126,5,32,0,6,13,19,50,127,177,221,194,17,0,10,1.2,0,16.7,61.1722,20,1
Zimbabwe,142,212.077,7.5,0.380282,227.704,6.97887,0.316901,130,SC Williams,67,12,55,108,126,5,32,0,6,13,19,50,127,177,221,194,17,0,10,2.56923,0.276923,28.5385,80.7927,65,4
Zimbabwe,142,212.077,7.5,0.380282,227.704,6.97887,0.316901,130,GB Brent,0,0,0,0,126,5,32,0,6,13,19,50,127,177,221,194,17,0,10,0.75,0.0625,10.5,61.5385,16,1
Zimbabwe,142,212.077,7.5,0.380282,227.704,6.97887,0.316901,130,P Utseya,0,0,0,0,126,5,32,0,6,13,19,50,127,177,221,194,17,0,10,0.842105,0.0263158,11.8289,55.8385,76,3
Zimbabwe,142,212.077,7.5,0.380282,227.704,6.97887,0.316901,131,P Utseya,13,0,13,34,112,8,5,1,8,0,8,48,77,125,0,146,21,0,10,0.842105,0.0263158,11.8289,55.8385,76,3
Zimbabwe,142,212.077,7.5,0.380282,227.704,6.97887,0.316901,132,KM Dabengwa,1,0,1,6,149,4,19,2,4,13,17,66,119,185,0,193,8,0,10,1.2,0,16.7,61.1722,20,1
Zimbabwe,142,212.077,7.5,0.380282,227.704,6.97887,0.316901,132,GB Brent,0,0,0,2,149,4,19,2,4,13,17,66,119,185,0,193,8,0,10,0.75,0.0625,10.5,61.5385,16,1
Zimbabwe,142,212.077,7.5,0.380282,227.704,6.97887,0.316901,132,P Utseya,0,0,0,0,149,4,19,2,4,13,17,66,119,185,0,193,8,0,10,0.842105,0.0263158,11.8289,55.8385,76,3
Bangladesh,160,218.438,7.70625,0.4,211.106,7.05,0.325,132,Mushfiqur Rahim,3,0,3,7,123,6,20,1,8,13,21,80,84,164,194,197,33,1,10,2.61111,0.18254,27.7778,75.2526,126,4
Bangladesh,160,218.438,7.70625,0.4,211.106,7.05,0.325,132,Habibul Bashar,26,8,18,48,123,6,20,1,8,13,21,80,84,164,194,197,33,1,10,1.125,0,15.25,51.2605,16,3
India,259,242.378,7.15058,0.339768,244.568,7.12741,0.30888,136,RR Powar,2,0,2,6,221,5,11,3,0,7,7,108,131,239,0,268,29,1,10,0.333333,0,5.77778,51.4851,9,3
India,259,242.378,7.15058,0.339768,244.568,7.12741,0.30888,136,S Sreesanth,0,0,0,0,221,5,11,3,0,7,7,108,131,239,0,268,29,1,10,0.125,0,2.4375,32.5,16,3
India,259,242.378,7.15058,0.339768,244.568,7.12741,0.30888,137,SR Tendulkar,71,32,39,60,211,2,40,1,36,27,63,158,156,314,0,341,27,1,10,5.89773,0.363636,45.6023,84.5376,88,4
India,259,242.378,7.15058,0.339768,244.568,7.12741,0.30888,137,MS Dhoni,6,0,6,6,211,2,40,1,36,27,63,158,156,314,0,341,27,1,10,3.47872,0.292553,36.7713,84.1612,188,4
Sri Lanka,244,223.373,7.09016,0.344262,227.578,7.47541,0.385246,138,MF Maharoof,6,0,6,17,172,5,21,1,26,17,43,128,108,236,0,257,21,0,10,1.38889,0.0277778,14.3611,81.2893,36,1
Sri Lanka,244,223.373,7.09016,0.344262,227.578,7.47541,0.385246,138,KC Sangakkara,85,48,37,115,172,5,21,1,26,17,43,128,108,236,0,257,21,0,10,4.33659,0.360976,41.9854,80.6276,205,4
Sri Lanka,244,223.373,7.09016,0.344262,227.578,7.47541,0.385246,138,KMDN Kulasekara,0,0,0,0,172,5,21,1,26,17,43,128,108,236,0,257,21,0,10,1.21,0.04,11.8,80.9328,100,1
Sri Lanka,244,223.373,7.09016,0.344262,227.578,7.47541,0.385246,138,HMCM Bandara,0,0,0,0,172,5,21,1,26,17,43,128,108,236,0,257,21,0,10,1,0,12.2857,80.3738,7,1
India,259,242.378,7.15058,0.339768,244.568,7.12741,0.30888,138,MS Dhoni,34,0,34,54,191,5,21,0,4,14,18,94,136,230,258,252,22,1,10,3.47872,0.292553,36.7713,84.1612,188,4
India,259,242.378,7.15058,0.339768,244.568,7.12741,0.30888,138,KD Karthik,31,4,27,48,191,5,21,0,4,14,18,94,136,230,258,252,22,1,10,2.46429,0.107143,21.6786,71.8769,56,1
India,259,242.378,7.15058,0.339768,244.568,7.12741,0.30888,138,Harbhajan Singh,0,0,0,0,191,5,21,0,4,14,18,94,136,230,258,252,22,1,10,0.901639,0,9.98361,76.4115,61,1
India,259,242.378,7.15058,0.339768,244.568,7.12741,0.30888,138,S Sreesanth,0,0,0,0,191,5,21,0,4,14,18,94,136,230,258,252,22,1,10,0.125,0,2.4375,32.5,16,3
Sri Lanka,244,223.373,7.09016,0.344262,227.578,7.47541,0.385246,139,HMCM Bandara,2,0,2,2,174,6,44,1,12,9,21,116,123,239,0,259,20,0,10,1,0,12.2857,80.3738,7,1
Sri Lanka,244,223.373,7.09016,0.344262,227.578,7.47541,0.385246,139,LPC Silva,89,42,47,103,174,6,44,1,12,9,21,116,123,239,0,259,20,0,10,2.55556,0.244444,26.0222,69.4543,45,4
Sri Lanka,244,223.373,7.09016,0.344262,227.578,7.47541,0.385246,140,RP Arnold,46,16,30,66,154,5,24,2,16,14,30,92,116,208,0,230,22,0,10,1.14286,0.142857,16.4286,73.2484,14,1
Sri Lanka,244,223.373,7.09016,0.344262,227.578,7.47541,0.385246,140,HMCM Bandara,1,0,1,2,154,5,24,2,16,14,30,92,116,208,0,230,22,0,10,1,0,12.2857,80.3738,7,1
Sri Lanka,244,223.373,7.09016,0.344262,227.578,7.47541,0.385246,140,KMDN Kulasekara,0,0,0,0,154,5,24,2,16,14,30,92,116,208,0,230,22,0,10,1.21,0.04,11.8,80.9328,100,1
India,259,242.378,7.15058,0.339768,244.568,7.12741,0.30888,140,MS Dhoni,65,16,49,72,173,4,40,0,4,2,6,94,125,219,231,233,14,1,10,3.47872,0.292553,36.7713,84.1612,188,4
India,259,242.378,7.15058,0.339768,244.568,7.12741,0.30888,140,KD Karthik,0,0,0,0,173,4,40,0,4,2,6,94,125,219,231,233,14,1,10,2.46429,0.107143,21.6786,71.8769,56,1
Bangladesh,160,218.438,7.70625,0.4,211.106,7.05,0.325,142,Aftab Ahmed,14,4,10,12,179,3,39,2,6,8,14,94,138,232,0,250,18,1,10,2.44118,0.0882353,19.1471,73.8095,34,1
Bangladesh,160,218.438,7.70625,0.4,211.106,7.05,0.325,142,Mohammad Rafique,0,0,0,0,179,3,39,2,6,8,14,94,138,232,0,250,18,1,10,0.5,0,8.16667,63.2258,12,1
Bangladesh,160,218.438,7.70625,0.4,211.106,7.05,0.325,142,Mushfiqur Rahim,0,0,0,0,179,3,39,2,6,8,14,94,138,232,0,250,18,1,10,2.61111,0.18254,27.7778,75.2526,126,4
India,259,242.378,7.15058,0.339768,244.568,7.12741,0.30888,142,KD Karthik,48,8,40,58,199,5,29,0,8,4,12,104,136,240,251,251,11,0,10,2.46429,0.107143,21.6786,71.8769,56,1
India,259,242.378,7.15058,0.339768,244.568,7.12741,0.30888,142,MS Dhoni,89,28,61,106,199,5,29,0,8,4,12,104,136,240,251,251,11,0,10,3.47872,0.292553,36.7713,84.1612,188,4
India,259,242.378,7.15058,0.339768,244.568,7.12741,0.30888,143,R Dravid,34,4,30,37,209,4,31,2,8,14,22,114,148,262,0,284,22,0,10,2.83721,0.255814,29.8605,72.7067,43,4
India,259,242.378,7.15058,0.339768,244.568,7.12741,0.30888,143,PP Chawla,1,0,1,1,209,4,31,2,8,14,22,114,148,262,0,284,22,0,10,0.25,0,3.16667,63.3333,12,1
India,259,242.378,7.15058,0.339768,244.568,7.12741,0.30888,143,RR Powar,0,0,0,0,209,4,31,2,8,14,22,114,148,262,0,284,22,0,10,0.333333,0,5.77778,51.4851,9,3
India,259,242.378,7.15058,0.339768,244.568,7.12741,0.30888,143,Z Khan,0,0,0,0,209,4,31,2,8,14,22,114,148,262,0,284,22,0,10,0.974359,0,8.35897,60.9346,39,1
Bangladesh,160,218.438,7.70625,0.4,211.106,7.05,0.325,143,Mashrafe Mortaza,10,4,6,11,161,6,19,2,30,11,41,116,105,221,285,238,17,1,10,1.27536,0,11.1594,76.9231,69,1
Bangladesh,160,218.438,7.70625,0.4,211.106,7.05,0.325,143,Abdur Razzak,4,4,0,5,161,6,19,2,30,11,41,116,105,221,285,238,17,1,10,0.849315,0.0136986,8.39726,73.8554,73,1
Bangladesh,160,218.438,7.70625,0.4,211.106,7.05,0.325,143,Syed Rasel,0,0,0,0,161,6,19,2,30,11,41,116,105,221,285,238,17,1,10,0.222222,0,2.88889,37.6812,18,3
Sri Lanka,244,223.373,7.09016,0.344262,227.578,7.47541,0.385246,146,TM Dilshan,2,0,2,5,194,3,26,1,12,21,33,88,165,253,0,269,16,1,10,4.60199,0.273632,38.3632,86.0219,201,4
Sri Lanka,244,223.373,7.09016,0.344262,227.578,7.47541,0.385246,146,LPC Silva,33,10,23,35,194,3,26,1,12,21,33,88,165,253,0,269,16,1,10,2.55556,0.244444,26.0222,69.4543,45,4
Sri Lanka,244,223.373,7.09016,0.344262,227.578,7.47541,0.385246,146,J Mubarak,0,0,0,0,194,3,26,1,12,21,33,88,165,253,0,269,16,1,10,1.21429,0.0714286,19.6429,69.797,14,1
Sri Lanka,244,223.373,7.09016,0.344262,227.578,7.47541,0.385246,146,MF Maharoof,0,0,0,0,194,3,26,1,12,21,33,88,165,253,0,269,16,1,10,1.38889,0.0277778,14.3611,81.2893,36,1
Sri Lanka,244,223.373,7.09016,0.344262,227.578,7.47541,0.385246,146,WPUJC Vaas,0,0,0,0,194,3,26,1,12,21,33,88,165,253,0,269,16,1,10,0.653846,0,8.65385,66.1765,26,1
England,221,237.176,7.17647,0.289593,230.633,7.45701,0.384615,147,OA Shah,65,12,53,81,159,6,29,0,8,31,39,58,169,227,0,234,7,0,10,3.13043,0.23913,32.6739,81.1994,46,4
England,221,237.176,7.17647,0.289593,230.633,7.45701,0.384615,147,GP Swann,21,0,21,28,159,6,29,0,8,31,39,58,169,227,0,234,7,0,10,1.08696,0,10.3043,90.631,46,0
England,221,237.176,7.17647,0.289593,230.633,7.45701,0.384615,147,SCJ Broad,0,0,0,0,159,6,29,0,8,31,39,58,169,227,0,234,7,0,10,0.725806,0,8.04839,74.0356,62,1
England,221,237.176,7.17647,0.289593,230.633,7.45701,0.384615,147,RJ Sidebottom,0,0,0,0,159,6,29,0,8,31,39,58,169,227,0,234,7,0,10,0.6875,0,7.6875,65.7754,16,1
Sri Lanka,244,223.373,7.09016,0.344262,227.578,7.47541,0.385246,148,TM Dilshan,10,0,10,10,136,4,31,2,8,22,30,48,149,197,0,211,14,1,10,4.60199,0.273632,38.3632,86.0219,201,4
Sri Lanka,244,223.373,7.09016,0.344262,227.578,7.47541,0.385246,148,J Mubarak,5,0,5,6,136,4,31,2,8,22,30,48,149,197,0,211,14,1,10,1.21429,0.0714286,19.6429,69.797,14,1
Sri Lanka,244,223.373,7.09016,0.344262,227.578,7.47541,0.385246,148,WPUJC Vaas,0,0,0,0,136,4,31,2,8,22,30,48,149,197,0,211,14,1,10,0.653846,0,8.65385,66.1765,26,1
Sri Lanka,244,223.373,7.09016,0.344262,227.578,7.47541,0.385246,148,CRD Fernando,0,0,0,0,136,4,31,2,8,22,30,48,149,197,0,211,14,1,10,0.571429,0,5.42857,64.7727,21,1
Sri Lanka,244,223.373,7.09016,0.344262,227.578,7.47541,0.385246,148,SL Malinga,0,0,0,0,136,4,31,2,8,22,30,48,149,197,0,211,14,1,10,0.617284,0.0123457,4.97531,74.6296,81,1
England,221,237.176,7.17647,0.289593,230.633,7.45701,0.384615,148,OA Shah,7,4,3,7,176,2,16,2,0,5,5,78,119,197,212,212,15,0,10,3.13043,0.23913,32.6739,81.1994,46,4
England,221,237.176,7.17647,0.289593,230.633,7.45701,0.384615,148,RS Bopara,0,0,0,0,176,2,16,2,0,5,5,78,119,197,212,212,15,0,10,2.22115,0.144231,25.1538,75.9361,104,4
England,221,237.176,7.17647,0.289593,230.633,7.45701,0.384615,148,KP Pietersen,61,22,39,76,176,2,16,2,0,5,5,78,119,197,212,212,15,0,10,3.69892,0.236559,33.4946,82.2117,93,4
Sri Lanka,244,223.373,7.09016,0.344262,227.578,7.47541,0.385246,149,CRD Fernando,5,4,1,3,154,7,30,1,4,9,13,76,121,197,0,211,14,1,10,0.571429,0,5.42857,64.7727,21,1
Sri Lanka,244,223.373,7.09016,0.344262,227.578,7.47541,0.385246,149,LPC Silva,67,32,35,104,154,7,30,1,4,9,13,76,121,197,0,211,14,1,10,2.55556,0.244444,26.0222,69.4543,45,4
Sri Lanka,244,223.373,7.09016,0.344262,227.578,7.47541,0.385246,149,SL Malinga,0,0,0,0,154,7,30,1,4,9,13,76,121,197,0,211,14,1,10,0.617284,0.0123457,4.97531,74.6296,81,1
New Zealand,184,233.745,7.39674,0.36413,227.951,7.30435,0.353261,150,JDP Oram,7,0,7,23,177,4,13,2,18,27,45,106,129,235,0,254,19,0,10,2.70833,0.1875,25.0417,95.8533,48,0
New Zealand,184,233.745,7.39674,0.36413,227.951,7.30435,0.353261,150,DL Vettori,5,0,5,7,177,4,13,2,18,27,45,106,129,235,0,254,19,0,10,1.43662,0.028169,15.7606,86.0108,71,0
New Zealand,184,233.745,7.39674,0.36413,227.951,7.30435,0.353261,150,KD Mills,0,0,0,0,177,4,13,2,18,27,45,106,129,235,0,254,19,0,10,1.52542,0.0338983,12.8644,90.7895,59,0
Australia,228,239.627,7.69737,0.372807,232.079,7.23246,0.337719,151,RT Ponting,118,48,70,123,202,4,38,0,12,25,37,114,163,277,0,282,5,1,10,4.17431,0.33945,38.1009,80.8606,109,4
Australia,228,239.627,7.69737,0.372807,232.079,7.23246,0.337719,151,BJ Haddin,25,14,11,23,202,4,38,0,12,25,37,114,163,277,0,282,5,1,10,3.14737,0.147368,26.7789,81.382,95,4
Australia,228,239.627,7.69737,0.372807,232.079,7.23246,0.337719,151,JR Hopes,0,0,0,0,202,4,38,0,12,25,37,114,163,277,0,282,5,1,10,2.09259,0.0555556,21.2778,91.4809,54,0
Australia,228,239.627,7.69737,0.372807,232.079,7.23246,0.337719,152,MJ Clarke,64,14,50,76,177,4,31,1,8,29,37,68,177,245,0,253,8,1,10,3.10294,0.301471,35.9265,74.0303,136,4
Australia,228,239.627,7.69737,0.372807,232.079,7.23246,0.337719,152,JR Hopes,10,0,10,12,177,4,31,1,8,29,37,68,177,245,0,253,8,1,10,2.09259,0.0555556,21.2778,91.4809,54,0
Australia,228,239.627,7.69737,0.372807,232.079,7.23246,0.337719,152,B Lee,0,0,0,0,177,4,31,1,8,29,37,68,177,245,0,253,8,1,10,1.09091,0.0227273,10.8182,81.5068,44,1
India,259,242.378,7.15058,0.339768,244.568,7.12741,0.30888,153,MS Dhoni,16,0,16,54,129,5,21,0,0,3,3,48,105,153,160,160,7,0,10,3.47872,0.292553,36.7713,84.1612,188,4
India,259,242.378,7.15058,0.339768,244.568,7.12741,0.30888,153,RG Sharma,37,8,29,59,129,5,21,0,0,3,3,48,105,153,160,160,7,0,10,3.82836,0.268657,35.9179,83.083,134,4
Australia,228,239.627,7.69737,0.372807,232.079,7.23246,0.337719,154,GB Hogg,32,8,24,51,146,6,28,0,0,19,19,62,131,193,0,203,10,1,10,0.769231,0,13.6923,69.5312,13,1
Australia,228,239.627,7.69737,0.372807,232.079,7.23246,0.337719,154,MJ Clarke,77,24,53,108,146,6,28,0,0,19,19,62,131,193,0,203,10,1,10,3.10294,0.301471,35.9265,74.0303,136,4
Australia,228,239.627,7.69737,0.372807,232.079,7.23246,0.337719,154,MG Johnson,0,0,0,0,146,6,28,0,0,19,19,62,131,193,0,203,10,1,10,1.18519,0.0246914,10.7901,94.181,81,0
Australia,228,239.627,7.69737,0.372807,232.079,7.23246,0.337719,154,NW Bracken,0,0,0,0,146,6,28,0,0,19,19,62,131,193,0,203,10,1,10,0.391304,0,4.91304,62.4309,23,1
Australia,228,239.627,7.69737,0.372807,232.079,7.23246,0.337719,154,SR Clark,0,0,0,0,146,6,28,0,0,19,19,62,131,193,0,203,10,1,10,0.285714,0,4,54.902,7,3
Sri Lanka,244,223.373,7.09016,0.344262,227.578,7.47541,0.385246,155,KC Sangakkara,97,28,69,140,159,4,29,0,20,21,41,74,155,229,0,238,9,0,10,4.33659,0.360976,41.9854,80.6276,205,4
Sri Lanka,244,223.373,7.09016,0.344262,227.578,7.47541,0.385246,155,LPC Silva,15,0,15,22,159,4,29,0,20,21,41,74,155,229,0,238,9,0,10,2.55556,0.244444,26.0222,69.4543,45,4
Sri Lanka,244,223.373,7.09016,0.344262,227.578,7.47541,0.385246,155,MF Maharoof,0,0,0,0,159,4,29,0,20,21,41,74,155,229,0,238,9,0,10,1.38889,0.0277778,14.3611,81.2893,36,1
Sri Lanka,244,223.373,7.09016,0.344262,227.578,7.47541,0.385246,155,WPUJC Vaas,0,0,0,0,159,4,29,0,20,21,41,74,155,229,0,238,9,0,10,0.653846,0,8.65385,66.1765,26,1
India,259,242.378,7.15058,0.339768,244.568,7.12741,0.30888,155,MS Dhoni,41,0,41,60,173,5,24,0,0,18,18,74,141,215,239,239,24,0,10,3.47872,0.292553,36.7713,84.1612,188,4
India,259,242.378,7.15058,0.339768,244.568,7.12741,0.30888,155,IK Pathan,31,16,15,41,173,5,24,0,0,18,18,74,141,215,239,239,24,0,10,1.875,0.025,16.85,78.2811,40,1
India,259,242.378,7.15058,0.339768,244.568,7.12741,0.30888,155,P Kumar,0,0,0,0,173,5,24,0,0,18,18,74,141,215,239,239,24,0,10,1,0.03125,9.03125,86.0119,32,1
India,259,242.378,7.15058,0.339768,244.568,7.12741,0.30888,155,Harbhajan Singh,0,0,0,0,173,5,24,0,0,18,18,74,141,215,239,239,24,0,10,0.901639,0,9.98361,76.4115,61,1
India,259,242.378,7.15058,0.339768,244.568,7.12741,0.30888,155,I Sharma,0,0,0,0,173,5,24,0,0,18,18,74,141,215,239,239,24,0,10,0.24,0,2.84,34.1346,25,3
Australia,228,239.627,7.69737,0.372807,232.079,7.23246,0.337719,156,MEK Hussey,52,4,48,86,132,4,22,1,0,25,25,32,147,179,0,184,5,1,10,2.7563,0.260504,34.084,82.4893,119,4
Australia,228,239.627,7.69737,0.372807,232.079,7.23246,0.337719,156,JR Hopes,8,0,8,12,132,4,22,1,0,25,25,32,147,179,0,184,5,1,10,2.09259,0.0555556,21.2778,91.4809,54,0
Australia,228,239.627,7.69737,0.372807,232.079,7.23246,0.337719,156,GB Hogg,0,0,0,0,132,4,22,1,0,25,25,32,147,179,0,184,5,1,10,0.769231,0,13.6923,69.5312,13,1
Australia,228,239.627,7.69737,0.372807,232.079,7.23246,0.337719,156,MG Johnson,0,0,0,0,132,4,22,1,0,25,25,32,147,179,0,184,5,1,10,1.18519,0.0246914,10.7901,94.181,81,0
Australia,228,239.627,7.69737,0.372807,232.079,7.23246,0.337719,157,A Symonds,43,26,17,40,219,3,41,0,10,33,43,108,195,303,0,317,14,1,10,3.44186,0.302326,32.0465,91.5615,43,4
Australia,228,239.627,7.69737,0.372807,232.079,7.23246,0.337719,157,RT Ponting,116,34,82,126,219,3,41,0,10,33,43,108,195,303,0,317,14,1,10,4.17431,0.33945,38.1009,80.8606,109,4
Australia,228,239.627,7.69737,0.372807,232.079,7.23246,0.337719,157,MEK Hussey,0,0,0,0,219,3,41,0,10,33,43,108,195,303,0,317,14,1,10,2.7563,0.260504,34.084,82.4893,119,4
Australia,228,239.627,7.69737,0.372807,232.079,7.23246,0.337719,157,JR Hopes,0,0,0,0,219,3,41,0,10,33,43,108,195,303,0,317,14,1,10,2.09259,0.0555556,21.2778,91.4809,54,0
India,259,242.378,7.15058,0.339768,244.568,7.12741,0.30888,157,Harbhajan Singh,1,0,1,1,204,6,37,1,16,15,31,116,156,272,318,299,27,0,10,0.901639,0,9.98361,76.4115,61,1
India,259,242.378,7.15058,0.339768,244.568,7.12741,0.30888,157,RV Uthappa,44,18,26,43,204,6,37,1,16,15,31,116,156,272,318,299,27,0,10,3,0.117647,22.1471,89.0071,34,0
India,259,242.378,7.15058,0.339768,244.568,7.12741,0.30888,157,S Sreesanth,0,0,0,0,204,6,37,1,16,15,31,116,156,272,318,299,27,0,10,0.125,0,2.4375,32.5,16,3
India,259,242.378,7.15058,0.339768,244.568,7.12741,0.30888,157,I Sharma,0,0,0,0,204,6,37,1,16,15,31,116,156,272,318,299,27,0,10,0.24,0,2.84,34.1346,25,3
Sri Lanka,244,223.373,7.09016,0.344262,227.578,7.47541,0.385246,158,M Muralitharan,12,4,8,23,133,8,24,0,4,7,11,62,106,168,0,179,11,0,10,0.69697,0,5.63636,99.4652,33,0
Sri Lanka,244,223.373,7.09016,0.344262,227.578,7.47541,0.385246,158,CK Kapugedera,47,16,31,81,133,8,24,0,4,7,11,62,106,168,0,179,11,0,10,1.74138,0.12069,21.1379,68.6066,58,1
Sri Lanka,244,223.373,7.09016,0.344262,227.578,7.47541,0.385246,158,MKDI Amerasinghe,0,0,0,0,133,8,24,0,4,7,11,62,106,168,0,179,11,0,10,0.333333,0,1.66667,71.4286,3,1
Sri Lanka,244,223.373,7.09016,0.344262,227.578,7.47541,0.385246,159,LPC Silva,20,4,16,40,150,5,23,1,20,15,35,78,130,208,0,221,13,0,10,2.55556,0.244444,26.0222,69.4543,45,4
Sri Lanka,244,223.373,7.09016,0.344262,227.578,7.47541,0.385246,159,KMDN Kulasekara,0,0,0,4,150,5,23,1,20,15,35,78,130,208,0,221,13,0,10,1.21,0.04,11.8,80.9328,100,1
Sri Lanka,244,223.373,7.09016,0.344262,227.578,7.47541,0.385246,159,SL Malinga,0,0,0,0,150,5,23,1,20,15,35,78,130,208,0,221,13,0,10,0.617284,0.0123457,4.97531,74.6296,81,1
Sri Lanka,244,223.373,7.09016,0.344262,227.578,7.47541,0.385246,159,M Muralitharan,0,0,0,0,150,5,23,1,20,15,35,78,130,208,0,221,13,0,10,0.69697,0,5.63636,99.4652,33,0
Sri Lanka,244,223.373,7.09016,0.344262,227.578,7.47541,0.385246,159,MKDI Amerasinghe,0,0,0,0,150,5,23,1,20,15,35,78,130,208,0,221,13,0,10,0.333333,0,1.66667,71.4286,3,1
Australia,228,239.627,7.69737,0.372807,232.079,7.23246,0.337719,159,NW Bracken,10,4,6,20,169,9,16,0,4,10,14,90,109,199,222,208,9,1,10,0.391304,0,4.91304,62.4309,23,1
Australia,228,239.627,7.69737,0.372807,232.079,7.23246,0.337719,159,B Lee,27,10,17,47,169,9,16,0,4,10,14,90,109,199,222,208,9,1,10,1.09091,0.0227273,10.8182,81.5068,44,1
Australia,228,239.627,7.69737,0.372807,232.079,7.23246,0.337719,160,MEK Hussey,37,4,33,62,172,6,20,0,16,23,39,88,143,231,0,239,8,1,10,2.7563,0.260504,34.084,82.4893,119,4
Australia,228,239.627,7.69737,0.372807,232.079,7.23246,0.337719,160,GB Hogg,15,0,15,20,172,6,20,0,16,23,39,88,143,231,0,239,8,1,10,0.769231,0,13.6923,69.5312,13,1
Australia,228,239.627,7.69737,0.372807,232.079,7.23246,0.337719,160,B Lee,0,0,0,0,172,6,20,0,16,23,39,88,143,231,0,239,8,1,10,1.09091,0.0227273,10.8182,81.5068,44,1
Australia,228,239.627,7.69737,0.372807,232.079,7.23246,0.337719,160,MG Johnson,0,0,0,0,172,6,20,0,16,23,39,88,143,231,0,239,8,1,10,1.18519,0.0246914,10.7901,94.181,81,0
India,259,242.378,7.15058,0.339768,244.568,7.12741,0.30888,160,MS Dhoni,10,8,2,8,192,3,30,1,4,2,6,88,140,228,240,242,14,0,10,3.47872,0.292553,36.7713,84.1612,188,4
India,259,242.378,7.15058,0.339768,244.568,7.12741,0.30888,160,SR Tendulkar,116,40,76,123,192,3,30,1,4,2,6,88,140,228,240,242,14,0,10,5.89773,0.363636,45.6023,84.5376,88,4
India,259,242.378,7.15058,0.339768,244.568,7.12741,0.30888,161,MS Dhoni,25,8,17,27,194,4,13,1,14,20,34,82,159,241,0,258,17,0,10,3.47872,0.292553,36.7713,84.1612,188,4
India,259,242.378,7.15058,0.339768,244.568,7.12741,0.30888,161,IK Pathan,6,4,2,14,194,4,13,1,14,20,34,82,159,241,0,258,17,0,10,1.875,0.025,16.85,78.2811,40,1
India,259,242.378,7.15058,0.339768,244.568,7.12741,0.30888,161,Harbhajan Singh,0,0,0,0,194,4,13,1,14,20,34,82,159,241,0,258,17,0,10,0.901639,0,9.98361,76.4115,61,1
India,259,242.378,7.15058,0.339768,244.568,7.12741,0.30888,161,P Kumar,0,0,0,0,194,4,13,1,14,20,34,82,159,241,0,258,17,0,10,1,0.03125,9.03125,86.0119,32,1
India,259,242.378,7.15058,0.339768,244.568,7.12741,0.30888,161,PP Chawla,0,0,0,0,194,4,13,1,14,20,34,82,159,241,0,258,17,0,10,0.25,0,3.16667,63.3333,12,1
India,259,242.378,7.15058,0.339768,244.568,7.12741,0.30888,161,S Sreesanth,0,0,0,0,194,4,13,1,14,20,34,82,159,241,0,258,17,0,10,0.125,0,2.4375,32.5,16,3
Australia,228,239.627,7.69737,0.372807,232.079,7.23246,0.337719,161,B Lee,5,0,5,5,176,5,39,1,10,15,25,84,156,240,259,249,9,1,10,1.09091,0.0227273,10.8182,81.5068,44,1
Australia,228,239.627,7.69737,0.372807,232.079,7.23246,0.337719,161,JR Hopes,49,16,33,67,176,5,39,1,10,15,25,84,156,240,259,249,9,1,10,2.09259,0.0555556,21.2778,91.4809,54,0
Australia,228,239.627,7.69737,0.372807,232.079,7.23246,0.337719,161,MG Johnson,0,0,0,0,176,5,39,1,10,15,25,84,156,240,259,249,9,1,10,1.18519,0.0246914,10.7901,94.181,81,0
Australia,228,239.627,7.69737,0.372807,232.079,7.23246,0.337719,161,NW Bracken,0,0,0,0,176,5,39,1,10,15,25,84,156,240,259,249,9,1,10,0.391304,0,4.91304,62.4309,23,1
Ireland,55,219.527,7.65455,0.290909,202.727,7.56364,0.4,162,DT Johnston,17,6,11,37,99,6,35,1,14,16,30,60,104,164,0,193,29,1,10,1.27273,0,12.1818,74.2382,22,1
Ireland,55,219.527,7.65455,0.290909,202.727,7.56364,0.4,162,WK McCallan,0,0,0,0,99,6,35,1,14,16,30,60,104,164,0,193,29,1,10,0.692308,0,7.69231,56.8182,13,3
Ireland,55,219.527,7.65455,0.290909,202.727,7.56364,0.4,162,RK Whelan,0,0,0,0,99,6,35,1,14,16,30,60,104,164,0,193,29,1,10,0.5,0,2.5,41.6667,2,3
India,259,242.378,7.15058,0.339768,244.568,7.12741,0.30888,163,Yuvraj Singh,7,0,7,7,170,2,22,1,18,19,37,94,135,229,0,242,13,0,10,4.05833,0.258333,32.525,83.8093,120,4
India,259,242.378,7.15058,0.339768,244.568,7.12741,0.30888,163,SR Tendulkar,98,48,50,143,170,2,22,1,18,19,37,94,135,229,0,242,13,0,10,5.89773,0.363636,45.6023,84.5376,88,4
India,259,242.378,7.15058,0.339768,244.568,7.12741,0.30888,163,KD Karthik,0,0,0,0,170,2,22,1,18,19,37,94,135,229,0,242,13,0,10,2.46429,0.107143,21.6786,71.8769,56,1
India,259,242.378,7.15058,0.339768,244.568,7.12741,0.30888,163,RG Sharma,0,0,0,0,170,2,22,1,18,19,37,94,135,229,0,242,13,0,10,3.82836,0.268657,35.9179,83.083,134,4
India,259,242.378,7.15058,0.339768,244.568,7.12741,0.30888,163,PP Chawla,0,0,0,0,170,2,22,1,18,19,37,94,135,229,0,242,13,0,10,0.25,0,3.16667,63.3333,12,1
India,259,242.378,7.15058,0.339768,244.568,7.12741,0.30888,163,RR Powar,0,0,0,0,170,2,22,1,18,19,37,94,135,229,0,242,13,0,10,0.333333,0,5.77778,51.4851,9,3
South Africa,190,234.274,7.4,0.373684,232.363,7.33158,0.342105,163,JH Kallis,75,16,59,100,182,6,24,0,12,13,25,88,143,231,243,245,14,0,10,3.58621,0.356322,37.2644,76.4442,87,4
South Africa,190,234.274,7.4,0.373684,232.363,7.33158,0.342105,163,VD Philander,8,0,8,14,182,6,24,0,12,13,25,88,143,231,243,245,14,0,10,0.8125,0,8.8125,66.5094,16,1
South Africa,190,234.274,7.4,0.373684,232.363,7.33158,0.342105,164,AJ Hall,8,4,4,9,154,4,21,1,18,21,39,88,126,214,0,226,12,0,10,1.4,0.1,14.4,87.8049,10,0
South Africa,190,234.274,7.4,0.373684,232.363,7.33158,0.342105,164,MV Boucher,26,8,18,38,154,4,21,1,18,21,39,88,126,214,0,226,12,0,10,2.21053,0.0877193,22.2281,89.3512,57,0
South Africa,190,234.274,7.4,0.373684,232.363,7.33158,0.342105,164,A Nel,0,0,0,0,154,4,21,1,18,21,39,88,126,214,0,226,12,0,10,1.06667,0,7.66667,81.5603,15,1
India,259,242.378,7.15058,0.339768,244.568,7.12741,0.30888,164,Yuvraj Singh,24,8,16,45,168,4,18,0,14,18,32,108,110,218,227,227,9,0,10,4.05833,0.258333,32.525,83.8093,120,4
India,259,242.378,7.15058,0.339768,244.568,7.12741,0.30888,164,KD Karthik,25,4,21,33,168,4,18,0,14,18,32,108,110,218,227,227,9,0,10,2.46429,0.107143,21.6786,71.8769,56,1
Sri Lanka,244,223.373,7.09016,0.344262,227.578,7.47541,0.385246,166,J Mubarak,4,0,4,3,156,4,33,1,10,24,34,102,121,223,0,234,11,1,10,1.21429,0.0714286,19.6429,69.797,14,1
Sri Lanka,244,223.373,7.09016,0.344262,227.578,7.47541,0.385246,166,TM Dilshan,24,4,20,31,156,4,33,1,10,24,34,102,121,223,0,234,11,1,10,4.60199,0.273632,38.3632,86.0219,201,4
Sri Lanka,244,223.373,7.09016,0.344262,227.578,7.47541,0.385246,166,MF Maharoof,0,0,0,0,156,4,33,1,10,24,34,102,121,223,0,234,11,1,10,1.38889,0.0277778,14.3611,81.2893,36,1
Bangladesh,160,218.438,7.70625,0.4,211.106,7.05,0.325,167,Shahadat Hossain,5,0,5,13,105,7,11,2,0,5,5,20,101,121,0,137,16,0,10,0.375,0,3.5625,50.4425,16,3
Bangladesh,160,218.438,7.70625,0.4,211.106,7.05,0.325,167,Syed Rasel,2,0,2,4,105,7,11,2,0,5,5,20,101,121,0,137,16,0,10,0.222222,0,2.88889,37.6812,18,3
England,221,237.176,7.17647,0.289593,230.633,7.45701,0.384615,171,KP Pietersen,97,46,51,101,186,3,38,1,38,23,61,142,143,285,0,307,22,1,10,3.69892,0.236559,33.4946,82.2117,93,4
England,221,237.176,7.17647,0.289593,230.633,7.45701,0.384615,171,OA Shah,2,0,2,3,186,3,38,1,38,23,61,142,143,285,0,307,22,1,10,3.13043,0.23913,32.6739,81.1994,46,4
England,221,237.176,7.17647,0.289593,230.633,7.45701,0.384615,172,SCJ Broad,1,0,1,5,187,5,22,2,8,15,23,110,122,232,0,245,13,1,10,0.725806,0,8.04839,74.0356,62,1
England,221,237.176,7.17647,0.289593,230.633,7.45701,0.384615,172,RJ Sidebottom,0,0,0,0,187,5,22,2,8,15,23,110,122,232,0,245,13,1,10,0.6875,0,7.6875,65.7754,16,1
England,221,237.176,7.17647,0.289593,230.633,7.45701,0.384615,172,JM Anderson,0,0,0,0,187,5,22,2,8,15,23,110,122,232,0,245,13,1,10,0.365385,0,3.92308,52.7132,52,3
New Zealand,184,233.745,7.39674,0.36413,227.951,7.30435,0.353261,172,TG Southee,2,0,2,4,178,7,32,1,6,12,18,98,130,228,246,246,18,0,10,0.764706,0,7.03922,92.7649,51,0
New Zealand,184,233.745,7.39674,0.36413,227.951,7.30435,0.353261,172,KD Mills,15,4,11,16,178,7,32,1,6,12,18,98,130,228,246,246,18,0,10,1.52542,0.0338983,12.8644,90.7895,59,0
New Zealand,184,233.745,7.39674,0.36413,227.951,7.30435,0.353261,172,MR Gillespie,0,0,0,0,178,7,32,1,6,12,18,98,130,228,246,246,18,0,10,0.9,0,8,84.2105,10,1
New Zealand,184,233.745,7.39674,0.36413,227.951,7.30435,0.353261,173,GD Elliott,2,0,2,5,151,4,34,1,40,21,61,100,146,246,0,266,20,0,10,2.67188,0.203125,29.4375,79.7629,64,4
New Zealand,184,233.745,7.39674,0.36413,227.951,7.30435,0.353261,173,SB Styris,47,8,39,73,151,4,34,1,40,21,61,100,146,246,0,266,20,0,10,3.20755,0.264151,33.8302,78.7094,53,4
England,221,237.176,7.17647,0.289593,230.633,7.45701,0.384615,173,RJ Sidebottom,6,4,2,6,147,7,36,1,0,10,10,88,105,193,267,215,22,1,10,0.6875,0,7.6875,65.7754,16,1
England,221,237.176,7.17647,0.289593,230.633,7.45701,0.384615,173,OA Shah,65,20,45,72,147,7,36,1,0,10,10,88,105,193,267,215,22,1,10,3.13043,0.23913,32.6739,81.1994,46,4
England,221,237.176,7.17647,0.289593,230.633,7.45701,0.384615,173,JM Anderson,0,0,0,0,147,7,36,1,0,10,10,88,105,193,267,215,22,1,10,0.365385,0,3.92308,52.7132,52,3
England,221,237.176,7.17647,0.289593,230.633,7.45701,0.384615,174,KP Pietersen,64,16,48,71,171,3,36,0,34,18,52,96,163,259,0,275,16,1,10,3.69892,0.236559,33.4946,82.2117,93,4
England,221,237.176,7.17647,0.289593,230.633,7.45701,0.384615,174,A Flintoff,54,20,34,55,171,3,36,0,34,18,52,96,163,259,0,275,16,1,10,2.4375,0.09375,22.5,86.5385,32,4
England,221,237.176,7.17647,0.289593,230.633,7.45701,0.384615,174,LJ Wright,0,0,0,0,171,3,36,0,34,18,52,96,163,259,0,275,16,1,10,1.92105,0.0263158,17.2368,81.875,38,1
South Africa,190,234.274,7.4,0.373684,232.363,7.33158,0.342105,174,A Nel,1,0,1,3,189,6,14,1,8,21,29,98,134,232,276,255,23,0,10,1.06667,0,7.66667,81.5603,15,1
South Africa,190,234.274,7.4,0.373684,232.363,7.33158,0.342105,174,VD Philander,8,0,8,20,189,6,14,1,8,21,29,98,134,232,276,255,23,0,10,0.8125,0,8.8125,66.5094,16,1
South Africa,190,234.274,7.4,0.373684,232.363,7.33158,0.342105,174,DW Steyn,0,0,0,0,189,6,14,1,8,21,29,98,134,232,276,255,23,0,10,0.75,0,6.52273,61.588,44,1
South Africa,190,234.274,7.4,0.373684,232.363,7.33158,0.342105,174,M Ntini,0,0,0,0,189,6,14,1,8,21,29,98,134,232,276,255,23,0,10,0.375,0,3.25,63.4146,16,1
England,221,237.176,7.17647,0.289593,230.633,7.45701,0.384615,176,A Flintoff,57,28,29,62,199,5,37,0,22,16,38,154,120,274,0,296,22,1,10,2.4375,0.09375,22.5,86.5385,32,4
England,221,237.176,7.17647,0.289593,230.633,7.45701,0.384615,176,SR Patel,31,12,19,34,199,5,37,0,22,16,38,154,120,274,0,296,22,1,10,2.22727,0.0454545,21.9091,90.6015,22,0
England,221,237.176,7.17647,0.289593,230.633,7.45701,0.384615,176,LJ Wright,0,0,0,0,199,5,37,0,22,16,38,154,120,274,0,296,22,1,10,1.92105,0.0263158,17.2368,81.875,38,1
Australia,228,239.627,7.69737,0.372807,232.079,7.23246,0.337719,178,BJ Haddin,54,28,26,52,201,4,42,0,22,20,42,148,137,285,0,306,21,0,10,3.14737,0.147368,26.7789,81.382,95,4
Australia,228,239.627,7.69737,0.372807,232.079,7.23246,0.337719,178,A Symonds,84,48,36,79,201,4,42,0,22,20,42,148,137,285,0,306,21,0,10,3.44186,0.302326,32.0465,91.5615,43,4
Australia,228,239.627,7.69737,0.372807,232.079,7.23246,0.337719,178,JR Hopes,0,0,0,0,201,4,42,0,22,20,42,148,137,285,0,306,21,0,10,2.09259,0.0555556,21.2778,91.4809,54,0
Australia,228,239.627,7.69737,0.372807,232.079,7.23246,0.337719,178,B Lee,0,0,0,0,201,4,42,0,22,20,42,148,137,285,0,306,21,0,10,1.09091,0.0227273,10.8182,81.5068,44,1
India,259,242.378,7.15058,0.339768,244.568,7.12741,0.30888,178,MS Dhoni,50,14,36,81,170,9,15,0,6,4,10,100,95,195,307,222,27,1,10,3.47872,0.292553,36.7713,84.1612,188,4
India,259,242.378,7.15058,0.339768,244.568,7.12741,0.30888,178,S Sreesanth,5,0,5,20,170,9,15,0,6,4,10,100,95,195,307,222,27,1,10,0.125,0,2.4375,32.5,16,3
Australia,228,239.627,7.69737,0.372807,232.079,7.23246,0.337719,179,BJ Hodge,0,0,0,0,194,3,51,1,10,21,31,130,146,276,0,290,14,0,10,2.76923,0.153846,26.4615,83.9024,13,4
Australia,228,239.627,7.69737,0.372807,232.079,7.23246,0.337719,179,A Symonds,72,40,32,56,194,3,51,1,10,21,31,130,146,276,0,290,14,0,10,3.44186,0.302326,32.0465,91.5615,43,4
Australia,228,239.627,7.69737,0.372807,232.079,7.23246,0.337719,179,JR Hopes,0,0,0,0,194,3,51,1,10,21,31,130,146,276,0,290,14,0,10,2.09259,0.0555556,21.2778,91.4809,54,0
India,259,242.378,7.15058,0.339768,244.568,7.12741,0.30888,179,Harbhajan Singh,7,0,7,16,180,7,37,2,10,3,13,116,114,230,291,243,13,1,10,0.901639,0,9.98361,76.4115,61,1
India,259,242.378,7.15058,0.339768,244.568,7.12741,0.30888,179,S Sreesanth,0,0,0,3,180,7,37,2,10,3,13,116,114,230,291,243,13,1,10,0.125,0,2.4375,32.5,16,3
India,259,242.378,7.15058,0.339768,244.568,7.12741,0.30888,180,MS Dhoni,34,16,18,28,168,2,30,1,42,12,54,130,122,252,0,291,39,1,10,3.47872,0.292553,36.7713,84.1612,188,4
India,259,242.378,7.15058,0.339768,244.568,7.12741,0.30888,180,R Dravid,5,0,5,10,168,2,30,1,42,12,54,130,122,252,0,291,39,1,10,2.83721,0.255814,29.8605,72.7067,43,4
India,259,242.378,7.15058,0.339768,244.568,7.12741,0.30888,180,RV Uthappa,0,0,0,0,168,2,30,1,42,12,54,130,122,252,0,291,39,1,10,3,0.117647,22.1471,89.0071,34,0
Australia,228,239.627,7.69737,0.372807,232.079,7.23246,0.337719,180,JR Hopes,5,0,5,6,207,4,29,1,4,25,29,116,149,265,292,283,18,0,10,2.09259,0.0555556,21.2778,91.4809,54,0
Australia,228,239.627,7.69737,0.372807,232.079,7.23246,0.337719,180,A Symonds,69,18,51,79,207,4,29,1,4,25,29,116,149,265,292,283,18,0,10,3.44186,0.302326,32.0465,91.5615,43,4
Australia,228,239.627,7.69737,0.372807,232.079,7.23246,0.337719,180,GB Hogg,0,0,0,0,207,4,29,1,4,25,29,116,149,265,292,283,18,0,10,0.769231,0,13.6923,69.5312,13,1
Australia,228,239.627,7.69737,0.372807,232.079,7.23246,0.337719,180,B Lee,0,0,0,0,207,4,29,1,4,25,29,116,149,265,292,283,18,0,10,1.09091,0.0227273,10.8182,81.5068,44,1
Australia,228,239.627,7.69737,0.372807,232.079,7.23246,0.337719,181,JR Hopes,26,12,14,23,208,5,45,0,32,24,56,178,131,309,0,317,8,0,10,2.09259,0.0555556,21.2778,91.4809,54,0
Australia,228,239.627,7.69737,0.372807,232.079,7.23246,0.337719,181,A Symonds,82,46,36,75,208,5,45,0,32,24,56,178,131,309,0,317,8,0,10,3.44186,0.302326,32.0465,91.5615,43,4
Australia,228,239.627,7.69737,0.372807,232.079,7.23246,0.337719,181,B Lee,0,0,0,0,208,5,45,0,32,24,56,178,131,309,0,317,8,0,10,1.09091,0.0227273,10.8182,81.5068,44,1
Australia,228,239.627,7.69737,0.372807,232.079,7.23246,0.337719,181,MG Johnson,0,0,0,0,208,5,45,0,32,24,56,178,131,309,0,317,8,0,10,1.18519,0.0246914,10.7901,94.181,81,0
India,259,242.378,7.15058,0.339768,244.568,7.12741,0.30888,181,MS Dhoni,18,10,8,19,203,4,43,1,18,15,33,160,119,279,318,299,20,1,10,3.47872,0.292553,36.7713,84.1612,188,4
India,259,242.378,7.15058,0.339768,244.568,7.12741,0.30888,181,RV Uthappa,28,22,6,16,203,4,43,1,18,15,33,160,119,279,318,299,20,1,10,3,0.117647,22.1471,89.0071,34,0
India,259,242.378,7.15058,0.339768,244.568,7.12741,0.30888,181,Harbhajan Singh,0,0,0,0,203,4,43,1,18,15,33,160,119,279,318,299,20,1,10,0.901639,0,9.98361,76.4115,61,1
India,259,242.378,7.15058,0.339768,244.568,7.12741,0.30888,181,Z Khan,0,0,0,0,203,4,43,1,18,15,33,160,119,279,318,299,20,1,10,0.974359,0,8.35897,60.9346,39,1
India,259,242.378,7.15058,0.339768,244.568,7.12741,0.30888,182,M Kartik,20,12,8,30,135,8,22,0,0,2,2,90,69,159,194,195,36,1,10,1.66667,0,12.3333,75.5102,3,1
India,259,242.378,7.15058,0.339768,244.568,7.12741,0.30888,182,Z Khan,30,18,12,43,135,8,22,0,0,2,2,90,69,159,194,195,36,1,10,0.974359,0,8.35897,60.9346,39,1
Pakistan,211,222.621,7.38389,0.393365,235.517,7.54976,0.336493,183,Mohammad Yousuf,49,12,37,70,158,4,27,1,20,24,44,86,143,229,0,239,10,0,10,3.27586,0.275862,36.7931,73.9176,58,4
Pakistan,211,222.621,7.38389,0.393365,235.517,7.54976,0.336493,183,Misbah-ul-Haq,16,4,12,17,158,4,27,1,20,24,44,86,143,229,0,239,10,0,10,2.95238,0.285714,34.9921,71.8195,126,4
Pakistan,211,222.621,7.38389,0.393365,235.517,7.54976,0.336493,183,Abdur Rehman,0,0,0,0,158,4,27,1,20,24,44,86,143,229,0,239,10,0,10,0.52381,0,6.04762,55.7018,21,3
India,259,242.378,7.15058,0.339768,244.568,7.12741,0.30888,183,RV Uthappa,2,0,2,3,179,3,32,2,12,1,13,136,88,224,240,242,18,1,10,3,0.117647,22.1471,89.0071,34,0
India,259,242.378,7.15058,0.339768,244.568,7.12741,0.30888,183,IK Pathan,1,0,1,6,179,3,32,2,12,1,13,136,88,224,240,242,18,1,10,1.875,0.025,16.85,78.2811,40,1
India,259,242.378,7.15058,0.339768,244.568,7.12741,0.30888,184,Harbhajan Singh,7,0,7,8,223,6,16,2,24,17,41,134,146,280,0,321,41,1,10,0.901639,0,9.98361,76.4115,61,1
India,259,242.378,7.15058,0.339768,244.568,7.12741,0.30888,184,Z Khan,0,0,0,1,223,6,16,2,24,17,41,134,146,280,0,321,41,1,10,0.974359,0,8.35897,60.9346,39,1
India,259,242.378,7.15058,0.339768,244.568,7.12741,0.30888,184,RP Singh,0,0,0,0,223,6,16,2,24,17,41,134,146,280,0,321,41,1,10,0.333333,0,5.6,39.8104,15,3
Pakistan,211,222.621,7.38389,0.393365,235.517,7.54976,0.336493,184,Misbah-ul-Haq,46,12,34,40,207,4,43,0,26,20,46,130,166,296,322,322,26,0,10,2.95238,0.285714,34.9921,71.8195,126,4
Pakistan,211,222.621,7.38389,0.393365,235.517,7.54976,0.336493,184,Younis Khan,117,48,69,118,207,4,43,0,26,20,46,130,166,296,322,322,26,0,10,2.64655,0.215517,28.5,73.2713,116,4
Pakistan,211,222.621,7.38389,0.393365,235.517,7.54976,0.336493,184,Shahid Afridi,0,0,0,0,207,4,43,0,26,20,46,130,166,296,322,322,26,0,10,2.72917,0.0972222,21.4097,127.766,144,0
Pakistan,211,222.621,7.38389,0.393365,235.517,7.54976,0.336493,184,Sohail Tanvir,0,0,0,0,207,4,43,0,26,20,46,130,166,296,322,322,26,0,10,1.18919,0,9.08108,81.5534,37,1
India,259,242.378,7.15058,0.339768,244.568,7.12741,0.30888,185,Yuvraj Singh,74,34,40,92,182,3,39,1,22,22,44,130,135,265,0,294,29,1,10,4.05833,0.258333,32.525,83.8093,120,4
India,259,242.378,7.15058,0.339768,244.568,7.12741,0.30888,185,RV Uthappa,5,0,5,6,182,3,39,1,22,22,44,130,135,265,0,294,29,1,10,3,0.117647,22.1471,89.0071,34,0
India,259,242.378,7.15058,0.339768,244.568,7.12741,0.30888,185,Harbhajan Singh,0,0,0,0,182,3,39,1,22,22,44,130,135,265,0,294,29,1,10,0.901639,0,9.98361,76.4115,61,1
India,259,242.378,7.15058,0.339768,244.568,7.12741,0.30888,185,IK Pathan,0,0,0,0,182,3,39,1,22,22,44,130,135,265,0,294,29,1,10,1.875,0.025,16.85,78.2811,40,1
Pakistan,211,222.621,7.38389,0.393365,235.517,7.54976,0.336493,185,Salman Butt,120,64,56,135,187,4,35,3,4,9,13,116,119,235,295,248,13,0,10,5.4359,0.384615,42.3846,78.8645,39,4
Pakistan,211,222.621,7.38389,0.393365,235.517,7.54976,0.336493,185,Abdur Rehman,1,0,1,3,187,4,35,3,4,9,13,116,119,235,295,248,13,0,10,0.52381,0,6.04762,55.7018,21,3
Pakistan,211,222.621,7.38389,0.393365,235.517,7.54976,0.336493,185,Shoaib Akhtar,0,0,0,0,187,4,35,3,4,9,13,116,119,235,295,248,13,0,10,0.421053,0,3.21053,67.033,19,1
Pakistan,211,222.621,7.38389,0.393365,235.517,7.54976,0.336493,185,Umar Gul,0,0,0,0,187,4,35,3,4,9,13,116,119,235,295,248,13,0,10,0.77193,0,7.14035,68.2886,57,1
Pakistan,211,222.621,7.38389,0.393365,235.517,7.54976,0.336493,186,Misbah-ul-Haq,29,8,21,33,173,4,34,0,20,20,40,96,151,247,0,255,8,0,10,2.95238,0.285714,34.9921,71.8195,126,4
Pakistan,211,222.621,7.38389,0.393365,235.517,7.54976,0.336493,186,Mohammad Yousuf,78,30,48,88,173,4,34,0,20,20,40,96,151,247,0,255,8,0,10,3.27586,0.275862,36.7931,73.9176,58,4
Pakistan,211,222.621,7.38389,0.393365,235.517,7.54976,0.336493,186,Sohail Tanvir,0,0,0,0,173,4,34,0,20,20,40,96,151,247,0,255,8,0,10,1.18919,0,9.08108,81.5534,37,1
Pakistan,211,222.621,7.38389,0.393365,235.517,7.54976,0.336493,186,Kamran Akmal,0,0,0,0,173,4,34,0,20,20,40,96,151,247,0,255,8,0,10,3.01124,0.11236,23.0787,81.4433,89,4
India,259,242.378,7.15058,0.339768,244.568,7.12741,0.30888,186,Yuvraj Singh,50,22,28,59,200,4,36,0,6,4,10,130,116,246,256,260,14,1,10,4.05833,0.258333,32.525,83.8093,120,4
India,259,242.378,7.15058,0.339768,244.568,7.12741,0.30888,186,MS Dhoni,38,12,26,44,200,4,36,0,6,4,10,130,116,246,256,260,14,1,10,3.47872,0.292553,36.7713,84.1612,188,4
Pakistan,211,222.621,7.38389,0.393365,235.517,7.54976,0.336493,187,Misbah-ul-Haq,16,10,6,9,199,3,38,2,14,26,40,112,165,277,0,306,29,0,10,2.95238,0.285714,34.9921,71.8195,126,4
Pakistan,211,222.621,7.38389,0.393365,235.517,7.54976,0.336493,187,Fawad Alam,1,0,1,4,199,3,38,2,14,26,40,112,165,277,0,306,29,0,10,1.85294,0.176471,26.5588,72.6468,34,4
Pakistan,211,222.621,7.38389,0.393365,235.517,7.54976,0.336493,187,Sohail Tanvir,0,0,0,0,199,3,38,2,14,26,40,112,165,277,0,306,29,0,10,1.18919,0,9.08108,81.5534,37,1
India,259,242.378,7.15058,0.339768,244.568,7.12741,0.30888,187,IK Pathan,23,12,11,24,194,7,37,2,14,15,29,116,144,260,307,275,15,1,10,1.875,0.025,16.85,78.2811,40,1
India,259,242.378,7.15058,0.339768,244.568,7.12741,0.30888,187,S Sreesanth,1,0,1,3,194,7,37,2,14,15,29,116,144,260,307,275,15,1,10,0.125,0,2.4375,32.5,16,3
New Zealand,184,233.745,7.39674,0.36413,227.951,7.30435,0.353261,188,MS Sinclair,4,0,4,5,162,3,33,1,18,24,42,98,139,237,0,248,11,0,10,2.4,0.2,24.4,91.7293,5,0
New Zealand,184,233.745,7.39674,0.36413,227.951,7.30435,0.353261,188,JM How,85,44,41,120,162,3,33,1,18,24,42,98,139,237,0,248,11,0,10,3.34615,0.192308,29.9231,64.9416,26,4
New Zealand,184,233.745,7.39674,0.36413,227.951,7.30435,0.353261,188,GJ Hopkins,0,0,0,0,162,3,33,1,18,24,42,98,139,237,0,248,11,0,10,1.3125,0,14.75,74.4479,16,1
New Zealand,184,233.745,7.39674,0.36413,227.951,7.30435,0.353261,188,KD Mills,0,0,0,0,162,3,33,1,18,24,42,98,139,237,0,248,11,0,10,1.52542,0.0338983,12.8644,90.7895,59,0
South Africa,190,234.274,7.4,0.373684,232.363,7.33158,0.342105,188,JP Duminy,46,18,28,60,164,4,35,0,16,20,36,94,141,235,249,249,14,1,10,2.3252,0.186992,29.9675,80.2351,123,4
South Africa,190,234.274,7.4,0.373684,232.363,7.33158,0.342105,188,MV Boucher,21,8,13,27,164,4,35,0,16,20,36,94,141,235,249,249,14,1,10,2.21053,0.0877193,22.2281,89.3512,57,0
South Africa,190,234.274,7.4,0.373684,232.363,7.33158,0.342105,188,SM Pollock,0,0,0,0,164,4,35,0,16,20,36,94,141,235,249,249,14,1,10,1.58621,0.0689655,16.931,82.3826,29,1
South Africa,190,234.274,7.4,0.373684,232.363,7.33158,0.342105,188,JA Morkel,0,0,0,0,164,4,35,0,16,20,36,94,141,235,249,249,14,1,10,2.42424,0.0606061,19.9697,99.5468,33,0
South Africa,190,234.274,7.4,0.373684,232.363,7.33158,0.342105,188,J Botha,0,0,0,0,164,4,35,0,16,20,36,94,141,235,249,249,14,1,10,1.09756,0,11.561,82.2917,41,1
South Africa,190,234.274,7.4,0.373684,232.363,7.33158,0.342105,188,A Nel,0,0,0,0,164,4,35,0,16,20,36,94,141,235,249,249,14,1,10,1.06667,0,7.66667,81.5603,15,1
South Africa,190,234.274,7.4,0.373684,232.363,7.33158,0.342105,189,SM Pollock,48,16,32,71,133,5,21,1,32,17,49,84,119,203,0,209,6,1,10,1.58621,0.0689655,16.931,82.3826,29,1
South Africa,190,234.274,7.4,0.373684,232.363,7.33158,0.342105,189,JA Morkel,1,0,1,5,133,5,21,1,32,17,49,84,119,203,0,209,6,1,10,2.42424,0.0606061,19.9697,99.5468,33,0
South Africa,190,234.274,7.4,0.373684,232.363,7.33158,0.342105,189,J Botha,0,0,0,0,133,5,21,1,32,17,49,84,119,203,0,209,6,1,10,1.09756,0,11.561,82.2917,41,1
South Africa,190,234.274,7.4,0.373684,232.363,7.33158,0.342105,189,A Nel,0,0,0,0,133,5,21,1,32,17,49,84,119,203,0,209,6,1,10,1.06667,0,7.66667,81.5603,15,1
South Africa,190,234.274,7.4,0.373684,232.363,7.33158,0.342105,189,CK Langeveldt,0,0,0,0,133,5,21,1,32,17,49,84,119,203,0,209,6,1,10,0.571429,0,4.71429,59.4595,14,3
South Africa,190,234.274,7.4,0.373684,232.363,7.33158,0.342105,191,SM Pollock,2,0,2,2,178,4,35,1,6,25,31,114,130,244,0,255,11,1,10,1.58621,0.0689655,16.931,82.3826,29,1
South Africa,190,234.274,7.4,0.373684,232.363,7.33158,0.342105,191,JP Duminy,51,16,35,68,178,4,35,1,6,25,31,114,130,244,0,255,11,1,10,2.3252,0.186992,29.9675,80.2351,123,4
South Africa,190,234.274,7.4,0.373684,232.363,7.33158,0.342105,191,J Botha,0,0,0,0,178,4,35,1,6,25,31,114,130,244,0,255,11,1,10,1.09756,0,11.561,82.2917,41,1
South Africa,190,234.274,7.4,0.373684,232.363,7.33158,0.342105,191,DW Steyn,0,0,0,0,178,4,35,1,6,25,31,114,130,244,0,255,11,1,10,0.75,0,6.52273,61.588,44,1
South Africa,190,234.274,7.4,0.373684,232.363,7.33158,0.342105,191,M Morkel,0,0,0,0,178,4,35,1,6,25,31,114,130,244,0,255,11,1,10,0.6,0,5.28571,72.2656,35,1
West Indies,176,217.33,7.15909,0.3125,225.278,7.57386,0.380682,191,S Chanderpaul,52,20,32,76,129,7,23,1,0,7,7,72,87,159,256,169,10,0,10,3.57143,0.396825,40.8254,68.0783,63,4
West Indies,176,217.33,7.15909,0.3125,225.278,7.57386,0.380682,191,FH Edwards,4,4,0,5,129,7,23,1,0,7,7,72,87,159,256,169,10,0,10,0.384615,0,4.46154,50.4348,13,3
West Indies,176,217.33,7.15909,0.3125,225.278,7.57386,0.380682,191,JE Taylor,0,0,0,0,129,7,23,1,0,7,7,72,87,159,256,169,10,0,10,0.903226,0,6.96774,83.3977,31,1
West Indies,176,217.33,7.15909,0.3125,225.278,7.57386,0.380682,192,MN Samuels,68,32,36,72,145,4,49,2,20,20,40,124,110,234,0,252,18,0,10,3.74757,0.23301,31.6214,74.5821,103,4
West Indies,176,217.33,7.15909,0.3125,225.278,7.57386,0.380682,192,D Ramdin,2,0,2,2,145,4,49,2,20,20,40,124,110,234,0,252,18,0,10,1.7439,0.097561,19.1951,81.1759,82,1
South Africa,190,234.274,7.4,0.373684,232.363,7.33158,0.342105,192,JH Kallis,105,46,59,124,190,3,28,0,14,14,28,108,138,246,253,256,10,1,10,3.58621,0.356322,37.2644,76.4442,87,4
South Africa,190,234.274,7.4,0.373684,232.363,7.33158,0.342105,192,JP Duminy,24,4,20,38,190,3,28,0,14,14,28,108,138,246,253,256,10,1,10,2.3252,0.186992,29.9675,80.2351,123,4
West Indies,176,217.33,7.15909,0.3125,225.278,7.57386,0.380682,193,FH Edwards,0,0,0,0,151,5,47,4,40,14,54,144,108,252,0,263,11,0,10,0.384615,0,4.46154,50.4348,13,3
West Indies,176,217.33,7.15909,0.3125,225.278,7.57386,0.380682,193,JE Taylor,1,0,1,5,151,5,47,4,40,14,54,144,108,252,0,263,11,0,10,0.903226,0,6.96774,83.3977,31,1
South Africa,190,234.274,7.4,0.373684,232.363,7.33158,0.342105,193,SM Pollock,15,4,11,17,211,4,26,1,12,4,16,128,125,253,264,266,13,1,10,1.58621,0.0689655,16.931,82.3826,29,1
South Africa,190,234.274,7.4,0.373684,232.363,7.33158,0.342105,193,MV Boucher,11,4,7,14,211,4,26,1,12,4,16,128,125,253,264,266,13,1,10,2.21053,0.0877193,22.2281,89.3512,57,0
West Indies,176,217.33,7.15909,0.3125,225.278,7.57386,0.380682,194,PA Browne,26,4,22,54,203,4,19,3,28,22,50,128,144,272,0,295,23,0,10,2.6,0,26.8,73.224,5,4
West Indies,176,217.33,7.15909,0.3125,225.278,7.57386,0.380682,194,RN Lewis,1,0,1,4,203,4,19,3,28,22,50,128,144,272,0,295,23,0,10,1.66667,0,19.5,119.388,6,0
South Africa,190,234.274,7.4,0.373684,232.363,7.33158,0.342105,195,MV Boucher,2,0,2,4,193,2,23,2,34,17,51,132,135,267,0,294,27,0,10,2.21053,0.0877193,22.2281,89.3512,57,0
South Africa,190,234.274,7.4,0.373684,232.363,7.33158,0.342105,195,AB de Villiers,69,24,45,84,193,2,23,2,34,17,51,132,135,267,0,294,27,0,10,5.04969,0.403727,47.2174,98.8428,161,4
South Africa,190,234.274,7.4,0.373684,232.363,7.33158,0.342105,195,SM Pollock,0,0,0,0,193,2,23,2,34,17,51,132,135,267,0,294,27,0,10,1.58621,0.0689655,16.931,82.3826,29,1
Pakistan,211,222.621,7.38389,0.393365,235.517,7.54976,0.336493,195,Iftikhar Anjum,6,4,2,10,196,7,43,1,0,4,4,116,127,243,295,249,6,1,10,0.666667,0,7.33333,58.7786,21,3
Pakistan,211,222.621,7.38389,0.393365,235.517,7.54976,0.336493,195,Shahid Afridi,47,32,15,26,196,7,43,1,0,4,4,116,127,243,295,249,6,1,10,2.72917,0.0972222,21.4097,127.766,144,0
Pakistan,211,222.621,7.38389,0.393365,235.517,7.54976,0.336493,195,Umar Gul,0,0,0,0,196,7,43,1,0,4,4,116,127,243,295,249,6,1,10,0.77193,0,7.14035,68.2886,57,1
Pakistan,211,222.621,7.38389,0.393365,235.517,7.54976,0.336493,196,Sohail Tanvir,0,0,0,0,179,4,40,2,14,15,29,98,150,248,0,265,17,1,10,1.18919,0,9.08108,81.5534,37,1
Pakistan,211,222.621,7.38389,0.393365,235.517,7.54976,0.336493,196,Mohammad Yousuf,102,28,74,130,179,4,40,2,14,15,29,98,150,248,0,265,17,1,10,3.27586,0.275862,36.7931,73.9176,58,4
Pakistan,211,222.621,7.38389,0.393365,235.517,7.54976,0.336493,196,Abdur Rehman,0,0,0,0,179,4,40,2,14,15,29,98,150,248,0,265,17,1,10,0.52381,0,6.04762,55.7018,21,3
Pakistan,211,222.621,7.38389,0.393365,235.517,7.54976,0.336493,196,Iftikhar Anjum,0,0,0,0,179,4,40,2,14,15,29,98,150,248,0,265,17,1,10,0.666667,0,7.33333,58.7786,21,3
Pakistan,211,222.621,7.38389,0.393365,235.517,7.54976,0.336493,196,Umar Gul,0,0,0,0,179,4,40,2,14,15,29,98,150,248,0,265,17,1,10,0.77193,0,7.14035,68.2886,57,1
South Africa,190,234.274,7.4,0.373684,232.363,7.33158,0.342105,196,SM Pollock,37,14,23,46,172,6,22,1,12,14,26,84,136,220,266,240,20,0,10,1.58621,0.0689655,16.931,82.3826,29,1
South Africa,190,234.274,7.4,0.373684,232.363,7.33158,0.342105,196,CK Langeveldt,0,0,0,0,172,6,22,1,12,14,26,84,136,220,266,240,20,0,10,0.571429,0,4.71429,59.4595,14,3
South Africa,190,234.274,7.4,0.373684,232.363,7.33158,0.342105,196,J Botha,4,0,4,8,172,6,22,1,12,14,26,84,136,220,266,240,20,0,10,1.09756,0,11.561,82.2917,41,1
South Africa,190,234.274,7.4,0.373684,232.363,7.33158,0.342105,196,M Ntini,0,0,0,0,172,6,22,1,12,14,26,84,136,220,266,240,20,0,10,0.375,0,3.25,63.4146,16,1
South Africa,190,234.274,7.4,0.373684,232.363,7.33158,0.342105,197,SM Pollock,0,0,0,0,137,4,25,2,4,14,18,72,108,180,0,197,17,0,10,1.58621,0.0689655,16.931,82.3826,29,1
South Africa,190,234.274,7.4,0.373684,232.363,7.33158,0.342105,197,JA Morkel,6,4,2,4,137,4,25,2,4,14,18,72,108,180,0,197,17,0,10,2.42424,0.0606061,19.9697,99.5468,33,0
South Africa,190,234.274,7.4,0.373684,232.363,7.33158,0.342105,197,J Botha,0,0,0,0,137,4,25,2,4,14,18,72,108,180,0,197,17,0,10,1.09756,0,11.561,82.2917,41,1
South Africa,190,234.274,7.4,0.373684,232.363,7.33158,0.342105,197,CK Langeveldt,0,0,0,0,137,4,25,2,4,14,18,72,108,180,0,197,17,0,10,0.571429,0,4.71429,59.4595,14,3
South Africa,190,234.274,7.4,0.373684,232.363,7.33158,0.342105,197,M Ntini,0,0,0,0,137,4,25,2,4,14,18,72,108,180,0,197,17,0,10,0.375,0,3.25,63.4146,16,1
Pakistan,211,222.621,7.38389,0.393365,235.517,7.54976,0.336493,197,Mohammad Yousuf,54,4,50,106,146,4,21,0,14,8,22,72,117,189,198,202,13,1,10,3.27586,0.275862,36.7931,73.9176,58,4
Pakistan,211,222.621,7.38389,0.393365,235.517,7.54976,0.336493,197,Misbah-ul-Haq,11,0,11,20,146,4,21,0,14,8,22,72,117,189,198,202,13,1,10,2.95238,0.285714,34.9921,71.8195,126,4
Pakistan,211,222.621,7.38389,0.393365,235.517,7.54976,0.336493,198,Abdur Rehman,10,0,10,25,157,6,11,0,26,17,43,82,129,211,0,230,19,1,10,0.52381,0,6.04762,55.7018,21,3
Pakistan,211,222.621,7.38389,0.393365,235.517,7.54976,0.336493,198,Kamran Akmal,9,0,9,19,157,6,11,0,26,17,43,82,129,211,0,230,19,1,10,3.01124,0.11236,23.0787,81.4433,89,4
Pakistan,211,222.621,7.38389,0.393365,235.517,7.54976,0.336493,198,Iftikhar Anjum,0,0,0,0,157,6,11,0,26,17,43,82,129,211,0,230,19,1,10,0.666667,0,7.33333,58.7786,21,3
Pakistan,211,222.621,7.38389,0.393365,235.517,7.54976,0.336493,198,Umar Gul,0,0,0,0,157,6,11,0,26,17,43,82,129,211,0,230,19,1,10,0.77193,0,7.14035,68.2886,57,1
Bangladesh,160,218.438,7.70625,0.4,211.106,7.05,0.325,199,Shahadat Hossain,2,0,2,5,165,7,25,2,0,6,6,112,84,196,0,201,5,0,10,0.375,0,3.5625,50.4425,16,3
Bangladesh,160,218.438,7.70625,0.4,211.106,7.05,0.325,199,Abdur Razzak,17,14,3,14,165,7,25,2,0,6,6,112,84,196,0,201,5,0,10,0.849315,0.0136986,8.39726,73.8554,73,1
New Zealand,184,233.745,7.39674,0.36413,227.951,7.30435,0.353261,200,JDP Oram,4,0,4,11,232,3,21,1,54,15,69,162,160,322,0,335,13,1,10,2.70833,0.1875,25.0417,95.8533,48,0
New Zealand,184,233.745,7.39674,0.36413,227.951,7.30435,0.353261,200,LRPL Taylor,16,0,16,16,232,3,21,1,54,15,69,162,160,322,0,335,13,1,10,3.68382,0.301471,36.7206,79.3959,136,4
England,221,237.176,7.17647,0.289593,230.633,7.45701,0.384615,202,SCJ Broad,11,4,7,32,99,8,11,0,0,10,10,28,92,120,0,130,10,0,10,0.725806,0,8.04839,74.0356,62,1
England,221,237.176,7.17647,0.289593,230.633,7.45701,0.384615,202,RJ Sidebottom,4,0,4,26,99,8,11,0,0,10,10,28,92,120,0,130,10,0,10,0.6875,0,7.6875,65.7754,16,1
England,221,237.176,7.17647,0.289593,230.633,7.45701,0.384615,202,JM Anderson,0,0,0,0,99,8,11,0,0,10,10,28,92,120,0,130,10,0,10,0.365385,0,3.92308,52.7132,52,3
New Zealand,184,233.745,7.39674,0.36413,227.951,7.30435,0.353261,204,JDP Oram,67,28,39,77,150,6,41,1,18,17,35,100,126,226,0,234,8,1,10,2.70833,0.1875,25.0417,95.8533,48,0
New Zealand,184,233.745,7.39674,0.36413,227.951,7.30435,0.353261,204,KD Mills,7,0,7,10,150,6,41,1,18,17,35,100,126,226,0,234,8,1,10,1.52542,0.0338983,12.8644,90.7895,59,0
New Zealand,184,233.745,7.39674,0.36413,227.951,7.30435,0.353261,204,PA Hitchcock,0,0,0,0,150,6,41,1,18,17,35,100,126,226,0,234,8,1,10,1,0,10,90.9091,1,0
England,221,237.176,7.17647,0.289593,230.633,7.45701,0.384615,205,PD Collingwood,27,18,9,15,233,3,42,1,32,21,53,180,148,328,0,340,12,0,10,2.62366,0.193548,30.5161,76.8065,93,4
England,221,237.176,7.17647,0.289593,230.633,7.45701,0.384615,205,OA Shah,3,0,3,5,233,3,42,1,32,21,53,180,148,328,0,340,12,0,10,3.13043,0.23913,32.6739,81.1994,46,4
England,221,237.176,7.17647,0.289593,230.633,7.45701,0.384615,205,LJ Wright,0,0,0,0,233,3,42,1,32,21,53,180,148,328,0,340,12,0,10,1.92105,0.0263158,17.2368,81.875,38,1
New Zealand,184,233.745,7.39674,0.36413,227.951,7.30435,0.353261,205,JM How,127,58,69,107,255,3,37,2,8,24,32,154,170,324,341,340,16,1,10,3.34615,0.192308,29.9231,64.9416,26,4
New Zealand,184,233.745,7.39674,0.36413,227.951,7.30435,0.353261,205,JDP Oram,0,0,0,0,255,3,37,2,8,24,32,154,170,324,341,340,16,1,10,2.70833,0.1875,25.0417,95.8533,48,0
New Zealand,184,233.745,7.39674,0.36413,227.951,7.30435,0.353261,205,DL Vettori,0,0,0,0,255,3,37,2,8,24,32,154,170,324,341,340,16,1,10,1.43662,0.028169,15.7606,86.0108,71,0
England,221,237.176,7.17647,0.289593,230.633,7.45701,0.384615,206,OA Shah,23,4,19,43,150,5,23,0,40,24,64,104,133,237,0,242,5,0,10,3.13043,0.23913,32.6739,81.1994,46,4
England,221,237.176,7.17647,0.289593,230.633,7.45701,0.384615,206,LJ Wright,29,16,13,34,150,5,23,0,40,24,64,104,133,237,0,242,5,0,10,1.92105,0.0263158,17.2368,81.875,38,1
England,221,237.176,7.17647,0.289593,230.633,7.45701,0.384615,206,SCJ Broad,0,0,0,0,150,5,23,0,40,24,64,104,133,237,0,242,5,0,10,0.725806,0,8.04839,74.0356,62,1
England,221,237.176,7.17647,0.289593,230.633,7.45701,0.384615,206,AD Mascarenhas,0,0,0,0,150,5,23,0,40,24,64,104,133,237,0,242,5,0,10,1.83333,0.0833333,18.5,89.5161,12,0
Zimbabwe,142,212.077,7.5,0.380282,227.704,6.97887,0.316901,207,E Chigumbura,35,12,23,68,124,7,21,0,30,15,45,96,94,190,0,206,16,1,10,2.28947,0.114035,22.7895,77.7844,114,4
Zimbabwe,142,212.077,7.5,0.380282,227.704,6.97887,0.316901,207,GB Brent,46,22,24,71,124,7,21,0,30,15,45,96,94,190,0,206,16,1,10,0.75,0.0625,10.5,61.5385,16,1
Zimbabwe,142,212.077,7.5,0.380282,227.704,6.97887,0.316901,207,T Maruma,0,0,0,0,124,7,21,0,30,15,45,96,94,190,0,206,16,1,10,0.5,0,5.5,38.3721,12,3
South Africa,190,234.274,7.4,0.373684,232.363,7.33158,0.342105,207,VD Philander,3,0,3,5,153,4,30,1,12,5,17,88,112,200,207,210,10,0,10,0.8125,0,8.8125,66.5094,16,1
South Africa,190,234.274,7.4,0.373684,232.363,7.33158,0.342105,207,SM Pollock,13,4,9,14,153,4,30,1,12,5,17,88,112,200,207,210,10,0,10,1.58621,0.0689655,16.931,82.3826,29,1
South Africa,190,234.274,7.4,0.373684,232.363,7.33158,0.342105,208,AB de Villiers,103,64,39,88,238,2,34,3,16,22,38,174,136,310,0,323,13,0,10,5.04969,0.403727,47.2174,98.8428,161,4
South Africa,190,234.274,7.4,0.373684,232.363,7.33158,0.342105,208,JP Duminy,0,0,0,0,238,2,34,3,16,22,38,174,136,310,0,323,13,0,10,2.3252,0.186992,29.9675,80.2351,123,4
South Africa,190,234.274,7.4,0.373684,232.363,7.33158,0.342105,208,M Morkel,0,0,0,0,238,2,34,3,16,22,38,174,136,310,0,323,13,0,10,0.6,0,5.28571,72.2656,35,1
South Africa,190,234.274,7.4,0.373684,232.363,7.33158,0.342105,208,M Ntini,0,0,0,0,238,2,34,3,16,22,38,174,136,310,0,323,13,0,10,0.375,0,3.25,63.4146,16,1
Zimbabwe,142,212.077,7.5,0.380282,227.704,6.97887,0.316901,208,T Taibu,95,38,57,91,223,4,37,1,4,19,23,148,135,283,324,295,12,1,10,2.36364,0.254545,29.4,71.0145,55,4
Zimbabwe,142,212.077,7.5,0.380282,227.704,6.97887,0.316901,208,S Matsikenyeri,17,8,9,11,223,4,37,1,4,19,23,148,135,283,324,295,12,1,10,2,0.106383,19.9787,75.7869,47,1
Zimbabwe,142,212.077,7.5,0.380282,227.704,6.97887,0.316901,208,GB Brent,0,0,0,0,223,4,37,1,4,19,23,148,135,283,324,295,12,1,10,0.75,0.0625,10.5,61.5385,16,1
Zimbabwe,142,212.077,7.5,0.380282,227.704,6.97887,0.316901,208,P Utseya,0,0,0,0,223,4,37,1,4,19,23,148,135,283,324,295,12,1,10,0.842105,0.0263158,11.8289,55.8385,76,3
Zimbabwe,142,212.077,7.5,0.380282,227.704,6.97887,0.316901,212,S Matsikenyeri,24,6,18,26,180,5,35,0,16,28,44,108,151,259,0,274,15,1,10,2,0.106383,19.9787,75.7869,47,1
Zimbabwe,142,212.077,7.5,0.380282,227.704,6.97887,0.316901,212,E Chigumbura,31,6,25,29,180,5,35,0,16,28,44,108,151,259,0,274,15,1,10,2.28947,0.114035,22.7895,77.7844,114,4
Zimbabwe,142,212.077,7.5,0.380282,227.704,6.97887,0.316901,212,P Utseya,0,0,0,0,180,5,35,0,16,28,44,108,151,259,0,274,15,1,10,0.842105,0.0263158,11.8289,55.8385,76,3
Zimbabwe,142,212.077,7.5,0.380282,227.704,6.97887,0.316901,212,KM Dabengwa,0,0,0,0,180,5,35,0,16,28,44,108,151,259,0,274,15,1,10,1.2,0,16.7,61.1722,20,1
West Indies,176,217.33,7.15909,0.3125,225.278,7.57386,0.380682,212,S Chanderpaul,102,24,78,127,159,3,29,0,22,26,48,72,164,236,275,244,8,0,10,3.57143,0.396825,40.8254,68.0783,63,4
West Indies,176,217.33,7.15909,0.3125,225.278,7.57386,0.380682,212,RS Morton,54,10,44,73,159,3,29,0,22,26,48,72,164,236,275,244,8,0,10,2.2963,0.222222,28.8889,67.0103,27,4
West Indies,176,217.33,7.15909,0.3125,225.278,7.57386,0.380682,212,RN Lewis,0,0,0,0,159,3,29,0,22,26,48,72,164,236,275,244,8,0,10,1.66667,0,19.5,119.388,6,0
West Indies,176,217.33,7.15909,0.3125,225.278,7.57386,0.380682,212,DJ Bravo,0,0,0,0,159,3,29,0,22,26,48,72,164,236,275,244,8,0,10,2.35514,0.11215,23.1589,80.9011,107,4
West Indies,176,217.33,7.15909,0.3125,225.278,7.57386,0.380682,212,D Ramdin,0,0,0,0,159,3,29,0,22,26,48,72,164,236,275,244,8,0,10,1.7439,0.097561,19.1951,81.1759,82,1
West Indies,176,217.33,7.15909,0.3125,225.278,7.57386,0.380682,212,R Rampaul,0,0,0,0,159,3,29,0,22,26,48,72,164,236,275,244,8,0,10,1.30303,0.030303,9.90909,77.4882,33,1
West Indies,176,217.33,7.15909,0.3125,225.278,7.57386,0.380682,212,JE Taylor,0,0,0,0,159,3,29,0,22,26,48,72,164,236,275,244,8,0,10,0.903226,0,6.96774,83.3977,31,1
West Indies,176,217.33,7.15909,0.3125,225.278,7.57386,0.380682,213,D Ramdin,7,0,7,11,200,4,23,2,26,20,46,112,157,269,0,286,17,0,10,1.7439,0.097561,19.1951,81.1759,82,1
West Indies,176,217.33,7.15909,0.3125,225.278,7.57386,0.380682,213,RN Lewis,12,6,6,11,200,4,23,2,26,20,46,112,157,269,0,286,17,0,10,1.66667,0,19.5,119.388,6,0
West Indies,176,217.33,7.15909,0.3125,225.278,7.57386,0.380682,213,R Rampaul,0,0,0,0,200,4,23,2,26,20,46,112,157,269,0,286,17,0,10,1.30303,0.030303,9.90909,77.4882,33,1
West Indies,176,217.33,7.15909,0.3125,225.278,7.57386,0.380682,213,JE Taylor,0,0,0,0,200,4,23,2,26,20,46,112,157,269,0,286,17,0,10,0.903226,0,6.96774,83.3977,31,1
West Indies,176,217.33,7.15909,0.3125,225.278,7.57386,0.380682,213,DBL Powell,0,0,0,0,200,4,23,2,26,20,46,112,157,269,0,286,17,0,10,0.529412,0,5.76471,77.1654,17,1
Zimbabwe,142,212.077,7.5,0.380282,227.704,6.97887,0.316901,214,BRM Taylor,19,4,15,22,174,3,30,2,4,18,22,84,142,226,0,232,6,1,10,3.3,0.26,33.56,76.3421,100,4
Zimbabwe,142,212.077,7.5,0.380282,227.704,6.97887,0.316901,214,KM Dabengwa,1,0,1,1,174,3,30,2,4,18,22,84,142,226,0,232,6,1,10,1.2,0,16.7,61.1722,20,1
Zimbabwe,142,212.077,7.5,0.380282,227.704,6.97887,0.316901,214,CJ Chibhabha,0,0,0,0,174,3,30,2,4,18,22,84,142,226,0,232,6,1,10,2.56716,0.149254,23.5373,64.7373,67,1
Zimbabwe,142,212.077,7.5,0.380282,227.704,6.97887,0.316901,214,P Utseya,0,0,0,0,174,3,30,2,4,18,22,84,142,226,0,232,6,1,10,0.842105,0.0263158,11.8289,55.8385,76,3
Zimbabwe,142,212.077,7.5,0.380282,227.704,6.97887,0.316901,214,GB Brent,0,0,0,0,174,3,30,2,4,18,22,84,142,226,0,232,6,1,10,0.75,0.0625,10.5,61.5385,16,1
Zimbabwe,142,212.077,7.5,0.380282,227.704,6.97887,0.316901,214,RW Price,0,0,0,0,174,3,30,2,4,18,22,84,142,226,0,232,6,1,10,0.666667,0,7.16667,57.2062,36,3
West Indies,176,217.33,7.15909,0.3125,225.278,7.57386,0.380682,214,DJ Bravo,25,6,19,35,179,4,22,1,10,9,19,96,124,220,233,234,14,0,10,2.35514,0.11215,23.1589,80.9011,107,4
West Indies,176,217.33,7.15909,0.3125,225.278,7.57386,0.380682,214,D Ramdin,2,0,2,4,179,4,22,1,10,9,19,96,124,220,233,234,14,0,10,1.7439,0.097561,19.1951,81.1759,82,1
Sri Lanka,244,223.373,7.09016,0.344262,227.578,7.47541,0.385246,215,LPC Silva,67,28,39,96,138,5,32,0,22,17,39,94,115,209,0,235,26,0,10,2.55556,0.244444,26.0222,69.4543,45,4
Sri Lanka,244,223.373,7.09016,0.344262,227.578,7.47541,0.385246,215,CK Kapugedera,67,24,43,101,138,5,32,0,22,17,39,94,115,209,0,235,26,0,10,1.74138,0.12069,21.1379,68.6066,58,1
Sri Lanka,244,223.373,7.09016,0.344262,227.578,7.47541,0.385246,215,WPUJC Vaas,0,0,0,0,138,5,32,0,22,17,39,94,115,209,0,235,26,0,10,0.653846,0,8.65385,66.1765,26,1
Sri Lanka,244,223.373,7.09016,0.344262,227.578,7.47541,0.385246,215,KMDN Kulasekara,0,0,0,0,138,5,32,0,22,17,39,94,115,209,0,235,26,0,10,1.21,0.04,11.8,80.9328,100,1
West Indies,176,217.33,7.15909,0.3125,225.278,7.57386,0.380682,215,DJG Sammy,0,0,0,0,169,5,22,1,20,15,35,120,106,226,236,236,10,1,10,2.25,0.09,18.25,95.8005,100,0
West Indies,176,217.33,7.15909,0.3125,225.278,7.57386,0.380682,215,S Chanderpaul,39,12,27,50,169,5,22,1,20,15,35,120,106,226,236,236,10,1,10,3.57143,0.396825,40.8254,68.0783,63,4
West Indies,176,217.33,7.15909,0.3125,225.278,7.57386,0.380682,215,JE Taylor,0,0,0,0,169,5,22,1,20,15,35,120,106,226,236,236,10,1,10,0.903226,0,6.96774,83.3977,31,1
West Indies,176,217.33,7.15909,0.3125,225.278,7.57386,0.380682,215,SJ Benn,0,0,0,0,169,5,22,1,20,15,35,120,106,226,236,236,10,1,10,0.8,0,6.75,72.973,20,1
West Indies,176,217.33,7.15909,0.3125,225.278,7.57386,0.380682,215,FH Edwards,0,0,0,0,169,5,22,1,20,15,35,120,106,226,236,236,10,1,10,0.384615,0,4.46154,50.4348,13,3
Australia,228,239.627,7.69737,0.372807,232.079,7.23246,0.337719,217,JR Hopes,0,0,0,0,133,4,32,1,8,27,35,66,134,200,0,213,13,0,10,2.09259,0.0555556,21.2778,91.4809,54,0
Australia,228,239.627,7.69737,0.372807,232.079,7.23246,0.337719,217,CL White,22,8,14,25,133,4,32,1,8,27,35,66,134,200,0,213,13,0,10,2.66176,0.191176,28.8235,80.1308,68,4
West Indies,176,217.33,7.15909,0.3125,225.278,7.57386,0.380682,218,DBL Powell,1,0,1,2,174,5,21,2,4,5,9,86,118,204,0,223,19,1,10,0.529412,0,5.76471,77.1654,17,1
West Indies,176,217.33,7.15909,0.3125,225.278,7.57386,0.380682,218,D Ramdin,21,4,17,28,174,5,21,2,4,5,9,86,118,204,0,223,19,1,10,1.7439,0.097561,19.1951,81.1759,82,1
West Indies,176,217.33,7.15909,0.3125,225.278,7.57386,0.380682,218,FH Edwards,0,0,0,0,174,5,21,2,4,5,9,86,118,204,0,223,19,1,10,0.384615,0,4.46154,50.4348,13,3
West Indies,176,217.33,7.15909,0.3125,225.278,7.57386,0.380682,218,SJ Benn,0,0,0,0,174,5,21,2,4,5,9,86,118,204,0,223,19,1,10,0.8,0,6.75,72.973,20,1
Australia,228,239.627,7.69737,0.372807,232.079,7.23246,0.337719,219,A Symonds,76,42,34,75,183,4,40,0,20,22,42,124,141,265,0,282,17,0,10,3.44186,0.302326,32.0465,91.5615,43,4
Australia,228,239.627,7.69737,0.372807,232.079,7.23246,0.337719,219,DJ Hussey,38,10,28,44,183,4,40,0,20,22,42,124,141,265,0,282,17,0,10,2.54386,0.245614,29.2105,87.8628,57,4
Australia,228,239.627,7.69737,0.372807,232.079,7.23246,0.337719,219,JR Hopes,0,0,0,0,183,4,40,0,20,22,42,124,141,265,0,282,17,0,10,2.09259,0.0555556,21.2778,91.4809,54,0
Australia,228,239.627,7.69737,0.372807,232.079,7.23246,0.337719,219,L Ronchi,0,0,0,0,183,4,40,0,20,22,42,124,141,265,0,282,17,0,10,2.92157,0.0784314,22.1961,115.392,51,0
Australia,228,239.627,7.69737,0.372807,232.079,7.23246,0.337719,219,B Lee,0,0,0,0,183,4,40,0,20,22,42,124,141,265,0,282,17,0,10,1.09091,0.0227273,10.8182,81.5068,44,1
Australia,228,239.627,7.69737,0.372807,232.079,7.23246,0.337719,219,MG Johnson,0,0,0,0,183,4,40,0,20,22,42,124,141,265,0,282,17,0,10,1.18519,0.0246914,10.7901,94.181,81,0
West Indies,176,217.33,7.15909,0.3125,225.278,7.57386,0.380682,219,S Chanderpaul,46,16,30,63,211,3,21,1,6,18,24,114,142,256,283,281,25,1,10,3.57143,0.396825,40.8254,68.0783,63,4
West Indies,176,217.33,7.15909,0.3125,225.278,7.57386,0.380682,219,SE Findlay,0,0,0,6,211,3,21,1,6,18,24,114,142,256,283,281,25,1,10,2.75,0.25,22,62.8571,4,1
West Indies,176,217.33,7.15909,0.3125,225.278,7.57386,0.380682,219,D Ramdin,0,0,0,0,211,3,21,1,6,18,24,114,142,256,283,281,25,1,10,1.7439,0.097561,19.1951,81.1759,82,1
West Indies,176,217.33,7.15909,0.3125,225.278,7.57386,0.380682,219,DJG Sammy,0,0,0,0,211,3,21,1,6,18,24,114,142,256,283,281,25,1,10,2.25,0.09,18.25,95.8005,100,0
Australia,228,239.627,7.69737,0.372807,232.079,7.23246,0.337719,220,DJ Hussey,4,0,4,4,230,4,37,1,52,15,67,194,140,334,0,341,7,0,10,2.54386,0.245614,29.2105,87.8628,57,4
Australia,228,239.627,7.69737,0.372807,232.079,7.23246,0.337719,220,MEK Hussey,50,12,38,54,230,4,37,1,52,15,67,194,140,334,0,341,7,0,10,2.7563,0.260504,34.084,82.4893,119,4
Australia,228,239.627,7.69737,0.372807,232.079,7.23246,0.337719,220,JR Hopes,0,0,0,0,230,4,37,1,52,15,67,194,140,334,0,341,7,0,10,2.09259,0.0555556,21.2778,91.4809,54,0
Bangladesh,160,218.438,7.70625,0.4,211.106,7.05,0.325,221,Dhiman Ghosh,10,0,10,27,137,6,15,1,6,9,15,60,107,167,0,178,11,1,10,0.909091,0,11.2727,60.4878,11,1
Bangladesh,160,218.438,7.70625,0.4,211.106,7.05,0.325,221,Abdur Razzak,5,0,5,5,137,6,15,1,6,9,15,60,107,167,0,178,11,1,10,0.849315,0.0136986,8.39726,73.8554,73,1
Bangladesh,160,218.438,7.70625,0.4,211.106,7.05,0.325,221,Shahadat Hossain,0,0,0,0,137,6,15,1,6,9,15,60,107,167,0,178,11,1,10,0.375,0,3.5625,50.4425,16,3
Bangladesh,160,218.438,7.70625,0.4,211.106,7.05,0.325,221,Syed Rasel,0,0,0,0,137,6,15,1,6,9,15,60,107,167,0,178,11,1,10,0.222222,0,2.88889,37.6812,18,3
Bangladesh,160,218.438,7.70625,0.4,211.106,7.05,0.325,222,Mashrafe Mortaza,8,0,8,22,129,7,13,1,4,9,13,48,107,155,0,173,18,1,10,1.27536,0,11.1594,76.9231,69,1
Bangladesh,160,218.438,7.70625,0.4,211.106,7.05,0.325,222,Syed Rasel,0,0,0,0,129,7,13,1,4,9,13,48,107,155,0,173,18,1,10,0.222222,0,2.88889,37.6812,18,3
South Africa,190,234.274,7.4,0.373684,232.363,7.33158,0.342105,222,AB de Villiers,54,4,50,99,137,3,9,0,10,9,19,38,127,165,174,179,14,0,10,5.04969,0.403727,47.2174,98.8428,161,4
South Africa,190,234.274,7.4,0.373684,232.363,7.33158,0.342105,222,JP Duminy,45,4,41,90,137,3,9,0,10,9,19,38,127,165,174,179,14,0,10,2.3252,0.186992,29.9675,80.2351,123,4
Zimbabwe,142,212.077,7.5,0.380282,227.704,6.97887,0.316901,226,T Taibu,73,20,53,100,202,3,37,1,22,18,40,130,149,279,0,303,24,0,10,2.36364,0.254545,29.4,71.0145,55,4
Zimbabwe,142,212.077,7.5,0.380282,227.704,6.97887,0.316901,226,E Chigumbura,0,0,0,0,202,3,37,1,22,18,40,130,149,279,0,303,24,0,10,2.28947,0.114035,22.7895,77.7844,114,4
Zimbabwe,142,212.077,7.5,0.380282,227.704,6.97887,0.316901,226,KM Dabengwa,0,0,0,0,202,3,37,1,22,18,40,130,149,279,0,303,24,0,10,1.2,0,16.7,61.1722,20,1
Zimbabwe,142,212.077,7.5,0.380282,227.704,6.97887,0.316901,226,T Maruma,0,0,0,0,202,3,37,1,22,18,40,130,149,279,0,303,24,0,10,0.5,0,5.5,38.3721,12,3
Zimbabwe,142,212.077,7.5,0.380282,227.704,6.97887,0.316901,226,P Utseya,0,0,0,0,202,3,37,1,22,18,40,130,149,279,0,303,24,0,10,0.842105,0.0263158,11.8289,55.8385,76,3
Ireland,55,219.527,7.65455,0.290909,202.727,7.56364,0.4,226,WK McCallan,19,12,7,23,112,8,19,0,4,2,6,68,69,137,304,147,10,0,10,0.692308,0,7.69231,56.8182,13,3
Ireland,55,219.527,7.65455,0.290909,202.727,7.56364,0.4,226,PC Connell,6,4,2,22,112,8,19,0,4,2,6,68,69,137,304,147,10,0,10,1,0,6,26.087,1,3
Pakistan,211,222.621,7.38389,0.393365,235.517,7.54976,0.336493,227,Shoaib Malik,46,10,36,45,250,4,37,0,20,29,49,140,196,336,0,347,11,0,10,2.77551,0.193878,28.7041,81.4418,98,4
Pakistan,211,222.621,7.38389,0.393365,235.517,7.54976,0.336493,227,Misbah-ul-Haq,25,8,17,21,250,4,37,0,20,29,49,140,196,336,0,347,11,0,10,2.95238,0.285714,34.9921,71.8195,126,4
Pakistan,211,222.621,7.38389,0.393365,235.517,7.54976,0.336493,227,Shahid Afridi,0,0,0,0,250,4,37,0,20,29,49,140,196,336,0,347,11,0,10,2.72917,0.0972222,21.4097,127.766,144,0
Zimbabwe,142,212.077,7.5,0.380282,227.704,6.97887,0.316901,227,SC Williams,27,0,27,46,176,6,13,1,14,24,38,78,149,227,348,243,16,0,10,2.56923,0.276923,28.5385,80.7927,65,4
Zimbabwe,142,212.077,7.5,0.380282,227.704,6.97887,0.316901,227,P Utseya,4,0,4,8,176,6,13,1,14,24,38,78,149,227,348,243,16,0,10,0.842105,0.0263158,11.8289,55.8385,76,3
Zimbabwe,142,212.077,7.5,0.380282,227.704,6.97887,0.316901,228,SC Williams,1,0,1,1,185,3,19,2,8,15,23,74,153,227,0,238,11,0,10,2.56923,0.276923,28.5385,80.7927,65,4
Zimbabwe,142,212.077,7.5,0.380282,227.704,6.97887,0.316901,228,T Taibu,80,12,68,113,185,3,19,2,8,15,23,74,153,227,0,238,11,0,10,2.36364,0.254545,29.4,71.0145,55,4
Zimbabwe,142,212.077,7.5,0.380282,227.704,6.97887,0.316901,228,S Matsikenyeri,0,0,0,0,185,3,19,2,8,15,23,74,153,227,0,238,11,0,10,2,0.106383,19.9787,75.7869,47,1
Zimbabwe,142,212.077,7.5,0.380282,227.704,6.97887,0.316901,228,P Utseya,0,0,0,0,185,3,19,2,8,15,23,74,153,227,0,238,11,0,10,0.842105,0.0263158,11.8289,55.8385,76,3
Zimbabwe,142,212.077,7.5,0.380282,227.704,6.97887,0.316901,228,GB Brent,0,0,0,0,185,3,19,2,8,15,23,74,153,227,0,238,11,0,10,0.75,0.0625,10.5,61.5385,16,1
Pakistan,211,222.621,7.38389,0.393365,235.517,7.54976,0.336493,228,Shahid Afridi,32,18,14,22,187,5,31,0,10,3,13,120,111,231,239,239,8,0,10,2.72917,0.0972222,21.4097,127.766,144,0
Pakistan,211,222.621,7.38389,0.393365,235.517,7.54976,0.336493,228,Mohammad Yousuf,36,8,28,61,187,5,31,0,10,3,13,120,111,231,239,239,8,0,10,3.27586,0.275862,36.7931,73.9176,58,4
Pakistan,211,222.621,7.38389,0.393365,235.517,7.54976,0.336493,229,Kamran Hussain,4,0,4,5,196,6,24,1,12,28,40,112,148,260,0,272,12,1,10,2,0,27,128.571,1,0
Pakistan,211,222.621,7.38389,0.393365,235.517,7.54976,0.336493,229,Kamran Akmal,14,4,10,25,196,6,24,1,12,28,40,112,148,260,0,272,12,1,10,3.01124,0.11236,23.0787,81.4433,89,4
Pakistan,211,222.621,7.38389,0.393365,235.517,7.54976,0.336493,229,Sohail Tanvir,0,0,0,0,196,6,24,1,12,28,40,112,148,260,0,272,12,1,10,1.18919,0,9.08108,81.5534,37,1
Zimbabwe,142,212.077,7.5,0.380282,227.704,6.97887,0.316901,229,E Chigumbura,21,0,21,26,164,5,23,2,8,22,30,36,181,217,273,235,18,0,10,2.28947,0.114035,22.7895,77.7844,114,4
Zimbabwe,142,212.077,7.5,0.380282,227.704,6.97887,0.316901,229,GB Brent,4,0,4,8,164,5,23,2,8,22,30,36,181,217,273,235,18,0,10,0.75,0.0625,10.5,61.5385,16,1
Zimbabwe,142,212.077,7.5,0.380282,227.704,6.97887,0.316901,230,KM Dabengwa,15,4,11,16,166,6,25,1,20,20,40,74,157,231,0,244,13,0,10,1.2,0,16.7,61.1722,20,1
Zimbabwe,142,212.077,7.5,0.380282,227.704,6.97887,0.316901,230,GB Brent,11,4,7,13,166,6,25,1,20,20,40,74,157,231,0,244,13,0,10,0.75,0.0625,10.5,61.5385,16,1
Zimbabwe,142,212.077,7.5,0.380282,227.704,6.97887,0.316901,230,RW Price,0,0,0,0,166,6,25,1,20,20,40,74,157,231,0,244,13,0,10,0.666667,0,7.16667,57.2062,36,3
Pakistan,211,222.621,7.38389,0.393365,235.517,7.54976,0.336493,230,Fawad Alam,8,4,4,13,202,3,26,0,4,6,10,106,132,238,245,245,7,1,10,1.85294,0.176471,26.5588,72.6468,34,4
Pakistan,211,222.621,7.38389,0.393365,235.517,7.54976,0.336493,230,Mohammad Yousuf,102,42,60,105,202,3,26,0,4,6,10,106,132,238,245,245,7,1,10,3.27586,0.275862,36.7931,73.9176,58,4
Zimbabwe,142,212.077,7.5,0.380282,227.704,6.97887,0.316901,231,KM Dabengwa,14,0,14,18,135,7,21,1,0,3,3,52,107,159,0,181,22,0,10,1.2,0,16.7,61.1722,20,1
Zimbabwe,142,212.077,7.5,0.380282,227.704,6.97887,0.316901,231,RW Price,6,4,2,12,135,7,21,1,0,3,3,52,107,159,0,181,22,0,10,0.666667,0,7.16667,57.2062,36,3
Sri Lanka,244,223.373,7.09016,0.344262,227.578,7.47541,0.385246,234,WPUJC Vaas,8,0,8,14,272,4,26,1,16,21,37,174,161,335,0,357,22,0,10,0.653846,0,8.65385,66.1765,26,1
Sri Lanka,244,223.373,7.09016,0.344262,227.578,7.47541,0.385246,234,TM Dilshan,18,0,18,18,272,4,26,1,16,21,37,174,161,335,0,357,22,0,10,4.60199,0.273632,38.3632,86.0219,201,4
Sri Lanka,244,223.373,7.09016,0.344262,227.578,7.47541,0.385246,234,KMDN Kulasekara,0,0,0,0,272,4,26,1,16,21,37,174,161,335,0,357,22,0,10,1.21,0.04,11.8,80.9328,100,1
Sri Lanka,244,223.373,7.09016,0.344262,227.578,7.47541,0.385246,234,BAW Mendis,0,0,0,0,272,4,26,1,16,21,37,174,161,335,0,357,22,0,10,0.447368,0,4.47368,66.4062,38,1
Sri Lanka,244,223.373,7.09016,0.344262,227.578,7.47541,0.385246,234,M Muralitharan,0,0,0,0,272,4,26,1,16,21,37,174,161,335,0,357,22,0,10,0.69697,0,5.63636,99.4652,33,0
Bangladesh,160,218.438,7.70625,0.4,211.106,7.05,0.325,234,Mashrafe Mortaza,21,0,21,39,160,6,15,1,14,17,31,64,142,206,358,226,20,0,10,1.27536,0,11.1594,76.9231,69,1
Bangladesh,160,218.438,7.70625,0.4,211.106,7.05,0.325,234,Abdur Razzak,4,0,4,11,160,6,15,1,14,17,31,64,142,206,358,226,20,0,10,0.849315,0.0136986,8.39726,73.8554,73,1
Pakistan,211,222.621,7.38389,0.393365,235.517,7.54976,0.336493,236,Misbah-ul-Haq,8,0,8,8,217,2,40,1,12,23,35,138,154,292,0,299,7,0,10,2.95238,0.285714,34.9921,71.8195,126,4
Pakistan,211,222.621,7.38389,0.393365,235.517,7.54976,0.336493,236,Mohammad Yousuf,30,20,10,20,217,2,40,1,12,23,35,138,154,292,0,299,7,0,10,3.27586,0.275862,36.7931,73.9176,58,4
Pakistan,211,222.621,7.38389,0.393365,235.517,7.54976,0.336493,236,Shahid Afridi,0,0,0,0,217,2,40,1,12,23,35,138,154,292,0,299,7,0,10,2.72917,0.0972222,21.4097,127.766,144,0
Pakistan,211,222.621,7.38389,0.393365,235.517,7.54976,0.336493,236,Sohail Tanvir,0,0,0,0,217,2,40,1,12,23,35,138,154,292,0,299,7,0,10,1.18919,0,9.08108,81.5534,37,1
Bangladesh,160,218.438,7.70625,0.4,211.106,7.05,0.325,237,Alok Kapali,83,50,33,77,178,5,50,0,20,21,41,144,125,269,0,283,14,0,10,2.38462,0.0769231,20.7692,76.2712,13,1
Bangladesh,160,218.438,7.70625,0.4,211.106,7.05,0.325,237,Mahmudullah,17,4,13,27,178,5,50,0,20,21,41,144,125,269,0,283,14,0,10,2.26531,0.153061,24.4286,70.9544,98,4
Sri Lanka,244,223.373,7.09016,0.344262,227.578,7.47541,0.385246,238,KC Sangakkara,103,42,61,106,206,3,29,1,22,22,44,128,151,279,0,302,23,0,10,4.33659,0.360976,41.9854,80.6276,205,4
Sri Lanka,244,223.373,7.09016,0.344262,227.578,7.47541,0.385246,238,T Thushara,6,0,6,8,206,3,29,1,22,22,44,128,151,279,0,302,23,0,10,1.7619,0.047619,16.4762,93.7669,21,0
Sri Lanka,244,223.373,7.09016,0.344262,227.578,7.47541,0.385246,238,TM Dilshan,0,0,0,0,206,3,29,1,22,22,44,128,151,279,0,302,23,0,10,4.60199,0.273632,38.3632,86.0219,201,4
Sri Lanka,244,223.373,7.09016,0.344262,227.578,7.47541,0.385246,238,WPUJC Vaas,0,0,0,0,206,3,29,1,22,22,44,128,151,279,0,302,23,0,10,0.653846,0,8.65385,66.1765,26,1
Sri Lanka,244,223.373,7.09016,0.344262,227.578,7.47541,0.385246,238,KMDN Kulasekara,0,0,0,0,206,3,29,1,22,22,44,128,151,279,0,302,23,0,10,1.21,0.04,11.8,80.9328,100,1
Pakistan,211,222.621,7.38389,0.393365,235.517,7.54976,0.336493,238,Sarfraz Ahmed,13,0,13,24,173,6,37,0,8,17,25,92,143,235,303,238,3,0,10,2.04878,0.097561,25.4878,83.9357,41,4
Pakistan,211,222.621,7.38389,0.393365,235.517,7.54976,0.336493,238,Misbah-ul-Haq,74,36,38,67,173,6,37,0,8,17,25,92,143,235,303,238,3,0,10,2.95238,0.285714,34.9921,71.8195,126,4
Pakistan,211,222.621,7.38389,0.393365,235.517,7.54976,0.336493,238,Sohail Tanvir,0,0,0,0,173,6,37,0,8,17,25,92,143,235,303,238,3,0,10,1.18919,0,9.08108,81.5534,37,1
Pakistan,211,222.621,7.38389,0.393365,235.517,7.54976,0.336493,238,Iftikhar Anjum,0,0,0,0,173,6,37,0,8,17,25,92,143,235,303,238,3,0,10,0.666667,0,7.33333,58.7786,21,3
Pakistan,211,222.621,7.38389,0.393365,235.517,7.54976,0.336493,238,Wahab Riaz,0,0,0,0,173,6,37,0,8,17,25,92,143,235,303,238,3,0,10,1.29167,0.0416667,10.9792,79.1291,48,1
Sri Lanka,244,223.373,7.09016,0.344262,227.578,7.47541,0.385246,239,T Thushara,1,0,1,2,253,4,30,2,14,25,39,192,130,322,0,332,10,0,10,1.7619,0.047619,16.4762,93.7669,21,0
Sri Lanka,244,223.373,7.09016,0.344262,227.578,7.47541,0.385246,239,WPUJC Vaas,3,0,3,10,253,4,30,2,14,25,39,192,130,322,0,332,10,0,10,0.653846,0,8.65385,66.1765,26,1
Sri Lanka,244,223.373,7.09016,0.344262,227.578,7.47541,0.385246,239,KMDN Kulasekara,0,0,0,0,253,4,30,2,14,25,39,192,130,322,0,332,10,0,10,1.21,0.04,11.8,80.9328,100,1
Sri Lanka,244,223.373,7.09016,0.344262,227.578,7.47541,0.385246,239,BAW Mendis,0,0,0,0,253,4,30,2,14,25,39,192,130,322,0,332,10,0,10,0.447368,0,4.47368,66.4062,38,1
India,259,242.378,7.15058,0.339768,244.568,7.12741,0.30888,240,MS Dhoni,66,16,50,88,223,4,26,2,16,30,46,122,173,295,0,308,13,0,10,3.47872,0.292553,36.7713,84.1612,188,4
India,259,242.378,7.15058,0.339768,244.568,7.12741,0.30888,240,IK Pathan,3,0,3,6,223,4,26,2,16,30,46,122,173,295,0,308,13,0,10,1.875,0.025,16.85,78.2811,40,1
India,259,242.378,7.15058,0.339768,244.568,7.12741,0.30888,240,P Kumar,0,0,0,0,223,4,26,2,16,30,46,122,173,295,0,308,13,0,10,1,0.03125,9.03125,86.0119,32,1
Pakistan,211,222.621,7.38389,0.393365,235.517,7.54976,0.336493,240,Younis Khan,122,50,72,116,263,3,35,0,4,1,5,152,151,303,309,309,6,0,10,2.64655,0.215517,28.5,73.2713,116,4
Pakistan,211,222.621,7.38389,0.393365,235.517,7.54976,0.336493,240,Misbah-ul-Haq,66,30,36,61,263,3,35,0,4,1,5,152,151,303,309,309,6,0,10,2.95238,0.285714,34.9921,71.8195,126,4
Sri Lanka,244,223.373,7.09016,0.344262,227.578,7.47541,0.385246,241,LPC Silva,49,14,35,56,224,4,23,1,26,20,46,138,155,293,0,308,15,0,10,2.55556,0.244444,26.0222,69.4543,45,4
Sri Lanka,244,223.373,7.09016,0.344262,227.578,7.47541,0.385246,241,T Thushara,0,0,0,0,224,4,23,1,26,20,46,138,155,293,0,308,15,0,10,1.7619,0.047619,16.4762,93.7669,21,0
Sri Lanka,244,223.373,7.09016,0.344262,227.578,7.47541,0.385246,241,K Weeraratne,8,4,4,9,224,4,23,1,26,20,46,138,155,293,0,308,15,0,10,1.5,0,19,97.4359,2,0
Sri Lanka,244,223.373,7.09016,0.344262,227.578,7.47541,0.385246,241,KMDN Kulasekara,0,0,0,0,224,4,23,1,26,20,46,138,155,293,0,308,15,0,10,1.21,0.04,11.8,80.9328,100,1
Sri Lanka,244,223.373,7.09016,0.344262,227.578,7.47541,0.385246,241,M Muralitharan,0,0,0,0,224,4,23,1,26,20,46,138,155,293,0,308,15,0,10,0.69697,0,5.63636,99.4652,33,0
India,259,242.378,7.15058,0.339768,244.568,7.12741,0.30888,241,RG Sharma,15,4,11,23,244,4,27,0,12,6,18,138,151,289,309,310,21,0,10,3.82836,0.268657,35.9179,83.083,134,4
India,259,242.378,7.15058,0.339768,244.568,7.12741,0.30888,241,Yuvraj Singh,25,10,15,26,244,4,27,0,12,6,18,138,151,289,309,310,21,0,10,4.05833,0.258333,32.525,83.8093,120,4
Sri Lanka,244,223.373,7.09016,0.344262,227.578,7.47541,0.385246,243,KMDN Kulasekara,7,0,7,15,209,6,18,1,20,17,37,114,150,264,0,273,9,0,10,1.21,0.04,11.8,80.9328,100,1
Sri Lanka,244,223.373,7.09016,0.344262,227.578,7.47541,0.385246,243,T Thushara,0,0,0,1,209,6,18,1,20,17,37,114,150,264,0,273,9,0,10,1.7619,0.047619,16.4762,93.7669,21,0
Sri Lanka,244,223.373,7.09016,0.344262,227.578,7.47541,0.385246,243,BAW Mendis,0,0,0,0,209,6,18,1,20,17,37,114,150,264,0,273,9,0,10,0.447368,0,4.47368,66.4062,38,1
Sri Lanka,244,223.373,7.09016,0.344262,227.578,7.47541,0.385246,243,M Muralitharan,0,0,0,0,209,6,18,1,20,17,37,114,150,264,0,273,9,0,10,0.69697,0,5.63636,99.4652,33,0
Australia,228,239.627,7.69737,0.372807,232.079,7.23246,0.337719,245,CL White,2,0,2,9,123,4,22,1,20,23,43,52,136,188,0,198,10,1,10,2.66176,0.191176,28.8235,80.1308,68,4
Australia,228,239.627,7.69737,0.372807,232.079,7.23246,0.337719,245,MEK Hussey,34,4,30,57,123,4,22,1,20,23,43,52,136,188,0,198,10,1,10,2.7563,0.260504,34.084,82.4893,119,4
India,259,242.378,7.15058,0.339768,244.568,7.12741,0.30888,246,PP Ojha,14,4,10,28,110,8,24,1,0,5,5,50,89,139,0,146,7,0,10,0.333333,0,5.11111,40.3509,9,3
India,259,242.378,7.15058,0.339768,244.568,7.12741,0.30888,246,MM Patel,12,10,2,10,110,8,24,1,0,5,5,50,89,139,0,146,7,0,10,0.363636,0,3.22727,66.9811,22,1
India,259,242.378,7.15058,0.339768,244.568,7.12741,0.30888,248,RG Sharma,27,8,19,29,153,5,39,0,12,13,25,88,129,217,0,237,20,0,10,3.82836,0.268657,35.9179,83.083,134,4
India,259,242.378,7.15058,0.339768,244.568,7.12741,0.30888,248,MS Dhoni,61,24,37,68,153,5,39,0,12,13,25,88,129,217,0,237,20,0,10,3.47872,0.292553,36.7713,84.1612,188,4
India,259,242.378,7.15058,0.339768,244.568,7.12741,0.30888,248,Harbhajan Singh,0,0,0,0,153,5,39,0,12,13,25,88,129,217,0,237,20,0,10,0.901639,0,9.98361,76.4115,61,1
India,259,242.378,7.15058,0.339768,244.568,7.12741,0.30888,248,Z Khan,0,0,0,0,153,5,39,0,12,13,25,88,129,217,0,237,20,0,10,0.974359,0,8.35897,60.9346,39,1
India,259,242.378,7.15058,0.339768,244.568,7.12741,0.30888,248,P Kumar,0,0,0,0,153,5,39,0,12,13,25,88,129,217,0,237,20,0,10,1,0.03125,9.03125,86.0119,32,1
Sri Lanka,244,223.373,7.09016,0.344262,227.578,7.47541,0.385246,248,DPMD Jayawardene,86,22,64,109,149,7,29,1,8,12,20,80,118,198,238,204,6,1,10,3.20833,0.244792,31.6979,79.1109,192,4
Sri Lanka,244,223.373,7.09016,0.344262,227.578,7.47541,0.385246,248,BAW Mendis,0,0,0,4,149,7,29,1,8,12,20,80,118,198,238,204,6,1,10,0.447368,0,4.47368,66.4062,38,1
Sri Lanka,244,223.373,7.09016,0.344262,227.578,7.47541,0.385246,248,M Muralitharan,0,0,0,0,149,7,29,1,8,12,20,80,118,198,238,204,6,1,10,0.69697,0,5.63636,99.4652,33,0
Sri Lanka,244,223.373,7.09016,0.344262,227.578,7.47541,0.385246,249,J Mubarak,30,8,22,39,134,6,46,0,12,22,34,80,134,214,0,227,13,1,10,1.21429,0.0714286,19.6429,69.797,14,1
Sri Lanka,244,223.373,7.09016,0.344262,227.578,7.47541,0.385246,249,T Thushara,37,16,21,34,134,6,46,0,12,22,34,80,134,214,0,227,13,1,10,1.7619,0.047619,16.4762,93.7669,21,0
Pakistan,211,222.621,7.38389,0.393365,235.517,7.54976,0.336493,250,Mohammad Yousuf,93,40,53,90,216,4,47,0,24,25,49,140,172,312,0,322,10,1,10,3.27586,0.275862,36.7931,73.9176,58,4
Pakistan,211,222.621,7.38389,0.393365,235.517,7.54976,0.336493,250,Misbah-ul-Haq,31,16,15,22,216,4,47,0,24,25,49,140,172,312,0,322,10,1,10,2.95238,0.285714,34.9921,71.8195,126,4
Pakistan,211,222.621,7.38389,0.393365,235.517,7.54976,0.336493,250,Shahid Afridi,0,0,0,0,216,4,47,0,24,25,49,140,172,312,0,322,10,1,10,2.72917,0.0972222,21.4097,127.766,144,0
Bangladesh,160,218.438,7.70625,0.4,211.106,7.05,0.325,251,Mahmudullah,41,12,29,67,161,6,20,0,12,11,23,106,98,204,0,225,21,0,10,2.26531,0.153061,24.4286,70.9544,98,4
Bangladesh,160,218.438,7.70625,0.4,211.106,7.05,0.325,251,Dhiman Ghosh,23,4,19,40,161,6,20,0,12,11,23,106,98,204,0,225,21,0,10,0.909091,0,11.2727,60.4878,11,1
Bangladesh,160,218.438,7.70625,0.4,211.106,7.05,0.325,251,Mashrafe Mortaza,0,0,0,0,161,6,20,0,12,11,23,106,98,204,0,225,21,0,10,1.27536,0,11.1594,76.9231,69,1
Bangladesh,160,218.438,7.70625,0.4,211.106,7.05,0.325,251,Abdur Razzak,0,0,0,0,161,6,20,0,12,11,23,106,98,204,0,225,21,0,10,0.849315,0.0136986,8.39726,73.8554,73,1
Pakistan,211,222.621,7.38389,0.393365,235.517,7.54976,0.336493,252,Salman Butt,120,56,64,118,233,4,38,1,12,17,29,146,154,300,0,308,8,1,10,5.4359,0.384615,42.3846,78.8645,39,4
Pakistan,211,222.621,7.38389,0.393365,235.517,7.54976,0.336493,252,Misbah-ul-Haq,1,0,1,1,233,4,38,1,12,17,29,146,154,300,0,308,8,1,10,2.95238,0.285714,34.9921,71.8195,126,4
Pakistan,211,222.621,7.38389,0.393365,235.517,7.54976,0.336493,252,Sohail Tanvir,0,0,0,0,233,4,38,1,12,17,29,146,154,300,0,308,8,1,10,1.18919,0,9.08108,81.5534,37,1
Pakistan,211,222.621,7.38389,0.393365,235.517,7.54976,0.336493,252,Fawad Alam,0,0,0,0,233,4,38,1,12,17,29,146,154,300,0,308,8,1,10,1.85294,0.176471,26.5588,72.6468,34,4
Pakistan,211,222.621,7.38389,0.393365,235.517,7.54976,0.336493,252,Iftikhar Anjum,0,0,0,0,233,4,38,1,12,17,29,146,154,300,0,308,8,1,10,0.666667,0,7.33333,58.7786,21,3
Bangladesh,160,218.438,7.70625,0.4,211.106,7.05,0.325,252,Farhad Reza,13,4,9,10,191,4,38,1,16,21,37,100,166,266,309,285,19,0,10,1,0,10.2727,54.3269,22,3
Bangladesh,160,218.438,7.70625,0.4,211.106,7.05,0.325,252,Mashrafe Mortaza,0,0,0,0,191,4,38,1,16,21,37,100,166,266,309,285,19,0,10,1.27536,0,11.1594,76.9231,69,1
Bangladesh,160,218.438,7.70625,0.4,211.106,7.05,0.325,252,Shakib Al Hasan,71,24,47,70,191,4,38,1,16,21,37,100,166,266,309,285,19,0,10,2.86992,0.252033,29.9106,79.0163,123,4
Bangladesh,160,218.438,7.70625,0.4,211.106,7.05,0.325,252,Dhiman Ghosh,0,0,0,0,191,4,38,1,16,21,37,100,166,266,309,285,19,0,10,0.909091,0,11.2727,60.4878,11,1
Pakistan,211,222.621,7.38389,0.393365,235.517,7.54976,0.336493,253,Misbah-ul-Haq,10,4,6,7,241,3,31,2,20,25,45,130,187,317,0,329,12,0,10,2.95238,0.285714,34.9921,71.8195,126,4
Pakistan,211,222.621,7.38389,0.393365,235.517,7.54976,0.336493,253,Shoaib Malik,21,4,17,23,241,3,31,2,20,25,45,130,187,317,0,329,12,0,10,2.77551,0.193878,28.7041,81.4418,98,4
Pakistan,211,222.621,7.38389,0.393365,235.517,7.54976,0.336493,253,Naumanullah,0,0,0,0,241,3,31,2,20,25,45,130,187,317,0,329,12,0,10,1,0,4,100,1,0
Pakistan,211,222.621,7.38389,0.393365,235.517,7.54976,0.336493,253,Wahab Riaz,0,0,0,0,241,3,31,2,20,25,45,130,187,317,0,329,12,0,10,1.29167,0.0416667,10.9792,79.1291,48,1
Pakistan,211,222.621,7.38389,0.393365,235.517,7.54976,0.336493,253,Umar Gul,0,0,0,0,241,3,31,2,20,25,45,130,187,317,0,329,12,0,10,0.77193,0,7.14035,68.2886,57,1
India,259,242.378,7.15058,0.339768,244.568,7.12741,0.30888,255,SK Raina,7,0,7,16,224,4,29,2,16,23,39,148,144,292,0,330,38,0,10,3.11111,0.216374,28.9064,91.8944,171,0
India,259,242.378,7.15058,0.339768,244.568,7.12741,0.30888,255,IK Pathan,4,0,4,5,224,4,29,2,16,23,39,148,144,292,0,330,38,0,10,1.875,0.025,16.85,78.2811,40,1
India,259,242.378,7.15058,0.339768,244.568,7.12741,0.30888,255,P Kumar,0,0,0,0,224,4,29,2,16,23,39,148,144,292,0,330,38,0,10,1,0.03125,9.03125,86.0119,32,1
India,259,242.378,7.15058,0.339768,244.568,7.12741,0.30888,255,PP Chawla,0,0,0,0,224,4,29,2,16,23,39,148,144,292,0,330,38,0,10,0.25,0,3.16667,63.3333,12,1
Bangladesh,160,218.438,7.70625,0.4,211.106,7.05,0.325,256,Mahmudullah,20,8,12,23,153,5,28,1,10,19,29,58,152,210,0,222,12,1,10,2.26531,0.153061,24.4286,70.9544,98,4
Bangladesh,160,218.438,7.70625,0.4,211.106,7.05,0.325,256,Farhad Reza,1,0,1,3,153,5,28,1,10,19,29,58,152,210,0,222,12,1,10,1,0,10.2727,54.3269,22,3
Bangladesh,160,218.438,7.70625,0.4,211.106,7.05,0.325,256,Mashrafe Mortaza,0,0,0,0,153,5,28,1,10,19,29,58,152,210,0,222,12,1,10,1.27536,0,11.1594,76.9231,69,1
Bangladesh,160,218.438,7.70625,0.4,211.106,7.05,0.325,256,Abdur Razzak,0,0,0,0,153,5,28,1,10,19,29,58,152,210,0,222,12,1,10,0.849315,0.0136986,8.39726,73.8554,73,1
Bangladesh,160,218.438,7.70625,0.4,211.106,7.05,0.325,256,Dolar Mahmud,0,0,0,0,153,5,28,1,10,19,29,58,152,210,0,222,12,1,10,2.33333,0,13.6667,117.143,3,0
Pakistan,211,222.621,7.38389,0.393365,235.517,7.54976,0.336493,257,Misbah-ul-Haq,21,14,7,12,221,1,50,1,16,19,35,158,148,306,0,315,9,0,10,2.95238,0.285714,34.9921,71.8195,126,4
Pakistan,211,222.621,7.38389,0.393365,235.517,7.54976,0.336493,257,Salman Butt,127,66,61,136,221,1,50,1,16,19,35,158,148,306,0,315,9,0,10,5.4359,0.384615,42.3846,78.8645,39,4
Pakistan,211,222.621,7.38389,0.393365,235.517,7.54976,0.336493,257,Shahid Afridi,0,0,0,0,221,1,50,1,16,19,35,158,148,306,0,315,9,0,10,2.72917,0.0972222,21.4097,127.766,144,0
Pakistan,211,222.621,7.38389,0.393365,235.517,7.54976,0.336493,257,Shoaib Malik,0,0,0,0,221,1,50,1,16,19,35,158,148,306,0,315,9,0,10,2.77551,0.193878,28.7041,81.4418,98,4
India,259,242.378,7.15058,0.339768,244.568,7.12741,0.30888,257,P Kumar,4,0,4,5,217,6,25,1,16,12,28,126,144,270,316,290,20,0,10,1,0.03125,9.03125,86.0119,32,1
India,259,242.378,7.15058,0.339768,244.568,7.12741,0.30888,257,MS Dhoni,39,8,31,49,217,6,25,1,16,12,28,126,144,270,316,290,20,0,10,3.47872,0.292553,36.7713,84.1612,188,4
India,259,242.378,7.15058,0.339768,244.568,7.12741,0.30888,257,PP Chawla,0,0,0,0,217,6,25,1,16,12,28,126,144,270,316,290,20,0,10,0.25,0,3.16667,63.3333,12,1
India,259,242.378,7.15058,0.339768,244.568,7.12741,0.30888,257,I Sharma,0,0,0,0,217,6,25,1,16,12,28,126,144,270,316,290,20,0,10,0.24,0,2.84,34.1346,25,3
Australia,228,239.627,7.69737,0.372807,232.079,7.23246,0.337719,258,CJ Ferguson,53,8,45,64,173,3,31,1,24,25,49,100,153,253,0,260,7,0,10,2.47826,0.173913,26.3478,80.4781,23,4
Australia,228,239.627,7.69737,0.372807,232.079,7.23246,0.337719,258,MEK Hussey,7,4,3,7,173,3,31,1,24,25,49,100,153,253,0,260,7,0,10,2.7563,0.260504,34.084,82.4893,119,4
Australia,228,239.627,7.69737,0.372807,232.079,7.23246,0.337719,258,JR Hopes,0,0,0,0,173,3,31,1,24,25,49,100,153,253,0,260,7,0,10,2.09259,0.0555556,21.2778,91.4809,54,0
England,221,237.176,7.17647,0.289593,230.633,7.45701,0.384615,258,LJ Wright,32,18,14,22,156,5,40,1,24,20,44,94,146,240,261,256,16,1,10,1.92105,0.0263158,17.2368,81.875,38,1
England,221,237.176,7.17647,0.289593,230.633,7.45701,0.384615,258,AU Rashid,10,4,6,9,156,5,40,1,24,20,44,94,146,240,261,256,16,1,10,2.41176,0.0588235,17.2941,108.889,17,0
England,221,237.176,7.17647,0.289593,230.633,7.45701,0.384615,258,GP Swann,0,0,0,0,156,5,40,1,24,20,44,94,146,240,261,256,16,1,10,1.08696,0,10.3043,90.631,46,0
England,221,237.176,7.17647,0.289593,230.633,7.45701,0.384615,258,RJ Sidebottom,0,0,0,0,156,5,40,1,24,20,44,94,146,240,261,256,16,1,10,0.6875,0,7.6875,65.7754,16,1
Australia,228,239.627,7.69737,0.372807,232.079,7.23246,0.337719,259,MG Johnson,12,4,8,7,162,5,30,2,16,25,41,88,145,233,0,249,16,0,10,1.18519,0.0246914,10.7901,94.181,81,0
Australia,228,239.627,7.69737,0.372807,232.079,7.23246,0.337719,259,B Lee,0,0,0,2,162,5,30,2,16,25,41,88,145,233,0,249,16,0,10,1.09091,0.0227273,10.8182,81.5068,44,1
Australia,228,239.627,7.69737,0.372807,232.079,7.23246,0.337719,259,NM Hauritz,0,0,0,0,162,5,30,2,16,25,41,88,145,233,0,249,16,0,10,1.04,0.04,11.64,93.5691,25,0
England,221,237.176,7.17647,0.289593,230.633,7.45701,0.384615,259,PD Collingwood,53,12,41,81,175,7,18,2,0,3,3,76,120,196,250,210,14,1,10,2.62366,0.193548,30.5161,76.8065,93,4
England,221,237.176,7.17647,0.289593,230.633,7.45701,0.384615,259,JM Anderson,0,0,0,3,175,7,18,2,0,3,3,76,120,196,250,210,14,1,10,0.365385,0,3.92308,52.7132,52,3
England,221,237.176,7.17647,0.289593,230.633,7.45701,0.384615,260,RJ Sidebottom,2,0,2,9,166,6,17,2,16,20,36,72,147,219,0,228,9,1,10,0.6875,0,7.6875,65.7754,16,1
England,221,237.176,7.17647,0.289593,230.633,7.45701,0.384615,260,TT Bresnan,17,4,13,26,166,6,17,2,16,20,36,72,147,219,0,228,9,1,10,1.52381,0.015873,13.8095,88.4146,63,0
Australia,228,239.627,7.69737,0.372807,232.079,7.23246,0.337719,260,CJ Ferguson,8,4,4,6,156,2,42,1,16,7,23,82,139,221,229,230,9,0,10,2.47826,0.173913,26.3478,80.4781,23,4
Australia,228,239.627,7.69737,0.372807,232.079,7.23246,0.337719,260,CL White,102,42,60,119,156,2,42,1,16,7,23,82,139,221,229,230,9,0,10,2.66176,0.191176,28.8235,80.1308,68,4
Australia,228,239.627,7.69737,0.372807,232.079,7.23246,0.337719,260,MEK Hussey,0,0,0,0,156,2,42,1,16,7,23,82,139,221,229,230,9,0,10,2.7563,0.260504,34.084,82.4893,119,4
England,221,237.176,7.17647,0.289593,230.633,7.45701,0.384615,261,TT Bresnan,5,0,5,5,169,5,35,3,4,4,8,92,120,212,0,220,8,1,10,1.52381,0.015873,13.8095,88.4146,63,0
England,221,237.176,7.17647,0.289593,230.633,7.45701,0.384615,261,AU Rashid,4,4,0,3,169,5,35,3,4,4,8,92,120,212,0,220,8,1,10,2.41176,0.0588235,17.2941,108.889,17,0
England,221,237.176,7.17647,0.289593,230.633,7.45701,0.384615,261,RJ Sidebottom,0,0,0,0,169,5,35,3,4,4,8,92,120,212,0,220,8,1,10,0.6875,0,7.6875,65.7754,16,1
Australia,228,239.627,7.69737,0.372807,232.079,7.23246,0.337719,262,CL White,17,12,5,13,188,3,35,2,34,17,51,152,122,274,0,296,22,0,10,2.66176,0.191176,28.8235,80.1308,68,4
Australia,228,239.627,7.69737,0.372807,232.079,7.23246,0.337719,262,JR Hopes,14,12,2,8,188,3,35,2,34,17,51,152,122,274,0,296,22,0,10,2.09259,0.0555556,21.2778,91.4809,54,0
Australia,228,239.627,7.69737,0.372807,232.079,7.23246,0.337719,262,B Lee,0,0,0,0,188,3,35,2,34,17,51,152,122,274,0,296,22,0,10,1.09091,0.0227273,10.8182,81.5068,44,1
Australia,228,239.627,7.69737,0.372807,232.079,7.23246,0.337719,262,NM Hauritz,0,0,0,0,188,3,35,2,34,17,51,152,122,274,0,296,22,0,10,1.04,0.04,11.64,93.5691,25,0
Australia,228,239.627,7.69737,0.372807,232.079,7.23246,0.337719,262,PM Siddle,0,0,0,0,188,3,35,2,34,17,51,152,122,274,0,296,22,0,10,0.25,0,4.25,94.4444,4,0
Australia,228,239.627,7.69737,0.372807,232.079,7.23246,0.337719,263,BW Hilfenhaus,1,0,1,8,145,6,25,3,0,1,1,70,101,171,0,176,5,0,10,0.222222,0,3.22222,40.8451,9,3
Australia,228,239.627,7.69737,0.372807,232.079,7.23246,0.337719,263,MEK Hussey,49,18,31,53,145,6,25,3,0,1,1,70,101,171,0,176,5,0,10,2.7563,0.260504,34.084,82.4893,119,4
South Africa,190,234.274,7.4,0.373684,232.363,7.33158,0.342105,264,J Botha,6,4,2,9,188,5,22,1,56,8,64,140,134,274,0,283,9,1,10,1.09756,0,11.561,82.2917,41,1
South Africa,190,234.274,7.4,0.373684,232.363,7.33158,0.342105,264,JA Morkel,13,0,13,27,188,5,22,1,56,8,64,140,134,274,0,283,9,1,10,2.42424,0.0606061,19.9697,99.5468,33,0
South Africa,190,234.274,7.4,0.373684,232.363,7.33158,0.342105,264,J Louw,0,0,0,0,188,5,22,1,56,8,64,140,134,274,0,283,9,1,10,4,0,17,242.857,1,2
South Africa,190,234.274,7.4,0.373684,232.363,7.33158,0.342105,264,M Morkel,0,0,0,0,188,5,22,1,56,8,64,140,134,274,0,283,9,1,10,0.6,0,5.28571,72.2656,35,1
Australia,228,239.627,7.69737,0.372807,232.079,7.23246,0.337719,265,JR Hopes,37,20,17,33,188,5,36,0,36,16,52,134,142,276,0,286,10,0,10,2.09259,0.0555556,21.2778,91.4809,54,0
Australia,228,239.627,7.69737,0.372807,232.079,7.23246,0.337719,265,MEK Hussey,53,12,41,66,188,5,36,0,36,16,52,134,142,276,0,286,10,0,10,2.7563,0.260504,34.084,82.4893,119,4
Australia,228,239.627,7.69737,0.372807,232.079,7.23246,0.337719,265,MG Johnson,0,0,0,0,188,5,36,0,36,16,52,134,142,276,0,286,10,0,10,1.18519,0.0246914,10.7901,94.181,81,0
Australia,228,239.627,7.69737,0.372807,232.079,7.23246,0.337719,265,NM Hauritz,0,0,0,0,188,5,36,0,36,16,52,134,142,276,0,286,10,0,10,1.04,0.04,11.64,93.5691,25,0
South Africa,190,234.274,7.4,0.373684,232.363,7.33158,0.342105,267,MV Boucher,2,0,2,3,191,3,33,2,36,19,55,114,165,279,0,289,10,1,10,2.21053,0.0877193,22.2281,89.3512,57,0
South Africa,190,234.274,7.4,0.373684,232.363,7.33158,0.342105,267,JA Morkel,6,0,6,12,191,3,33,2,36,19,55,114,165,279,0,289,10,1,10,2.42424,0.0606061,19.9697,99.5468,33,0
South Africa,190,234.274,7.4,0.373684,232.363,7.33158,0.342105,267,RE van der Merwe,0,0,0,0,191,3,33,2,36,19,55,114,165,279,0,289,10,1,10,0.714286,0,5.57143,95.122,7,0
Australia,228,239.627,7.69737,0.372807,232.079,7.23246,0.337719,267,MG Johnson,0,0,0,0,160,5,39,1,18,19,37,74,162,236,290,264,28,0,10,1.18519,0.0246914,10.7901,94.181,81,0
Australia,228,239.627,7.69737,0.372807,232.079,7.23246,0.337719,267,JR Hopes,45,12,33,47,160,5,39,1,18,19,37,74,162,236,290,264,28,0,10,2.09259,0.0555556,21.2778,91.4809,54,0
Australia,228,239.627,7.69737,0.372807,232.079,7.23246,0.337719,267,B Geeves,0,0,0,0,160,5,39,1,18,19,37,74,162,236,290,264,28,0,10,1,0,10,90.9091,1,0
South Africa,190,234.274,7.4,0.373684,232.363,7.33158,0.342105,268,JP Duminy,7,0,7,5,221,3,30,2,30,23,53,142,162,304,0,317,13,1,10,2.3252,0.186992,29.9675,80.2351,123,4
South Africa,190,234.274,7.4,0.373684,232.363,7.33158,0.342105,268,MV Boucher,9,4,5,17,221,3,30,2,30,23,53,142,162,304,0,317,13,1,10,2.21053,0.0877193,22.2281,89.3512,57,0
Australia,228,239.627,7.69737,0.372807,232.079,7.23246,0.337719,268,NM Hauritz,3,0,3,4,200,5,45,3,0,0,0,104,141,245,318,256,11,0,10,1.04,0.04,11.64,93.5691,25,0
Australia,228,239.627,7.69737,0.372807,232.079,7.23246,0.337719,269,MEK Hussey,27,4,23,41,235,6,14,1,26,15,41,138,152,290,0,303,13,0,10,2.7563,0.260504,34.084,82.4893,119,4
Australia,228,239.627,7.69737,0.372807,232.079,7.23246,0.337719,269,NM Hauritz,5,0,5,15,235,6,14,1,26,15,41,138,152,290,0,303,13,0,10,1.04,0.04,11.64,93.5691,25,0
South Africa,190,234.274,7.4,0.373684,232.363,7.33158,0.342105,269,M Ntini,2,0,2,3,211,5,30,4,6,1,7,114,134,248,304,256,8,1,10,0.375,0,3.25,63.4146,16,1
South Africa,190,234.274,7.4,0.373684,232.363,7.33158,0.342105,269,M Morkel,15,8,7,12,211,5,30,4,6,1,7,114,134,248,304,256,8,1,10,0.6,0,5.28571,72.2656,35,1
Australia,228,239.627,7.69737,0.372807,232.079,7.23246,0.337719,270,DJ Hussey,46,16,30,47,177,4,40,1,16,24,40,90,167,257,0,271,14,1,10,2.54386,0.245614,29.2105,87.8628,57,4
Australia,228,239.627,7.69737,0.372807,232.079,7.23246,0.337719,270,BJ Haddin,0,0,0,0,177,4,40,1,16,24,40,90,167,257,0,271,14,1,10,3.14737,0.147368,26.7789,81.382,95,4
Australia,228,239.627,7.69737,0.372807,232.079,7.23246,0.337719,270,JR Hopes,0,0,0,0,177,4,40,1,16,24,40,90,167,257,0,271,14,1,10,2.09259,0.0555556,21.2778,91.4809,54,0
Australia,228,239.627,7.69737,0.372807,232.079,7.23246,0.337719,270,NW Bracken,0,0,0,0,177,4,40,1,16,24,40,90,167,257,0,271,14,1,10,0.391304,0,4.91304,62.4309,23,1
Australia,228,239.627,7.69737,0.372807,232.079,7.23246,0.337719,270,BW Hilfenhaus,0,0,0,0,177,4,40,1,16,24,40,90,167,257,0,271,14,1,10,0.222222,0,3.22222,40.8451,9,3
South Africa,190,234.274,7.4,0.373684,232.363,7.33158,0.342105,270,JA Morkel,3,0,3,4,188,3,17,4,26,23,49,78,176,254,272,272,18,0,10,2.42424,0.0606061,19.9697,99.5468,33,0
South Africa,190,234.274,7.4,0.373684,232.363,7.33158,0.342105,270,J Botha,0,0,0,5,188,3,17,4,26,23,49,78,176,254,272,272,18,0,10,1.09756,0,11.561,82.2917,41,1
Australia,228,239.627,7.69737,0.372807,232.079,7.23246,0.337719,271,DJ Hussey,36,8,28,44,197,5,25,0,12,17,29,96,155,251,0,269,18,1,10,2.54386,0.245614,29.2105,87.8628,57,4
Australia,228,239.627,7.69737,0.372807,232.079,7.23246,0.337719,271,MG Johnson,0,0,0,0,197,5,25,0,12,17,29,96,155,251,0,269,18,1,10,1.18519,0.0246914,10.7901,94.181,81,0
Australia,228,239.627,7.69737,0.372807,232.079,7.23246,0.337719,271,JR Hopes,27,8,19,47,197,5,25,0,12,17,29,96,155,251,0,269,18,1,10,2.09259,0.0555556,21.2778,91.4809,54,0
Australia,228,239.627,7.69737,0.372807,232.079,7.23246,0.337719,271,NM Hauritz,0,0,0,0,197,5,25,0,12,17,29,96,155,251,0,269,18,1,10,1.04,0.04,11.64,93.5691,25,0
Australia,228,239.627,7.69737,0.372807,232.079,7.23246,0.337719,271,NW Bracken,0,0,0,0,197,5,25,0,12,17,29,96,155,251,0,269,18,1,10,0.391304,0,4.91304,62.4309,23,1
Australia,228,239.627,7.69737,0.372807,232.079,7.23246,0.337719,271,SW Tait,0,0,0,0,197,5,25,0,12,17,29,96,155,251,0,269,18,1,10,0.666667,0,4.16667,86.2069,6,1
South Africa,190,234.274,7.4,0.373684,232.363,7.33158,0.342105,271,MV Boucher,30,4,26,44,194,6,40,0,18,1,19,124,129,253,270,270,17,0,10,2.21053,0.0877193,22.2281,89.3512,57,0
South Africa,190,234.274,7.4,0.373684,232.363,7.33158,0.342105,271,JA Morkel,26,16,10,17,194,6,40,0,18,1,19,124,129,253,270,270,17,0,10,2.42424,0.0606061,19.9697,99.5468,33,0
South Africa,190,234.274,7.4,0.373684,232.363,7.33158,0.342105,271,J Botha,0,0,0,0,194,6,40,0,18,1,19,124,129,253,270,270,17,0,10,1.09756,0,11.561,82.2917,41,1
Australia,228,239.627,7.69737,0.372807,232.079,7.23246,0.337719,272,JR Hopes,36,10,26,39,180,6,20,2,4,9,13,98,115,213,0,222,9,1,10,2.09259,0.0555556,21.2778,91.4809,54,0
Australia,228,239.627,7.69737,0.372807,232.079,7.23246,0.337719,272,BW Hilfenhaus,2,0,2,10,180,6,20,2,4,9,13,98,115,213,0,222,9,1,10,0.222222,0,3.22222,40.8451,9,3
Australia,228,239.627,7.69737,0.372807,232.079,7.23246,0.337719,272,SW Tait,0,0,0,0,180,6,20,2,4,9,13,98,115,213,0,222,9,1,10,0.666667,0,4.16667,86.2069,6,1
South Africa,190,234.274,7.4,0.373684,232.363,7.33158,0.342105,273,JP Duminy,31,18,13,25,182,3,40,2,20,25,45,96,171,267,0,288,21,0,10,2.3252,0.186992,29.9675,80.2351,123,4
South Africa,190,234.274,7.4,0.373684,232.363,7.33158,0.342105,273,J Botha,0,0,0,0,182,3,40,2,20,25,45,96,171,267,0,288,21,0,10,1.09756,0,11.561,82.2917,41,1
Australia,228,239.627,7.69737,0.372807,232.079,7.23246,0.337719,273,MG Johnson,2,0,2,4,178,6,37,1,4,15,19,78,156,234,289,249,15,1,10,1.18519,0.0246914,10.7901,94.181,81,0
Australia,228,239.627,7.69737,0.372807,232.079,7.23246,0.337719,273,BJ Haddin,53,22,31,44,178,6,37,1,4,15,19,78,156,234,289,249,15,1,10,3.14737,0.147368,26.7789,81.382,95,4
Australia,228,239.627,7.69737,0.372807,232.079,7.23246,0.337719,273,NW Bracken,0,0,0,0,178,6,37,1,4,15,19,78,156,234,289,249,15,1,10,0.391304,0,4.91304,62.4309,23,1
Australia,228,239.627,7.69737,0.372807,232.079,7.23246,0.337719,273,BW Hilfenhaus,0,0,0,0,178,6,37,1,4,15,19,78,156,234,289,249,15,1,10,0.222222,0,3.22222,40.8451,9,3
Australia,228,239.627,7.69737,0.372807,232.079,7.23246,0.337719,274,MG Johnson,2,0,2,2,136,6,16,3,20,7,27,60,119,179,0,181,2,1,10,1.18519,0.0246914,10.7901,94.181,81,0
Australia,228,239.627,7.69737,0.372807,232.079,7.23246,0.337719,274,SW Tait,0,0,0,3,136,6,16,3,20,7,27,60,119,179,0,181,2,1,10,0.666667,0,4.16667,86.2069,6,1
New Zealand,184,233.745,7.39674,0.36413,227.951,7.30435,0.353261,274,KD Mills,25,12,13,32,106,5,33,0,4,16,20,64,95,159,182,182,23,0,10,1.52542,0.0338983,12.8644,90.7895,59,0
New Zealand,184,233.745,7.39674,0.36413,227.951,7.30435,0.353261,274,LRPL Taylor,57,26,31,88,106,5,33,0,4,16,20,64,95,159,182,182,23,0,10,3.68382,0.301471,36.7206,79.3959,136,4
New Zealand,184,233.745,7.39674,0.36413,227.951,7.30435,0.353261,274,DL Vettori,0,0,0,0,106,5,33,0,4,16,20,64,95,159,182,182,23,0,10,1.43662,0.028169,15.7606,86.0108,71,0
New Zealand,184,233.745,7.39674,0.36413,227.951,7.30435,0.353261,274,TG Southee,0,0,0,0,106,5,33,0,4,16,20,64,95,159,182,182,23,0,10,0.764706,0,7.03922,92.7649,51,0
New Zealand,184,233.745,7.39674,0.36413,227.951,7.30435,0.353261,274,JS Patel,0,0,0,0,106,5,33,0,4,16,20,64,95,159,182,182,23,0,10,0.7,0,8.4,60,10,3
Australia,228,239.627,7.69737,0.372807,232.079,7.23246,0.337719,275,MEK Hussey,72,16,56,91,159,3,29,0,0,32,32,52,168,220,0,225,5,1,10,2.7563,0.260504,34.084,82.4893,119,4
Australia,228,239.627,7.69737,0.372807,232.079,7.23246,0.337719,275,MJ Clarke,92,28,64,126,159,3,29,0,0,32,32,52,168,220,0,225,5,1,10,3.10294,0.301471,35.9265,74.0303,136,4
Australia,228,239.627,7.69737,0.372807,232.079,7.23246,0.337719,275,CL White,0,0,0,0,159,3,29,0,0,32,32,52,168,220,0,225,5,1,10,2.66176,0.191176,28.8235,80.1308,68,4
Australia,228,239.627,7.69737,0.372807,232.079,7.23246,0.337719,275,CJ Ferguson,0,0,0,0,159,3,29,0,0,32,32,52,168,220,0,225,5,1,10,2.47826,0.173913,26.3478,80.4781,23,4
New Zealand,184,233.745,7.39674,0.36413,227.951,7.30435,0.353261,275,NT Broom,10,8,2,10,150,3,28,1,12,16,28,80,126,206,226,226,20,0,10,1.42105,0.0526316,16.2632,65.7447,19,1
New Zealand,184,233.745,7.39674,0.36413,227.951,7.30435,0.353261,275,GD Elliott,49,20,29,64,150,3,28,1,12,16,28,80,126,206,226,226,20,0,10,2.67188,0.203125,29.4375,79.7629,64,4
Australia,228,239.627,7.69737,0.372807,232.079,7.23246,0.337719,276,MEK Hussey,33,16,17,20,221,5,44,0,8,24,32,132,165,297,0,301,4,1,10,2.7563,0.260504,34.084,82.4893,119,4
Australia,228,239.627,7.69737,0.372807,232.079,7.23246,0.337719,276,CJ Ferguson,26,16,10,21,221,5,44,0,8,24,32,132,165,297,0,301,4,1,10,2.47826,0.173913,26.3478,80.4781,23,4
Australia,228,239.627,7.69737,0.372807,232.079,7.23246,0.337719,276,JR Hopes,0,0,0,0,221,5,44,0,8,24,32,132,165,297,0,301,4,1,10,2.09259,0.0555556,21.2778,91.4809,54,0
Australia,228,239.627,7.69737,0.372807,232.079,7.23246,0.337719,276,MG Johnson,0,0,0,0,221,5,44,0,8,24,32,132,165,297,0,301,4,1,10,1.18519,0.0246914,10.7901,94.181,81,0
Australia,228,239.627,7.69737,0.372807,232.079,7.23246,0.337719,276,NW Bracken,0,0,0,0,221,5,44,0,8,24,32,132,165,297,0,301,4,1,10,0.391304,0,4.91304,62.4309,23,1
New Zealand,184,233.745,7.39674,0.36413,227.951,7.30435,0.353261,276,BB McCullum,30,18,12,24,204,7,28,1,6,8,14,92,154,246,302,269,23,0,10,3.98611,0.201389,29.9028,98.4004,144,0
New Zealand,184,233.745,7.39674,0.36413,227.951,7.30435,0.353261,276,JS Patel,1,0,1,2,204,7,28,1,6,8,14,92,154,246,302,269,23,0,10,0.7,0,8.4,60,10,3
New Zealand,184,233.745,7.39674,0.36413,227.951,7.30435,0.353261,277,LRPL Taylor,56,24,32,62,159,5,24,1,22,27,49,80,152,232,0,244,12,0,10,3.68382,0.301471,36.7206,79.3959,136,4
New Zealand,184,233.745,7.39674,0.36413,227.951,7.30435,0.353261,277,KD Mills,7,0,7,15,159,5,24,1,22,27,49,80,152,232,0,244,12,0,10,1.52542,0.0338983,12.8644,90.7895,59,0
New Zealand,184,233.745,7.39674,0.36413,227.951,7.30435,0.353261,277,DL Vettori,0,0,0,0,159,5,24,1,22,27,49,80,152,232,0,244,12,0,10,1.43662,0.028169,15.7606,86.0108,71,0
New Zealand,184,233.745,7.39674,0.36413,227.951,7.30435,0.353261,277,TG Southee,0,0,0,0,159,5,24,1,22,27,49,80,152,232,0,244,12,0,10,0.764706,0,7.03922,92.7649,51,0
Australia,228,239.627,7.69737,0.372807,232.079,7.23246,0.337719,277,MEK Hussey,59,22,37,62,177,3,35,1,14,13,27,98,141,239,245,247,8,1,10,2.7563,0.260504,34.084,82.4893,119,4
Australia,228,239.627,7.69737,0.372807,232.079,7.23246,0.337719,277,CJ Ferguson,2,0,2,2,177,3,35,1,14,13,27,98,141,239,245,247,8,1,10,2.47826,0.173913,26.3478,80.4781,23,4
England,221,237.176,7.17647,0.289593,230.633,7.45701,0.384615,278,MJ Prior,2,0,2,8,183,3,13,2,24,22,46,90,152,242,0,270,28,0,10,2.27083,0.0625,21.6875,76.4879,48,4
England,221,237.176,7.17647,0.289593,230.633,7.45701,0.384615,278,PD Collingwood,57,16,41,71,183,3,13,2,24,22,46,90,152,242,0,270,28,0,10,2.62366,0.193548,30.5161,76.8065,93,4
England,221,237.176,7.17647,0.289593,230.633,7.45701,0.384615,278,SCJ Broad,0,0,0,0,183,3,13,2,24,22,46,90,152,242,0,270,28,0,10,0.725806,0,8.04839,74.0356,62,1
England,221,237.176,7.17647,0.289593,230.633,7.45701,0.384615,278,GJ Batty,0,0,0,0,183,3,13,2,24,22,46,90,152,242,0,270,28,0,10,0.333333,0,7.33333,40,3,3
West Indies,176,217.33,7.15909,0.3125,225.278,7.57386,0.380682,278,D Ramdin,9,0,9,11,187,3,28,2,4,2,6,100,121,221,271,244,23,1,10,1.7439,0.097561,19.1951,81.1759,82,1
West Indies,176,217.33,7.15909,0.3125,225.278,7.57386,0.380682,278,KA Pollard,38,20,18,33,187,3,28,2,4,2,6,100,121,221,271,244,23,1,10,2.70513,0.115385,24.5,88.0645,78,4
West Indies,176,217.33,7.15909,0.3125,225.278,7.57386,0.380682,279,DJ Bravo,19,6,13,18,191,4,30,0,8,19,27,94,154,248,0,264,16,1,10,2.35514,0.11215,23.1589,80.9011,107,4
West Indies,176,217.33,7.15909,0.3125,225.278,7.57386,0.380682,279,D Ramdin,0,0,0,0,191,4,30,0,8,19,27,94,154,248,0,264,16,1,10,1.7439,0.097561,19.1951,81.1759,82,1
West Indies,176,217.33,7.15909,0.3125,225.278,7.57386,0.380682,279,DJG Sammy,0,0,0,0,191,4,30,0,8,19,27,94,154,248,0,264,16,1,10,2.25,0.09,18.25,95.8005,100,0
West Indies,176,217.33,7.15909,0.3125,225.278,7.57386,0.380682,279,S Chanderpaul,100,36,64,131,191,4,30,0,8,19,27,94,154,248,0,264,16,1,10,3.57143,0.396825,40.8254,68.0783,63,4
West Indies,176,217.33,7.15909,0.3125,225.278,7.57386,0.380682,279,NO Miller,0,0,0,0,191,4,30,0,8,19,27,94,154,248,0,264,16,1,10,1,0.0416667,10.3333,79.2332,24,1
West Indies,176,217.33,7.15909,0.3125,225.278,7.57386,0.380682,279,FH Edwards,0,0,0,0,191,4,30,0,8,19,27,94,154,248,0,264,16,1,10,0.384615,0,4.46154,50.4348,13,3
England,221,237.176,7.17647,0.289593,230.633,7.45701,0.384615,279,SJ Harmison,13,0,13,11,165,7,33,1,8,13,21,68,151,219,265,243,24,0,10,0.142857,0,5.14286,72,7,1
England,221,237.176,7.17647,0.289593,230.633,7.45701,0.384615,279,AJ Strauss,97,24,73,128,165,7,33,1,8,13,21,68,151,219,265,243,24,0,10,3.93243,0.27027,33.9054,79.8028,74,4
England,221,237.176,7.17647,0.289593,230.633,7.45701,0.384615,279,JM Anderson,0,0,0,0,165,7,33,1,8,13,21,68,151,219,265,243,24,0,10,0.365385,0,3.92308,52.7132,52,3
West Indies,176,217.33,7.15909,0.3125,225.278,7.57386,0.380682,280,DJ Bravo,58,32,26,66,166,6,39,1,16,9,25,128,102,230,0,239,9,1,10,2.35514,0.11215,23.1589,80.9011,107,4
West Indies,176,217.33,7.15909,0.3125,225.278,7.57386,0.380682,280,FH Edwards,0,0,0,2,166,6,39,1,16,9,25,128,102,230,0,239,9,1,10,0.384615,0,4.46154,50.4348,13,3
West Indies,176,217.33,7.15909,0.3125,225.278,7.57386,0.380682,280,LS Baker,0,0,0,0,166,6,39,1,16,9,25,128,102,230,0,239,9,1,10,0.666667,0,3.33333,58.8235,3,3
West Indies,176,217.33,7.15909,0.3125,225.278,7.57386,0.380682,280,NO Miller,7,4,3,9,166,6,39,1,16,9,25,128,102,230,0,239,9,1,10,1,0.0416667,10.3333,79.2332,24,1
India,259,242.378,7.15058,0.339768,244.568,7.12741,0.30888,283,Yuvraj Singh,90,60,30,63,248,4,57,0,44,18,62,230,137,367,0,387,20,1,10,4.05833,0.258333,32.525,83.8093,120,4
India,259,242.378,7.15058,0.339768,244.568,7.12741,0.30888,283,MS Dhoni,36,18,18,30,248,4,57,0,44,18,62,230,137,367,0,387,20,1,10,3.47872,0.292553,36.7713,84.1612,188,4
India,259,242.378,7.15058,0.339768,244.568,7.12741,0.30888,283,RG Sharma,0,0,0,0,248,4,57,0,44,18,62,230,137,367,0,387,20,1,10,3.82836,0.268657,35.9179,83.083,134,4
India,259,242.378,7.15058,0.339768,244.568,7.12741,0.30888,284,Harbhajan Singh,4,0,4,6,197,5,37,1,22,18,40,142,132,274,0,292,18,1,10,0.901639,0,9.98361,76.4115,61,1
India,259,242.378,7.15058,0.339768,244.568,7.12741,0.30888,284,YK Pathan,19,10,9,15,197,5,37,1,22,18,40,142,132,274,0,292,18,1,10,2.575,0.125,19.975,110.055,40,0
India,259,242.378,7.15058,0.339768,244.568,7.12741,0.30888,284,Z Khan,0,0,0,0,197,5,37,1,22,18,40,142,132,274,0,292,18,1,10,0.974359,0,8.35897,60.9346,39,1
India,259,242.378,7.15058,0.339768,244.568,7.12741,0.30888,284,RP Singh,0,0,0,0,197,5,37,1,22,18,40,142,132,274,0,292,18,1,10,0.333333,0,5.6,39.8104,15,3
India,259,242.378,7.15058,0.339768,244.568,7.12741,0.30888,284,MM Patel,0,0,0,0,197,5,37,1,22,18,40,142,132,274,0,292,18,1,10,0.363636,0,3.22727,66.9811,22,1
England,221,237.176,7.17647,0.289593,230.633,7.45701,0.384615,284,SJ Harmison,0,0,0,0,177,6,38,2,8,4,12,132,95,227,293,238,11,0,10,0.142857,0,5.14286,72,7,1
England,221,237.176,7.17647,0.289593,230.633,7.45701,0.384615,284,SCJ Broad,17,14,3,8,177,6,38,2,8,4,12,132,95,227,293,238,11,0,10,0.725806,0,8.04839,74.0356,62,1
England,221,237.176,7.17647,0.289593,230.633,7.45701,0.384615,284,JM Anderson,0,0,0,0,177,6,38,2,8,4,12,132,95,227,293,238,11,0,10,0.365385,0,3.92308,52.7132,52,3
England,221,237.176,7.17647,0.289593,230.633,7.45701,0.384615,285,MJ Prior,2,0,2,6,174,5,29,1,6,14,20,96,127,223,0,240,17,0,10,2.27083,0.0625,21.6875,76.4879,48,4
England,221,237.176,7.17647,0.289593,230.633,7.45701,0.384615,285,SR Patel,15,4,11,23,174,5,29,1,6,14,20,96,127,223,0,240,17,0,10,2.22727,0.0454545,21.9091,90.6015,22,0
England,221,237.176,7.17647,0.289593,230.633,7.45701,0.384615,285,SCJ Broad,0,0,0,0,174,5,29,1,6,14,20,96,127,223,0,240,17,0,10,0.725806,0,8.04839,74.0356,62,1
England,221,237.176,7.17647,0.289593,230.633,7.45701,0.384615,285,GP Swann,0,0,0,0,174,5,29,1,6,14,20,96,127,223,0,240,17,0,10,1.08696,0,10.3043,90.631,46,0
England,221,237.176,7.17647,0.289593,230.633,7.45701,0.384615,285,JM Anderson,0,0,0,0,174,5,29,1,6,14,20,96,127,223,0,240,17,0,10,0.365385,0,3.92308,52.7132,52,3
England,221,237.176,7.17647,0.289593,230.633,7.45701,0.384615,287,KP Pietersen,97,42,55,114,178,4,32,0,20,22,42,114,138,252,0,270,18,0,10,3.69892,0.236559,33.4946,82.2117,93,4
England,221,237.176,7.17647,0.289593,230.633,7.45701,0.384615,287,OA Shah,38,20,18,41,178,4,32,0,20,22,42,114,138,252,0,270,18,0,10,3.13043,0.23913,32.6739,81.1994,46,4
India,259,242.378,7.15058,0.339768,244.568,7.12741,0.30888,288,S Badrinath,5,0,5,9,206,3,24,2,0,17,17,78,169,247,0,258,11,0,10,0.666667,0,13.1667,45.6647,6,3
India,259,242.378,7.15058,0.339768,244.568,7.12741,0.30888,288,RG Sharma,7,0,7,10,206,3,24,2,0,17,17,78,169,247,0,258,11,0,10,3.82836,0.268657,35.9179,83.083,134,4
India,259,242.378,7.15058,0.339768,244.568,7.12741,0.30888,288,Harbhajan Singh,0,0,0,0,206,3,24,2,0,17,17,78,169,247,0,258,11,0,10,0.901639,0,9.98361,76.4115,61,1
India,259,242.378,7.15058,0.339768,244.568,7.12741,0.30888,288,P Kumar,0,0,0,0,206,3,24,2,0,17,17,78,169,247,0,258,11,0,10,1,0.03125,9.03125,86.0119,32,1
India,259,242.378,7.15058,0.339768,244.568,7.12741,0.30888,288,MM Patel,0,0,0,0,206,3,24,2,0,17,17,78,169,247,0,258,11,0,10,0.363636,0,3.22727,66.9811,22,1
India,259,242.378,7.15058,0.339768,244.568,7.12741,0.30888,288,Z Khan,0,0,0,0,206,3,24,2,0,17,17,78,169,247,0,258,11,0,10,0.974359,0,8.35897,60.9346,39,1
Sri Lanka,244,223.373,7.09016,0.344262,227.578,7.47541,0.385246,288,T Thushara,37,20,17,25,170,7,22,2,0,4,4,80,116,196,259,212,16,1,10,1.7619,0.047619,16.4762,93.7669,21,0
Sri Lanka,244,223.373,7.09016,0.344262,227.578,7.47541,0.385246,288,M Muralitharan,0,0,0,2,170,7,22,2,0,4,4,80,116,196,259,212,16,1,10,0.69697,0,5.63636,99.4652,33,0
New Zealand,184,233.745,7.39674,0.36413,227.951,7.30435,0.353261,289,GD Elliott,18,4,14,22,181,5,39,0,18,7,25,112,133,245,0,270,25,1,10,2.67188,0.203125,29.4375,79.7629,64,4
New Zealand,184,233.745,7.39674,0.36413,227.951,7.30435,0.353261,289,PD McGlashan,48,26,22,39,181,5,39,0,18,7,25,112,133,245,0,270,25,1,10,3.5,0.5,30.5,115.094,2,0
India,259,242.378,7.15058,0.339768,244.568,7.12741,0.30888,291,SK Raina,0,0,0,0,268,3,53,1,38,16,54,236,139,375,0,392,17,0,10,3.11111,0.216374,28.9064,91.8944,171,0
India,259,242.378,7.15058,0.339768,244.568,7.12741,0.30888,291,MS Dhoni,53,24,29,48,268,3,53,1,38,16,54,236,139,375,0,392,17,0,10,3.47872,0.292553,36.7713,84.1612,188,4
India,259,242.378,7.15058,0.339768,244.568,7.12741,0.30888,291,YK Pathan,0,0,0,0,268,3,53,1,38,16,54,236,139,375,0,392,17,0,10,2.575,0.125,19.975,110.055,40,0
New Zealand,184,233.745,7.39674,0.36413,227.951,7.30435,0.353261,291,TG Southee,32,24,8,22,269,8,57,1,0,0,0,198,128,326,393,334,8,1,10,0.764706,0,7.03922,92.7649,51,0
West Indies,176,217.33,7.15909,0.3125,225.278,7.57386,0.380682,293,S Chanderpaul,23,8,15,25,213,3,39,1,14,14,28,148,132,280,0,294,14,0,10,3.57143,0.396825,40.8254,68.0783,63,4
West Indies,176,217.33,7.15909,0.3125,225.278,7.57386,0.380682,293,CS Baugh,2,0,2,3,213,3,39,1,14,14,28,148,132,280,0,294,14,0,10,1.04545,0,14,60.9901,22,1
West Indies,176,217.33,7.15909,0.3125,225.278,7.57386,0.380682,293,BP Nash,0,0,0,0,213,3,39,1,14,14,28,148,132,280,0,294,14,0,10,1,0,5,62.5,1,1
West Indies,176,217.33,7.15909,0.3125,225.278,7.57386,0.380682,293,JE Taylor,0,0,0,0,213,3,39,1,14,14,28,148,132,280,0,294,14,0,10,0.903226,0,6.96774,83.3977,31,1
West Indies,176,217.33,7.15909,0.3125,225.278,7.57386,0.380682,293,DBL Powell,0,0,0,0,213,3,39,1,14,14,28,148,132,280,0,294,14,0,10,0.529412,0,5.76471,77.1654,17,1
West Indies,176,217.33,7.15909,0.3125,225.278,7.57386,0.380682,293,NO Miller,0,0,0,0,213,3,39,1,14,14,28,148,132,280,0,294,14,0,10,1,0.0416667,10.3333,79.2332,24,1
Pakistan,211,222.621,7.38389,0.393365,235.517,7.54976,0.336493,293,Shoaib Malik,60,30,30,44,194,4,37,1,22,23,45,92,184,276,295,295,19,0,10,2.77551,0.193878,28.7041,81.4418,98,4
Pakistan,211,222.621,7.38389,0.393365,235.517,7.54976,0.336493,293,Fawad Alam,11,0,11,12,194,4,37,1,22,23,45,92,184,276,295,295,19,0,10,1.85294,0.176471,26.5588,72.6468,34,4
Pakistan,211,222.621,7.38389,0.393365,235.517,7.54976,0.336493,293,Kamran Akmal,0,0,0,0,194,4,37,1,22,23,45,92,184,276,295,295,19,0,10,3.01124,0.11236,23.0787,81.4433,89,4
Pakistan,211,222.621,7.38389,0.393365,235.517,7.54976,0.336493,294,Sohail Tanvir,12,4,8,13,171,5,24,2,22,9,31,64,162,226,0,232,6,0,10,1.18919,0,9.08108,81.5534,37,1
Pakistan,211,222.621,7.38389,0.393365,235.517,7.54976,0.336493,294,Iftikhar Anjum,7,0,7,10,171,5,24,2,22,9,31,64,162,226,0,232,6,0,10,0.666667,0,7.33333,58.7786,21,3
Pakistan,211,222.621,7.38389,0.393365,235.517,7.54976,0.336493,294,Umar Gul,0,0,0,0,171,5,24,2,22,9,31,64,162,226,0,232,6,0,10,0.77193,0,7.14035,68.2886,57,1
Pakistan,211,222.621,7.38389,0.393365,235.517,7.54976,0.336493,294,Saeed Ajmal,0,0,0,0,171,5,24,2,22,9,31,64,162,226,0,232,6,0,10,0.34375,0,4.60938,58.3004,64,3
West Indies,176,217.33,7.15909,0.3125,225.278,7.57386,0.380682,294,S Chanderpaul,100,24,76,142,141,5,29,2,0,16,16,52,134,186,233,208,22,0,10,3.57143,0.396825,40.8254,68.0783,63,4
West Indies,176,217.33,7.15909,0.3125,225.278,7.57386,0.380682,294,NO Miller,9,4,5,11,141,5,29,2,0,16,16,52,134,186,233,208,22,0,10,1,0.0416667,10.3333,79.2332,24,1
West Indies,176,217.33,7.15909,0.3125,225.278,7.57386,0.380682,294,DBL Powell,0,0,0,0,141,5,29,2,0,16,16,52,134,186,233,208,22,0,10,0.529412,0,5.76471,77.1654,17,1
West Indies,176,217.33,7.15909,0.3125,225.278,7.57386,0.380682,294,LS Baker,0,0,0,0,141,5,29,2,0,16,16,52,134,186,233,208,22,0,10,0.666667,0,3.33333,58.8235,3,3
India,259,242.378,7.15058,0.339768,244.568,7.12741,0.30888,298,MS Dhoni,36,10,26,41,242,5,24,0,32,19,51,164,153,317,0,339,22,0,10,3.47872,0.292553,36.7713,84.1612,188,4
India,259,242.378,7.15058,0.339768,244.568,7.12741,0.30888,298,YK Pathan,15,4,11,24,242,5,24,0,32,19,51,164,153,317,0,339,22,0,10,2.575,0.125,19.975,110.055,40,0
India,259,242.378,7.15058,0.339768,244.568,7.12741,0.30888,298,Harbhajan Singh,0,0,0,0,242,5,24,0,32,19,51,164,153,317,0,339,22,0,10,0.901639,0,9.98361,76.4115,61,1
West Indies,176,217.33,7.15909,0.3125,225.278,7.57386,0.380682,298,D Ramdin,17,4,13,17,236,7,35,1,10,9,19,142,148,290,340,319,29,1,10,1.7439,0.097561,19.1951,81.1759,82,1
West Indies,176,217.33,7.15909,0.3125,225.278,7.57386,0.380682,298,SJ Benn,0,0,0,0,236,7,35,1,10,9,19,142,148,290,340,319,29,1,10,0.8,0,6.75,72.973,20,1
West Indies,176,217.33,7.15909,0.3125,225.278,7.57386,0.380682,298,LS Baker,0,0,0,0,236,7,35,1,10,9,19,142,148,290,340,319,29,1,10,0.666667,0,3.33333,58.8235,3,3
India,259,242.378,7.15058,0.339768,244.568,7.12741,0.30888,299,MS Dhoni,81,26,55,125,134,8,22,0,10,6,16,76,96,172,0,188,16,0,10,3.47872,0.292553,36.7713,84.1612,188,4
India,259,242.378,7.15058,0.339768,244.568,7.12741,0.30888,299,RP Singh,21,10,11,68,134,8,22,0,10,6,16,76,96,172,0,188,16,0,10,0.333333,0,5.6,39.8104,15,3
India,259,242.378,7.15058,0.339768,244.568,7.12741,0.30888,299,A Nehra,0,0,0,0,134,8,22,0,10,6,16,76,96,172,0,188,16,0,10,0.263158,0,2.84211,43.2,19,3
Zimbabwe,142,212.077,7.5,0.380282,227.704,6.97887,0.316901,301,RW Price,0,0,0,0,134,6,15,1,22,20,42,90,101,191,0,205,14,0,10,0.666667,0,7.16667,57.2062,36,3
Zimbabwe,142,212.077,7.5,0.380282,227.704,6.97887,0.316901,301,E Chigumbura,40,12,28,84,134,6,15,1,22,20,42,90,101,191,0,205,14,0,10,2.28947,0.114035,22.7895,77.7844,114,4
Zimbabwe,142,212.077,7.5,0.380282,227.704,6.97887,0.316901,301,T Mupariwa,0,0,0,0,134,6,15,1,22,20,42,90,101,191,0,205,14,0,10,0.416667,0,3.58333,39.0909,12,3
Bangladesh,160,218.438,7.70625,0.4,211.106,7.05,0.325,301,Mahbubul Alam,21,10,11,23,133,8,22,1,0,2,2,54,103,157,206,167,10,1,10,3.5,0.5,39.5,109.722,2,0
England,221,237.176,7.17647,0.289593,230.633,7.45701,0.384615,305,MJ Prior,84,20,64,86,224,2,41,2,18,24,42,114,193,307,0,328,21,1,10,2.27083,0.0625,21.6875,76.4879,48,4
England,221,237.176,7.17647,0.289593,230.633,7.45701,0.384615,305,PD Collingwood,5,4,1,2,224,2,41,2,18,24,42,114,193,307,0,328,21,1,10,2.62366,0.193548,30.5161,76.8065,93,4
England,221,237.176,7.17647,0.289593,230.633,7.45701,0.384615,305,EJG Morgan,0,0,0,0,224,2,41,2,18,24,42,114,193,307,0,328,21,1,10,3.19549,0.233083,30.0526,86.9291,133,4
England,221,237.176,7.17647,0.289593,230.633,7.45701,0.384615,305,TT Bresnan,0,0,0,0,224,2,41,2,18,24,42,114,193,307,0,328,21,1,10,1.52381,0.015873,13.8095,88.4146,63,0
England,221,237.176,7.17647,0.289593,230.633,7.45701,0.384615,305,SCJ Broad,0,0,0,0,224,2,41,2,18,24,42,114,193,307,0,328,21,1,10,0.725806,0,8.04839,74.0356,62,1
West Indies,176,217.33,7.15909,0.3125,225.278,7.57386,0.380682,305,SJ Benn,13,10,3,14,193,6,34,2,18,16,34,116,145,261,329,270,9,0,10,0.8,0,6.75,72.973,20,1
West Indies,176,217.33,7.15909,0.3125,225.278,7.57386,0.380682,305,R Rampaul,4,0,4,5,193,6,34,2,18,16,34,116,145,261,329,270,9,0,10,1.30303,0.030303,9.90909,77.4882,33,1
West Indies,176,217.33,7.15909,0.3125,225.278,7.57386,0.380682,305,FH Edwards,0,0,0,0,193,6,34,2,18,16,34,116,145,261,329,270,9,0,10,0.384615,0,4.46154,50.4348,13,3
England,221,237.176,7.17647,0.289593,230.633,7.45701,0.384615,306,GP Swann,0,0,0,0,128,6,39,1,8,18,26,62,131,193,0,203,10,0,10,1.08696,0,10.3043,90.631,46,0
England,221,237.176,7.17647,0.289593,230.633,7.45701,0.384615,306,AU Rashid,5,0,5,12,128,6,39,1,8,18,26,62,131,193,0,203,10,0,10,2.41176,0.0588235,17.2941,108.889,17,0
England,221,237.176,7.17647,0.289593,230.633,7.45701,0.384615,306,TT Bresnan,0,0,0,0,128,6,39,1,8,18,26,62,131,193,0,203,10,0,10,1.52381,0.015873,13.8095,88.4146,63,0
England,221,237.176,7.17647,0.289593,230.633,7.45701,0.384615,306,RJ Sidebottom,0,0,0,0,128,6,39,1,8,18,26,62,131,193,0,203,10,0,10,0.6875,0,7.6875,65.7754,16,1
Sri Lanka,244,223.373,7.09016,0.344262,227.578,7.47541,0.385246,307,M Muralitharan,2,0,2,5,184,7,19,2,4,1,5,84,124,208,0,219,11,0,10,0.69697,0,5.63636,99.4652,33,0
Sri Lanka,244,223.373,7.09016,0.344262,227.578,7.47541,0.385246,307,BAW Mendis,1,0,1,2,184,7,19,2,4,1,5,84,124,208,0,219,11,0,10,0.447368,0,4.47368,66.4062,38,1
Pakistan,211,222.621,7.38389,0.393365,235.517,7.54976,0.336493,307,Shoaib Malik,4,0,4,5,182,1,25,1,4,3,7,104,110,214,220,220,6,0,10,2.77551,0.193878,28.7041,81.4418,98,4
Sri Lanka,244,223.373,7.09016,0.344262,227.578,7.47541,0.385246,308,MF Maharoof,11,4,7,8,198,4,31,1,20,25,45,124,150,274,0,290,16,0,10,1.38889,0.0277778,14.3611,81.2893,36,1
Sri Lanka,244,223.373,7.09016,0.344262,227.578,7.47541,0.385246,308,CK Kapugedera,24,8,16,29,198,4,31,1,20,25,45,124,150,274,0,290,16,0,10,1.74138,0.12069,21.1379,68.6066,58,1
Sri Lanka,244,223.373,7.09016,0.344262,227.578,7.47541,0.385246,308,T Thushara,0,0,0,0,198,4,31,1,20,25,45,124,150,274,0,290,16,0,10,1.7619,0.047619,16.4762,93.7669,21,0
Sri Lanka,244,223.373,7.09016,0.344262,227.578,7.47541,0.385246,308,M Muralitharan,0,0,0,0,198,4,31,1,20,25,45,124,150,274,0,290,16,0,10,0.69697,0,5.63636,99.4652,33,0
Sri Lanka,244,223.373,7.09016,0.344262,227.578,7.47541,0.385246,309,TM Dilshan,108,20,88,123,210,2,36,1,28,16,44,98,192,290,0,309,19,0,10,4.60199,0.273632,38.3632,86.0219,201,4
Sri Lanka,244,223.373,7.09016,0.344262,227.578,7.47541,0.385246,309,DPMD Jayawardene,11,8,3,8,210,2,36,1,28,16,44,98,192,290,0,309,19,0,10,3.20833,0.244792,31.6979,79.1109,192,4
Sri Lanka,244,223.373,7.09016,0.344262,227.578,7.47541,0.385246,309,CK Kapugedera,0,0,0,0,210,2,36,1,28,16,44,98,192,290,0,309,19,0,10,1.74138,0.12069,21.1379,68.6066,58,1
Sri Lanka,244,223.373,7.09016,0.344262,227.578,7.47541,0.385246,309,MF Maharoof,0,0,0,0,210,2,36,1,28,16,44,98,192,290,0,309,19,0,10,1.38889,0.0277778,14.3611,81.2893,36,1
Sri Lanka,244,223.373,7.09016,0.344262,227.578,7.47541,0.385246,310,MF Maharoof,20,8,12,18,171,4,28,0,18,24,42,84,157,241,0,246,5,1,10,1.38889,0.0277778,14.3611,81.2893,36,1
Sri Lanka,244,223.373,7.09016,0.344262,227.578,7.47541,0.385246,310,DPMD Jayawardene,11,0,11,19,171,4,28,0,18,24,42,84,157,241,0,246,5,1,10,3.20833,0.244792,31.6979,79.1109,192,4
Sri Lanka,244,223.373,7.09016,0.344262,227.578,7.47541,0.385246,310,CK Kapugedera,0,0,0,0,171,4,28,0,18,24,42,84,157,241,0,246,5,1,10,1.74138,0.12069,21.1379,68.6066,58,1
Sri Lanka,244,223.373,7.09016,0.344262,227.578,7.47541,0.385246,310,T Thushara,0,0,0,0,171,4,28,0,18,24,42,84,157,241,0,246,5,1,10,1.7619,0.047619,16.4762,93.7669,21,0
India,259,242.378,7.15058,0.339768,244.568,7.12741,0.30888,310,MS Dhoni,46,12,34,53,178,4,26,0,16,10,26,78,152,230,247,247,17,0,10,3.47872,0.292553,36.7713,84.1612,188,4
India,259,242.378,7.15058,0.339768,244.568,7.12741,0.30888,310,RG Sharma,14,4,10,23,178,4,26,0,16,10,26,78,152,230,247,247,17,0,10,3.82836,0.268657,35.9179,83.083,134,4
India,259,242.378,7.15058,0.339768,244.568,7.12741,0.30888,311,Z Khan,2,0,2,10,203,5,13,2,10,20,30,102,144,246,0,256,10,0,10,0.974359,0,8.35897,60.9346,39,1
India,259,242.378,7.15058,0.339768,244.568,7.12741,0.30888,311,P Kumar,0,0,0,4,203,5,13,2,10,20,30,102,144,246,0,256,10,0,10,1,0.03125,9.03125,86.0119,32,1
Sri Lanka,244,223.373,7.09016,0.344262,227.578,7.47541,0.385246,311,T Thushara,3,0,3,2,158,4,43,2,8,14,22,70,153,223,257,241,18,1,10,1.7619,0.047619,16.4762,93.7669,21,0
Sri Lanka,244,223.373,7.09016,0.344262,227.578,7.47541,0.385246,311,SHT Kandamby,79,28,51,121,158,4,43,2,8,14,22,70,153,223,257,241,18,1,10,2.23333,0.166667,27.1667,69.5392,30,4
Sri Lanka,244,223.373,7.09016,0.344262,227.578,7.47541,0.385246,311,M Muralitharan,0,0,0,0,158,4,43,2,8,14,22,70,153,223,257,241,18,1,10,0.69697,0,5.63636,99.4652,33,0
Sri Lanka,244,223.373,7.09016,0.344262,227.578,7.47541,0.385246,311,KMDN Kulasekara,0,0,0,0,158,4,43,2,8,14,22,70,153,223,257,241,18,1,10,1.21,0.04,11.8,80.9328,100,1
India,259,242.378,7.15058,0.339768,244.568,7.12741,0.30888,312,YK Pathan,21,10,11,19,270,5,29,0,28,26,54,198,155,353,0,363,10,0,10,2.575,0.125,19.975,110.055,40,0
India,259,242.378,7.15058,0.339768,244.568,7.12741,0.30888,312,MS Dhoni,19,0,19,34,270,5,29,0,28,26,54,198,155,353,0,363,10,0,10,3.47872,0.292553,36.7713,84.1612,188,4
India,259,242.378,7.15058,0.339768,244.568,7.12741,0.30888,313,SK Raina,27,12,15,23,229,4,38,0,18,22,40,120,187,307,0,332,25,0,10,3.11111,0.216374,28.9064,91.8944,171,0
India,259,242.378,7.15058,0.339768,244.568,7.12741,0.30888,313,G Gambhir,136,54,82,144,229,4,38,0,18,22,40,120,187,307,0,332,25,0,10,3.99145,0.333333,37.4701,84.1944,117,4
India,259,242.378,7.15058,0.339768,244.568,7.12741,0.30888,313,RG Sharma,0,0,0,0,229,4,38,0,18,22,40,120,187,307,0,332,25,0,10,3.82836,0.268657,35.9179,83.083,134,4
Sri Lanka,244,223.373,7.09016,0.344262,227.578,7.47541,0.385246,313,KMDN Kulasekara,13,8,5,11,199,6,25,3,24,9,33,104,153,257,333,265,8,1,10,1.21,0.04,11.8,80.9328,100,1
Sri Lanka,244,223.373,7.09016,0.344262,227.578,7.47541,0.385246,313,CRD Fernando,2,0,2,7,199,6,25,3,24,9,33,104,153,257,333,265,8,1,10,0.571429,0,5.42857,64.7727,21,1
Sri Lanka,244,223.373,7.09016,0.344262,227.578,7.47541,0.385246,314,MF Maharoof,8,4,4,8,239,2,24,4,18,20,38,140,161,301,0,320,19,1,10,1.38889,0.0277778,14.3611,81.2893,36,1
Sri Lanka,244,223.373,7.09016,0.344262,227.578,7.47541,0.385246,314,T Thushara,10,4,6,9,239,2,24,4,18,20,38,140,161,301,0,320,19,1,10,1.7619,0.047619,16.4762,93.7669,21,0
Sri Lanka,244,223.373,7.09016,0.344262,227.578,7.47541,0.385246,314,KMDN Kulasekara,0,0,0,0,239,2,24,4,18,20,38,140,161,301,0,320,19,1,10,1.21,0.04,11.8,80.9328,100,1
Sri Lanka,244,223.373,7.09016,0.344262,227.578,7.47541,0.385246,314,M Muralitharan,0,0,0,0,239,2,24,4,18,20,38,140,161,301,0,320,19,1,10,0.69697,0,5.63636,99.4652,33,0
India,259,242.378,7.15058,0.339768,244.568,7.12741,0.30888,314,RA Jadeja,42,8,34,65,200,7,20,1,12,10,22,106,136,242,321,252,10,0,10,2.12941,0.117647,21.7529,82.4342,85,4
India,259,242.378,7.15058,0.339768,244.568,7.12741,0.30888,314,L Balaji,7,4,3,9,200,7,20,1,12,10,22,106,136,242,321,252,10,0,10,1,0,7,70,1,1
India,259,242.378,7.15058,0.339768,244.568,7.12741,0.30888,314,I Sharma,0,0,0,0,200,7,20,1,12,10,22,106,136,242,321,252,10,0,10,0.24,0,2.84,34.1346,25,3
South Africa,190,234.274,7.4,0.373684,232.363,7.33158,0.342105,315,RE van der Merwe,2,0,2,5,174,6,32,1,14,20,34,102,138,240,0,250,10,1,10,0.714286,0,5.57143,95.122,7,0
South Africa,190,234.274,7.4,0.373684,232.363,7.33158,0.342105,315,MV Boucher,17,4,13,25,174,6,32,1,14,20,34,102,138,240,0,250,10,1,10,2.21053,0.0877193,22.2281,89.3512,57,0
South Africa,190,234.274,7.4,0.373684,232.363,7.33158,0.342105,315,DW Steyn,0,0,0,0,174,6,32,1,14,20,34,102,138,240,0,250,10,1,10,0.75,0,6.52273,61.588,44,1
South Africa,190,234.274,7.4,0.373684,232.363,7.33158,0.342105,315,CK Langeveldt,0,0,0,0,174,6,32,1,14,20,34,102,138,240,0,250,10,1,10,0.571429,0,4.71429,59.4595,14,3
England,221,237.176,7.17647,0.289593,230.633,7.45701,0.384615,315,PD Collingwood,99,36,63,108,183,2,45,1,8,3,11,110,129,239,251,252,13,0,10,2.62366,0.193548,30.5161,76.8065,93,4
England,221,237.176,7.17647,0.289593,230.633,7.45701,0.384615,315,EJG Morgan,22,18,4,15,183,2,45,1,8,3,11,110,129,239,251,252,13,0,10,3.19549,0.233083,30.0526,86.9291,133,4
Pakistan,211,222.621,7.38389,0.393365,235.517,7.54976,0.336493,321,Umar Gul,7,4,3,10,158,5,41,2,0,5,5,116,88,204,0,207,3,0,10,0.77193,0,7.14035,68.2886,57,1
Pakistan,211,222.621,7.38389,0.393365,235.517,7.54976,0.336493,321,Shoaib Akhtar,24,22,2,12,158,5,41,2,0,5,5,116,88,204,0,207,3,0,10,0.421053,0,3.21053,67.033,19,1
Pakistan,211,222.621,7.38389,0.393365,235.517,7.54976,0.336493,321,Saeed Ajmal,0,0,0,0,158,5,41,2,0,5,5,116,88,204,0,207,3,0,10,0.34375,0,4.60938,58.3004,64,3
Pakistan,211,222.621,7.38389,0.393365,235.517,7.54976,0.336493,321,Iftikhar Anjum,0,0,0,0,158,5,41,2,0,5,5,116,88,204,0,207,3,0,10,0.666667,0,7.33333,58.7786,21,3
Australia,228,239.627,7.69737,0.372807,232.079,7.23246,0.337719,321,CJ Ferguson,9,4,5,10,168,4,24,0,0,1,1,68,125,193,208,208,15,0,10,2.47826,0.173913,26.3478,80.4781,23,4
Australia,228,239.627,7.69737,0.372807,232.079,7.23246,0.337719,322,NM Hauritz,0,0,0,0,144,5,18,1,6,18,24,82,104,186,0,198,12,0,10,1.04,0.04,11.64,93.5691,25,0
Australia,228,239.627,7.69737,0.372807,232.079,7.23246,0.337719,322,DJ Hussey,7,0,7,15,144,5,18,1,6,18,24,82,104,186,0,198,12,0,10,2.54386,0.245614,29.2105,87.8628,57,4
Australia,228,239.627,7.69737,0.372807,232.079,7.23246,0.337719,322,NW Bracken,0,0,0,0,144,5,18,1,6,18,24,82,104,186,0,198,12,0,10,0.391304,0,4.91304,62.4309,23,1
Pakistan,211,222.621,7.38389,0.393365,235.517,7.54976,0.336493,322,Sohail Tanvir,8,4,4,18,134,6,16,1,0,5,5,66,89,155,199,171,16,0,10,1.18919,0,9.08108,81.5534,37,1
Pakistan,211,222.621,7.38389,0.393365,235.517,7.54976,0.336493,322,Shoaib Malik,28,8,20,53,134,6,16,1,0,5,5,66,89,155,199,171,16,0,10,2.77551,0.193878,28.7041,81.4418,98,4
Pakistan,211,222.621,7.38389,0.393365,235.517,7.54976,0.336493,322,Saeed Ajmal,0,0,0,0,134,6,16,1,0,5,5,66,89,155,199,171,16,0,10,0.34375,0,4.60938,58.3004,64,3
Pakistan,211,222.621,7.38389,0.393365,235.517,7.54976,0.336493,322,Umar Gul,0,0,0,0,134,6,16,1,0,5,5,66,89,155,199,171,16,0,10,0.77193,0,7.14035,68.2886,57,1
Pakistan,211,222.621,7.38389,0.393365,235.517,7.54976,0.336493,323,Sohail Tanvir,0,0,0,0,149,6,21,1,8,10,18,58,130,188,0,197,9,0,10,1.18919,0,9.08108,81.5534,37,1
Pakistan,211,222.621,7.38389,0.393365,235.517,7.54976,0.336493,323,Yasir Arafat,16,10,6,26,149,6,21,1,8,10,18,58,130,188,0,197,9,0,10,2.66667,0,17.3333,58.427,3,3
Pakistan,211,222.621,7.38389,0.393365,235.517,7.54976,0.336493,323,Shoaib Akhtar,0,0,0,0,149,6,21,1,8,10,18,58,130,188,0,197,9,0,10,0.421053,0,3.21053,67.033,19,1
Pakistan,211,222.621,7.38389,0.393365,235.517,7.54976,0.336493,323,Saeed Ajmal,0,0,0,0,149,6,21,1,8,10,18,58,130,188,0,197,9,0,10,0.34375,0,4.60938,58.3004,64,3
Australia,228,239.627,7.69737,0.372807,232.079,7.23246,0.337719,324,CJ Ferguson,24,8,16,31,181,4,22,0,8,28,36,88,151,239,0,250,11,0,10,2.47826,0.173913,26.3478,80.4781,23,4
Australia,228,239.627,7.69737,0.372807,232.079,7.23246,0.337719,324,SR Watson,97,36,61,130,181,4,22,0,8,28,36,88,151,239,0,250,11,0,10,4.71318,0.286822,37.7907,90.0943,129,4
Pakistan,211,222.621,7.38389,0.393365,235.517,7.54976,0.336493,324,Misbah-ul-Haq,63,28,35,75,192,3,21,0,24,1,25,108,130,238,251,254,16,0,10,2.95238,0.285714,34.9921,71.8195,126,4
Pakistan,211,222.621,7.38389,0.393365,235.517,7.54976,0.336493,324,Kamran Akmal,104,40,64,112,192,3,21,0,24,1,25,108,130,238,251,254,16,0,10,3.01124,0.11236,23.0787,81.4433,89,4
West Indies,176,217.33,7.15909,0.3125,225.278,7.57386,0.380682,325,TM Dowlin,87,26,61,107,165,4,49,1,26,21,47,100,161,261,0,274,13,1,10,2.1,0.2,22.7,62.7072,10,1
West Indies,176,217.33,7.15909,0.3125,225.278,7.57386,0.380682,325,RN Lewis,12,6,6,13,165,4,49,1,26,21,47,100,161,261,0,274,13,1,10,1.66667,0,19.5,119.388,6,0
West Indies,176,217.33,7.15909,0.3125,225.278,7.57386,0.380682,325,DJG Sammy,0,0,0,0,165,4,49,1,26,21,47,100,161,261,0,274,13,1,10,2.25,0.09,18.25,95.8005,100,0
Bangladesh,160,218.438,7.70625,0.4,211.106,7.05,0.325,325,Mahmudullah,3,0,3,5,187,4,40,1,12,10,22,72,177,249,275,276,27,0,10,2.26531,0.153061,24.4286,70.9544,98,4
Bangladesh,160,218.438,7.70625,0.4,211.106,7.05,0.325,325,Mushfiqur Rahim,23,8,15,27,187,4,40,1,12,10,22,72,177,249,275,276,27,0,10,2.61111,0.18254,27.7778,75.2526,126,4
Bangladesh,160,218.438,7.70625,0.4,211.106,7.05,0.325,325,Naeem Islam,0,0,0,0,187,4,40,1,12,10,22,72,177,249,275,276,27,0,10,1.88889,0.111111,18.6889,67.496,45,1
Bangladesh,160,218.438,7.70625,0.4,211.106,7.05,0.325,325,Abdur Razzak,0,0,0,0,187,4,40,1,12,10,22,72,177,249,275,276,27,0,10,0.849315,0.0136986,8.39726,73.8554,73,1
West Indies,176,217.33,7.15909,0.3125,225.278,7.57386,0.380682,326,DC Thomas,20,4,16,28,186,7,24,1,8,10,18,140,88,228,0,248,20,1,10,1.11111,0,12.4444,61.3699,18,1
West Indies,176,217.33,7.15909,0.3125,225.278,7.57386,0.380682,326,KAJ Roach,2,0,2,5,186,7,24,1,8,10,18,140,88,228,0,248,20,1,10,0.526316,0,5.68421,50.5855,38,3
West Indies,176,217.33,7.15909,0.3125,225.278,7.57386,0.380682,326,GC Tonge,0,0,0,0,186,7,24,1,8,10,18,140,88,228,0,248,20,1,10,0.333333,0,3,56.25,3,3
Bangladesh,160,218.438,7.70625,0.4,211.106,7.05,0.325,326,Mahmudullah,32,4,28,61,176,6,31,0,16,16,32,120,119,239,249,249,10,0,10,2.26531,0.153061,24.4286,70.9544,98,4
Bangladesh,160,218.438,7.70625,0.4,211.106,7.05,0.325,326,Naeem Islam,19,12,7,16,176,6,31,0,16,16,32,120,119,239,249,249,10,0,10,1.88889,0.111111,18.6889,67.496,45,1
Bangladesh,160,218.438,7.70625,0.4,211.106,7.05,0.325,326,Abdur Razzak,0,0,0,0,176,6,31,0,16,16,32,120,119,239,249,249,10,0,10,0.849315,0.0136986,8.39726,73.8554,73,1
Sri Lanka,244,223.373,7.09016,0.344262,227.578,7.47541,0.385246,327,AD Mathews,30,4,26,41,145,6,21,1,34,22,56,74,148,222,0,232,10,1,10,2.64122,0.198473,28.6794,82.3362,131,4
Sri Lanka,244,223.373,7.09016,0.344262,227.578,7.47541,0.385246,327,M Muralitharan,1,0,1,1,145,6,21,1,34,22,56,74,148,222,0,232,10,1,10,0.69697,0,5.63636,99.4652,33,0
Sri Lanka,244,223.373,7.09016,0.344262,227.578,7.47541,0.385246,327,T Thushara,0,0,0,0,145,6,21,1,34,22,56,74,148,222,0,232,10,1,10,1.7619,0.047619,16.4762,93.7669,21,0
Sri Lanka,244,223.373,7.09016,0.344262,227.578,7.47541,0.385246,327,SL Malinga,0,0,0,0,145,6,21,1,34,22,56,74,148,222,0,232,10,1,10,0.617284,0.0123457,4.97531,74.6296,81,1
Pakistan,211,222.621,7.38389,0.393365,235.517,7.54976,0.336493,328,Saeed Ajmal,14,4,10,17,110,9,22,0,4,6,10,56,86,142,0,168,26,0,10,0.34375,0,4.60938,58.3004,64,3
Pakistan,211,222.621,7.38389,0.393365,235.517,7.54976,0.336493,328,Mohammad Amir,16,8,8,27,110,9,22,0,4,6,10,56,86,142,0,168,26,0,10,1.5,0.0714286,12,73.6842,14,1
Pakistan,211,222.621,7.38389,0.393365,235.517,7.54976,0.336493,329,Abdul Razzaq,17,10,7,17,196,6,44,1,16,21,37,144,133,277,0,288,11,0,10,2.225,0.075,20.475,82.0641,40,4
Pakistan,211,222.621,7.38389,0.393365,235.517,7.54976,0.336493,329,Naved-ul-Hasan,10,6,4,10,196,6,44,1,16,21,37,144,133,277,0,288,11,0,10,1.15,0,11.35,83.4559,20,1
Pakistan,211,222.621,7.38389,0.393365,235.517,7.54976,0.336493,329,Mohammad Amir,0,0,0,0,196,6,44,1,16,21,37,144,133,277,0,288,11,0,10,1.5,0.0714286,12,73.6842,14,1
Sri Lanka,244,223.373,7.09016,0.344262,227.578,7.47541,0.385246,329,KC Sangakkara,25,8,17,25,229,3,27,1,12,8,20,130,146,276,289,289,13,1,10,4.33659,0.360976,41.9854,80.6276,205,4
Sri Lanka,244,223.373,7.09016,0.344262,227.578,7.47541,0.385246,329,CK Kapugedera,0,0,0,5,229,3,27,1,12,8,20,130,146,276,289,289,13,1,10,1.74138,0.12069,21.1379,68.6066,58,1
Pakistan,211,222.621,7.38389,0.393365,235.517,7.54976,0.336493,330,Younis Khan,77,12,65,102,199,4,39,0,28,22,50,108,180,288,0,321,33,0,10,2.64655,0.215517,28.5,73.2713,116,4
Pakistan,211,222.621,7.38389,0.393365,235.517,7.54976,0.336493,330,Umar Akmal,66,24,42,55,199,4,39,0,28,22,50,108,180,288,0,321,33,0,10,2.76842,0.2,27.5053,82.7947,95,4
Pakistan,211,222.621,7.38389,0.393365,235.517,7.54976,0.336493,330,Shahid Afridi,0,0,0,0,199,4,39,0,28,22,50,108,180,288,0,321,33,0,10,2.72917,0.0972222,21.4097,127.766,144,0
Pakistan,211,222.621,7.38389,0.393365,235.517,7.54976,0.336493,331,Misbah-ul-Haq,53,12,41,65,211,5,18,1,24,18,42,104,167,271,0,279,8,0,10,2.95238,0.285714,34.9921,71.8195,126,4
Pakistan,211,222.621,7.38389,0.393365,235.517,7.54976,0.336493,331,Naved-ul-Hasan,11,0,11,16,211,5,18,1,24,18,42,104,167,271,0,279,8,0,10,1.15,0,11.35,83.4559,20,1
Sri Lanka,244,223.373,7.09016,0.344262,227.578,7.47541,0.385246,332,AD Mathews,40,12,28,51,141,5,35,0,12,23,35,68,143,211,0,216,5,1,10,2.64122,0.198473,28.6794,82.3362,131,4
Sri Lanka,244,223.373,7.09016,0.344262,227.578,7.47541,0.385246,332,TT Samaraweera,92,36,56,115,141,5,35,0,12,23,35,68,143,211,0,216,5,1,10,2.19231,0.0769231,23.4231,73.8182,26,4
Sri Lanka,244,223.373,7.09016,0.344262,227.578,7.47541,0.385246,332,KMDN Kulasekara,0,0,0,0,141,5,35,0,12,23,35,68,143,211,0,216,5,1,10,1.21,0.04,11.8,80.9328,100,1
Sri Lanka,244,223.373,7.09016,0.344262,227.578,7.47541,0.385246,332,T Thushara,0,0,0,0,141,5,35,0,12,23,35,68,143,211,0,216,5,1,10,1.7619,0.047619,16.4762,93.7669,21,0
Sri Lanka,244,223.373,7.09016,0.344262,227.578,7.47541,0.385246,333,CK Kapugedera,33,8,25,39,205,5,35,0,32,20,52,132,160,292,0,307,15,1,10,1.74138,0.12069,21.1379,68.6066,58,1
Sri Lanka,244,223.373,7.09016,0.344262,227.578,7.47541,0.385246,333,SHT Kandamby,45,12,33,52,205,5,35,0,32,20,52,132,160,292,0,307,15,1,10,2.23333,0.166667,27.1667,69.5392,30,4
Sri Lanka,244,223.373,7.09016,0.344262,227.578,7.47541,0.385246,333,KMDN Kulasekara,0,0,0,0,205,5,35,0,32,20,52,132,160,292,0,307,15,1,10,1.21,0.04,11.8,80.9328,100,1
India,259,242.378,7.15058,0.339768,244.568,7.12741,0.30888,334,Yuvraj Singh,26,10,16,26,214,2,31,0,38,16,54,106,193,299,0,319,20,0,10,4.05833,0.258333,32.525,83.8093,120,4
India,259,242.378,7.15058,0.339768,244.568,7.12741,0.30888,334,SR Tendulkar,124,32,92,135,214,2,31,0,38,16,54,106,193,299,0,319,20,0,10,5.89773,0.363636,45.6023,84.5376,88,4
India,259,242.378,7.15058,0.339768,244.568,7.12741,0.30888,334,YK Pathan,0,0,0,0,214,2,31,0,38,16,54,106,193,299,0,319,20,0,10,2.575,0.125,19.975,110.055,40,0
India,259,242.378,7.15058,0.339768,244.568,7.12741,0.30888,334,SK Raina,0,0,0,0,214,2,31,0,38,16,54,106,193,299,0,319,20,0,10,3.11111,0.216374,28.9064,91.8944,171,0
India,259,242.378,7.15058,0.339768,244.568,7.12741,0.30888,334,V Kohli,0,0,0,0,214,2,31,0,38,16,54,106,193,299,0,319,20,0,10,4.66456,0.379747,44.9937,88.3325,158,4
Sri Lanka,244,223.373,7.09016,0.344262,227.578,7.47541,0.385246,334,BAW Mendis,3,0,3,1,228,6,25,3,0,5,5,118,140,258,320,273,15,1,10,0.447368,0,4.47368,66.4062,38,1
Sri Lanka,244,223.373,7.09016,0.344262,227.578,7.47541,0.385246,334,KMDN Kulasekara,8,4,4,9,228,6,25,3,0,5,5,118,140,258,320,273,15,1,10,1.21,0.04,11.8,80.9328,100,1
Australia,228,239.627,7.69737,0.372807,232.079,7.23246,0.337719,335,MG Johnson,5,0,5,6,173,4,20,2,16,24,40,60,173,233,0,256,23,1,10,1.18519,0.0246914,10.7901,94.181,81,0
Australia,228,239.627,7.69737,0.372807,232.079,7.23246,0.337719,335,MEK Hussey,12,0,12,16,173,4,20,2,16,24,40,60,173,233,0,256,23,1,10,2.7563,0.260504,34.084,82.4893,119,4
Australia,228,239.627,7.69737,0.372807,232.079,7.23246,0.337719,335,NM Hauritz,0,0,0,0,173,4,20,2,16,24,40,60,173,233,0,256,23,1,10,1.04,0.04,11.64,93.5691,25,0
Australia,228,239.627,7.69737,0.372807,232.079,7.23246,0.337719,337,MEK Hussey,8,4,4,8,210,3,40,2,30,27,57,124,183,307,0,324,17,1,10,2.7563,0.260504,34.084,82.4893,119,4
Australia,228,239.627,7.69737,0.372807,232.079,7.23246,0.337719,337,JR Hopes,7,4,3,4,210,3,40,2,30,27,57,124,183,307,0,324,17,1,10,2.09259,0.0555556,21.2778,91.4809,54,0
Australia,228,239.627,7.69737,0.372807,232.079,7.23246,0.337719,337,MG Johnson,0,0,0,0,210,3,40,2,30,27,57,124,183,307,0,324,17,1,10,1.18519,0.0246914,10.7901,94.181,81,0
West Indies,176,217.33,7.15909,0.3125,225.278,7.57386,0.380682,337,KA Pollard,53,24,29,50,179,6,39,0,24,15,39,122,135,257,325,274,17,0,10,2.70513,0.115385,24.5,88.0645,78,4
West Indies,176,217.33,7.15909,0.3125,225.278,7.57386,0.380682,337,DR Smith,34,14,20,47,179,6,39,0,24,15,39,122,135,257,325,274,17,0,10,2.5,0.12,17.96,84.5574,50,1
West Indies,176,217.33,7.15909,0.3125,225.278,7.57386,0.380682,337,DJG Sammy,0,0,0,0,179,6,39,0,24,15,39,122,135,257,325,274,17,0,10,2.25,0.09,18.25,95.8005,100,0
West Indies,176,217.33,7.15909,0.3125,225.278,7.57386,0.380682,337,NO Miller,0,0,0,0,179,6,39,0,24,15,39,122,135,257,325,274,17,0,10,1,0.0416667,10.3333,79.2332,24,1
Australia,228,239.627,7.69737,0.372807,232.079,7.23246,0.337719,338,AC Voges,27,8,19,25,216,4,34,1,46,19,65,132,183,315,0,324,9,1,10,2.29167,0.125,29.625,84.142,24,4
Australia,228,239.627,7.69737,0.372807,232.079,7.23246,0.337719,338,JR Hopes,10,4,6,7,216,4,34,1,46,19,65,132,183,315,0,324,9,1,10,2.09259,0.0555556,21.2778,91.4809,54,0
Pakistan,211,222.621,7.38389,0.393365,235.517,7.54976,0.336493,339,Shahid Afridi,28,20,8,15,199,4,38,3,18,8,26,130,133,263,0,274,11,0,10,2.72917,0.0972222,21.4097,127.766,144,0
Pakistan,211,222.621,7.38389,0.393365,235.517,7.54976,0.336493,339,Naved-ul-Hasan,4,4,0,5,199,4,38,3,18,8,26,130,133,263,0,274,11,0,10,1.15,0,11.35,83.4559,20,1
Pakistan,211,222.621,7.38389,0.393365,235.517,7.54976,0.336493,339,Saeed Ajmal,0,0,0,0,199,4,38,3,18,8,26,130,133,263,0,274,11,0,10,0.34375,0,4.60938,58.3004,64,3
Australia,228,239.627,7.69737,0.372807,232.079,7.23246,0.337719,339,CL White,100,52,48,85,182,4,46,0,8,16,24,80,172,252,275,275,23,1,10,2.66176,0.191176,28.8235,80.1308,68,4
Australia,228,239.627,7.69737,0.372807,232.079,7.23246,0.337719,339,MEK Hussey,23,4,19,26,182,4,46,0,8,16,24,80,172,252,275,275,23,1,10,2.7563,0.260504,34.084,82.4893,119,4
Australia,228,239.627,7.69737,0.372807,232.079,7.23246,0.337719,339,BJ Haddin,0,0,0,0,182,4,46,0,8,16,24,80,172,252,275,275,23,1,10,3.14737,0.147368,26.7789,81.382,95,4
Australia,228,239.627,7.69737,0.372807,232.079,7.23246,0.337719,340,CL White,36,14,22,44,183,4,30,0,20,27,47,104,156,260,0,267,7,1,10,2.66176,0.191176,28.8235,80.1308,68,4
Australia,228,239.627,7.69737,0.372807,232.079,7.23246,0.337719,340,MEK Hussey,29,4,25,34,183,4,30,0,20,27,47,104,156,260,0,267,7,1,10,2.7563,0.260504,34.084,82.4893,119,4
Australia,228,239.627,7.69737,0.372807,232.079,7.23246,0.337719,340,BJ Haddin,0,0,0,0,183,4,30,0,20,27,47,104,156,260,0,267,7,1,10,3.14737,0.147368,26.7789,81.382,95,4
Australia,228,239.627,7.69737,0.372807,232.079,7.23246,0.337719,340,NM Hauritz,0,0,0,0,183,4,30,0,20,27,47,104,156,260,0,267,7,1,10,1.04,0.04,11.64,93.5691,25,0
Australia,228,239.627,7.69737,0.372807,232.079,7.23246,0.337719,341,MJ Clarke,66,8,58,77,187,3,35,1,22,30,52,98,176,274,0,286,12,1,10,3.10294,0.301471,35.9265,74.0303,136,4
Australia,228,239.627,7.69737,0.372807,232.079,7.23246,0.337719,341,MEK Hussey,12,8,4,10,187,3,35,1,22,30,52,98,176,274,0,286,12,1,10,2.7563,0.260504,34.084,82.4893,119,4
Australia,228,239.627,7.69737,0.372807,232.079,7.23246,0.337719,341,NM Hauritz,0,0,0,0,187,3,35,1,22,30,52,98,176,274,0,286,12,1,10,1.04,0.04,11.64,93.5691,25,0
Australia,228,239.627,7.69737,0.372807,232.079,7.23246,0.337719,341,BJ Haddin,0,0,0,0,187,3,35,1,22,30,52,98,176,274,0,286,12,1,10,3.14737,0.147368,26.7789,81.382,95,4
Pakistan,211,222.621,7.38389,0.393365,235.517,7.54976,0.336493,341,Naved-ul-Hasan,33,18,15,27,180,6,48,2,0,4,4,96,136,232,287,246,14,0,10,1.15,0,11.35,83.4559,20,1
Pakistan,211,222.621,7.38389,0.393365,235.517,7.54976,0.336493,341,Saeed Ajmal,5,4,1,4,180,6,48,2,0,4,4,96,136,232,287,246,14,0,10,0.34375,0,4.60938,58.3004,64,3
Australia,228,239.627,7.69737,0.372807,232.079,7.23246,0.337719,342,NM Hauritz,19,10,9,21,181,6,32,0,30,25,55,100,168,268,0,277,9,1,10,1.04,0.04,11.64,93.5691,25,0
Australia,228,239.627,7.69737,0.372807,232.079,7.23246,0.337719,342,MEK Hussey,50,4,46,66,181,6,32,0,30,25,55,100,168,268,0,277,9,1,10,2.7563,0.260504,34.084,82.4893,119,4
Zimbabwe,142,212.077,7.5,0.380282,227.704,6.97887,0.316901,343,P Utseya,7,0,7,8,154,6,28,2,6,11,17,66,133,199,0,207,8,1,10,0.842105,0.0263158,11.8289,55.8385,76,3
Zimbabwe,142,212.077,7.5,0.380282,227.704,6.97887,0.316901,343,RW Price,2,0,2,6,154,6,28,2,6,11,17,66,133,199,0,207,8,1,10,0.666667,0,7.16667,57.2062,36,3
Zimbabwe,142,212.077,7.5,0.380282,227.704,6.97887,0.316901,343,AG Cremer,0,0,0,0,154,6,28,2,6,11,17,66,133,199,0,207,8,1,10,0.766667,0,10.5,54.6875,30,3
Bangladesh,160,218.438,7.70625,0.4,211.106,7.05,0.325,344,Shakib Al Hasan,94,56,38,62,202,3,59,2,20,21,41,138,164,302,0,320,18,0,10,2.86992,0.252033,29.9106,79.0163,123,4
Bangladesh,160,218.438,7.70625,0.4,211.106,7.05,0.325,344,Mushfiqur Rahim,4,0,4,3,202,3,59,2,20,21,41,138,164,302,0,320,18,0,10,2.61111,0.18254,27.7778,75.2526,126,4
Bangladesh,160,218.438,7.70625,0.4,211.106,7.05,0.325,344,Mahmudullah,0,0,0,0,202,3,59,2,20,21,41,138,164,302,0,320,18,0,10,2.26531,0.153061,24.4286,70.9544,98,4
Zimbabwe,142,212.077,7.5,0.380282,227.704,6.97887,0.316901,344,RW Price,4,0,4,4,216,7,42,1,0,3,3,96,165,261,321,271,10,1,10,0.666667,0,7.16667,57.2062,36,3
Zimbabwe,142,212.077,7.5,0.380282,227.704,6.97887,0.316901,344,E Chigumbura,29,18,11,17,216,7,42,1,0,3,3,96,165,261,321,271,10,1,10,2.28947,0.114035,22.7895,77.7844,114,4
Zimbabwe,142,212.077,7.5,0.380282,227.704,6.97887,0.316901,345,BRM Taylor,83,10,73,94,204,4,58,0,32,21,53,126,189,315,0,323,8,1,10,3.3,0.26,33.56,76.3421,100,4
Zimbabwe,142,212.077,7.5,0.380282,227.704,6.97887,0.316901,345,E Chigumbura,44,30,14,24,204,4,58,0,32,21,53,126,189,315,0,323,8,1,10,2.28947,0.114035,22.7895,77.7844,114,4
Zimbabwe,142,212.077,7.5,0.380282,227.704,6.97887,0.316901,345,S Matsikenyeri,0,0,0,0,204,4,58,0,32,21,53,126,189,315,0,323,8,1,10,2,0.106383,19.9787,75.7869,47,1
Zimbabwe,142,212.077,7.5,0.380282,227.704,6.97887,0.316901,345,MN Waller,0,0,0,0,204,4,58,0,32,21,53,126,189,315,0,323,8,1,10,2.07895,0.0789474,19.3684,68.9784,38,1
Zimbabwe,142,212.077,7.5,0.380282,227.704,6.97887,0.316901,346,E Chigumbura,10,6,4,8,194,4,48,1,34,19,53,138,157,295,0,312,17,1,10,2.28947,0.114035,22.7895,77.7844,114,4
Zimbabwe,142,212.077,7.5,0.380282,227.704,6.97887,0.316901,346,CK Coventry,156,80,76,147,194,4,48,1,34,19,53,138,157,295,0,312,17,1,10,3.33333,0.166667,29.3889,90.273,18,4
Zimbabwe,142,212.077,7.5,0.380282,227.704,6.97887,0.316901,346,MN Waller,0,0,0,0,194,4,48,1,34,19,53,138,157,295,0,312,17,1,10,2.07895,0.0789474,19.3684,68.9784,38,1
Zimbabwe,142,212.077,7.5,0.380282,227.704,6.97887,0.316901,346,T Mupariwa,0,0,0,0,194,4,48,1,34,19,53,138,157,295,0,312,17,1,10,0.416667,0,3.58333,39.0909,12,3
Zimbabwe,142,212.077,7.5,0.380282,227.704,6.97887,0.316901,346,P Utseya,0,0,0,0,194,4,48,1,34,19,53,138,157,295,0,312,17,1,10,0.842105,0.0263158,11.8289,55.8385,76,3
Bangladesh,160,218.438,7.70625,0.4,211.106,7.05,0.325,346,Mushfiqur Rahim,9,0,9,10,231,4,40,1,12,13,25,126,170,296,313,313,17,0,10,2.61111,0.18254,27.7778,75.2526,126,4
Bangladesh,160,218.438,7.70625,0.4,211.106,7.05,0.325,346,Mahmudullah,6,4,2,2,231,4,40,1,12,13,25,126,170,296,313,313,17,0,10,2.26531,0.153061,24.4286,70.9544,98,4
Bangladesh,160,218.438,7.70625,0.4,211.106,7.05,0.325,346,Naeem Islam,0,0,0,0,231,4,40,1,12,13,25,126,170,296,313,313,17,0,10,1.88889,0.111111,18.6889,67.496,45,1
Zimbabwe,142,212.077,7.5,0.380282,227.704,6.97887,0.316901,347,RW Price,40,18,22,54,163,7,26,1,8,3,11,92,108,200,0,209,9,1,10,0.666667,0,7.16667,57.2062,36,3
Zimbabwe,142,212.077,7.5,0.380282,227.704,6.97887,0.316901,347,AG Cremer,6,0,6,9,163,7,26,1,8,3,11,92,108,200,0,209,9,1,10,0.766667,0,10.5,54.6875,30,3
Bangladesh,160,218.438,7.70625,0.4,211.106,7.05,0.325,347,Mahmudullah,18,6,12,29,159,4,19,1,8,5,13,78,113,191,210,212,21,0,10,2.26531,0.153061,24.4286,70.9544,98,4
Bangladesh,160,218.438,7.70625,0.4,211.106,7.05,0.325,347,Naeem Islam,0,0,0,2,159,4,19,1,8,5,13,78,113,191,210,212,21,0,10,1.88889,0.111111,18.6889,67.496,45,1
Sri Lanka,244,223.373,7.09016,0.344262,227.578,7.47541,0.385246,349,TT Samaraweera,34,4,30,44,223,3,47,0,12,24,36,144,162,306,0,319,13,0,10,2.19231,0.0769231,23.4231,73.8182,26,4
Sri Lanka,244,223.373,7.09016,0.344262,227.578,7.47541,0.385246,349,DPMD Jayawardene,66,30,36,55,223,3,47,0,12,24,36,144,162,306,0,319,13,0,10,3.20833,0.244792,31.6979,79.1109,192,4
Sri Lanka,244,223.373,7.09016,0.344262,227.578,7.47541,0.385246,349,AD Mathews,0,0,0,0,223,3,47,0,12,24,36,144,162,306,0,319,13,0,10,2.64122,0.198473,28.6794,82.3362,131,4
Sri Lanka,244,223.373,7.09016,0.344262,227.578,7.47541,0.385246,349,SHT Kandamby,0,0,0,0,223,3,47,0,12,24,36,144,162,306,0,319,13,0,10,2.23333,0.166667,27.1667,69.5392,30,4
Sri Lanka,244,223.373,7.09016,0.344262,227.578,7.47541,0.385246,349,KMDN Kulasekara,0,0,0,0,223,3,47,0,12,24,36,144,162,306,0,319,13,0,10,1.21,0.04,11.8,80.9328,100,1
New Zealand,184,233.745,7.39674,0.36413,227.951,7.30435,0.353261,351,LRPL Taylor,66,32,34,100,156,4,36,2,8,3,11,108,95,203,0,214,11,0,10,3.68382,0.301471,36.7206,79.3959,136,4
New Zealand,184,233.745,7.39674,0.36413,227.951,7.30435,0.353261,351,KD Mills,0,0,0,0,156,4,36,2,8,3,11,108,95,203,0,214,11,0,10,1.52542,0.0338983,12.8644,90.7895,59,0
New Zealand,184,233.745,7.39674,0.36413,227.951,7.30435,0.353261,351,DR Tuffey,0,0,0,0,156,4,36,2,8,3,11,108,95,203,0,214,11,0,10,1.33333,0,12.3333,112.977,12,0
New Zealand,184,233.745,7.39674,0.36413,227.951,7.30435,0.353261,351,SE Bond,0,0,0,0,156,4,36,2,8,3,11,108,95,203,0,214,11,0,10,0.5,0,7,71.7949,20,1
New Zealand,184,233.745,7.39674,0.36413,227.951,7.30435,0.353261,351,DL Vettori,0,0,0,0,156,4,36,2,8,3,11,108,95,203,0,214,11,0,10,1.43662,0.028169,15.7606,86.0108,71,0
Australia,228,239.627,7.69737,0.372807,232.079,7.23246,0.337719,352,B Lee,10,4,6,15,152,7,41,0,38,21,59,128,124,252,0,275,23,0,10,1.09091,0.0227273,10.8182,81.5068,44,1
Australia,228,239.627,7.69737,0.372807,232.079,7.23246,0.337719,352,MG Johnson,36,20,16,32,152,7,41,0,38,21,59,128,124,252,0,275,23,0,10,1.18519,0.0246914,10.7901,94.181,81,0
Australia,228,239.627,7.69737,0.372807,232.079,7.23246,0.337719,352,NM Hauritz,0,0,0,0,152,7,41,0,38,21,59,128,124,252,0,275,23,0,10,1.04,0.04,11.64,93.5691,25,0
West Indies,176,217.33,7.15909,0.3125,225.278,7.57386,0.380682,352,KAJ Roach,1,0,1,1,158,5,27,2,0,4,4,90,99,189,276,225,36,0,10,0.526316,0,5.68421,50.5855,38,3
West Indies,176,217.33,7.15909,0.3125,225.278,7.57386,0.380682,352,NO Miller,2,0,2,3,158,5,27,2,0,4,4,90,99,189,276,225,36,0,10,1,0.0416667,10.3333,79.2332,24,1
Pakistan,211,222.621,7.38389,0.393365,235.517,7.54976,0.336493,353,Mohammad Yousuf,82,24,58,89,206,3,43,0,20,20,40,140,149,289,0,302,13,0,10,3.27586,0.275862,36.7931,73.9176,58,4
Pakistan,211,222.621,7.38389,0.393365,235.517,7.54976,0.336493,353,Shoaib Malik,108,56,52,114,206,3,43,0,20,20,40,140,149,289,0,302,13,0,10,2.77551,0.193878,28.7041,81.4418,98,4
Pakistan,211,222.621,7.38389,0.393365,235.517,7.54976,0.336493,353,Shahid Afridi,0,0,0,0,206,3,43,0,20,20,40,140,149,289,0,302,13,0,10,2.72917,0.0972222,21.4097,127.766,144,0
Pakistan,211,222.621,7.38389,0.393365,235.517,7.54976,0.336493,353,Umar Akmal,0,0,0,0,206,3,43,0,20,20,40,140,149,289,0,302,13,0,10,2.76842,0.2,27.5053,82.7947,95,4
Pakistan,211,222.621,7.38389,0.393365,235.517,7.54976,0.336493,353,Naved-ul-Hasan,0,0,0,0,206,3,43,0,20,20,40,140,149,289,0,302,13,0,10,1.15,0,11.35,83.4559,20,1
Pakistan,211,222.621,7.38389,0.393365,235.517,7.54976,0.336493,353,Umar Gul,0,0,0,0,206,3,43,0,20,20,40,140,149,289,0,302,13,0,10,0.77193,0,7.14035,68.2886,57,1
Pakistan,211,222.621,7.38389,0.393365,235.517,7.54976,0.336493,353,Mohammad Amir,0,0,0,0,206,3,43,0,20,20,40,140,149,289,0,302,13,0,10,1.5,0.0714286,12,73.6842,14,1
New Zealand,184,233.745,7.39674,0.36413,227.951,7.30435,0.353261,354,MJ Guptill,46,10,36,63,211,5,31,1,34,23,57,144,155,299,0,315,16,0,10,4.8087,0.313043,38.1217,82.7482,115,4
New Zealand,184,233.745,7.39674,0.36413,227.951,7.30435,0.353261,354,JEC Franklin,9,0,9,9,211,5,31,1,34,23,57,144,155,299,0,315,16,0,10,1.67308,0.0769231,18.7115,77.5299,52,1
New Zealand,184,233.745,7.39674,0.36413,227.951,7.30435,0.353261,354,KD Mills,0,0,0,0,211,5,31,1,34,23,57,144,155,299,0,315,16,0,10,1.52542,0.0338983,12.8644,90.7895,59,0
Sri Lanka,244,223.373,7.09016,0.344262,227.578,7.47541,0.385246,354,BAW Mendis,0,0,0,0,216,7,38,2,10,5,15,154,115,269,316,277,8,0,10,0.447368,0,4.47368,66.4062,38,1
Sri Lanka,244,223.373,7.09016,0.344262,227.578,7.47541,0.385246,354,KMDN Kulasekara,45,22,23,54,216,7,38,2,10,5,15,154,115,269,316,277,8,0,10,1.21,0.04,11.8,80.9328,100,1
England,221,237.176,7.17647,0.289593,230.633,7.45701,0.384615,355,EJG Morgan,41,28,13,21,222,3,48,1,26,16,42,172,140,312,0,323,11,0,10,3.19549,0.233083,30.0526,86.9291,133,4
England,221,237.176,7.17647,0.289593,230.633,7.45701,0.384615,355,LJ Wright,3,0,3,5,222,3,48,1,26,16,42,172,140,312,0,323,11,0,10,1.92105,0.0263158,17.2368,81.875,38,1
England,221,237.176,7.17647,0.289593,230.633,7.45701,0.384615,355,RS Bopara,0,0,0,0,222,3,48,1,26,16,42,172,140,312,0,323,11,0,10,2.22115,0.144231,25.1538,75.9361,104,4
England,221,237.176,7.17647,0.289593,230.633,7.45701,0.384615,355,SCJ Broad,0,0,0,0,222,3,48,1,26,16,42,172,140,312,0,323,11,0,10,0.725806,0,8.04839,74.0356,62,1
England,221,237.176,7.17647,0.289593,230.633,7.45701,0.384615,355,GP Swann,0,0,0,0,222,3,48,1,26,16,42,172,140,312,0,323,11,0,10,1.08696,0,10.3043,90.631,46,0
England,221,237.176,7.17647,0.289593,230.633,7.45701,0.384615,355,JM Anderson,0,0,0,0,222,3,48,1,26,16,42,172,140,312,0,323,11,0,10,0.365385,0,3.92308,52.7132,52,3
South Africa,190,234.274,7.4,0.373684,232.363,7.33158,0.342105,355,RE van der Merwe,0,0,0,0,222,4,29,3,16,20,36,128,159,287,324,301,14,1,10,0.714286,0,5.57143,95.122,7,0
South Africa,190,234.274,7.4,0.373684,232.363,7.33158,0.342105,355,WD Parnell,0,0,0,0,222,4,29,3,16,20,36,128,159,287,324,301,14,1,10,1.47826,0.0434783,15.8261,74.7433,23,1
South Africa,190,234.274,7.4,0.373684,232.363,7.33158,0.342105,355,GC Smith,132,56,76,129,222,4,29,3,16,20,36,128,159,287,324,301,14,1,10,3.97,0.29,33.57,79.6819,100,4
South Africa,190,234.274,7.4,0.373684,232.363,7.33158,0.342105,355,DW Steyn,0,0,0,0,222,4,29,3,16,20,36,128,159,287,324,301,14,1,10,0.75,0,6.52273,61.588,44,1
Pakistan,211,222.621,7.38389,0.393365,235.517,7.54976,0.336493,357,Misbah-ul-Haq,23,8,15,38,144,4,25,0,12,18,30,86,113,199,0,205,6,0,10,2.95238,0.285714,34.9921,71.8195,126,4
Pakistan,211,222.621,7.38389,0.393365,235.517,7.54976,0.336493,357,Mohammad Yousuf,42,12,30,67,144,4,25,0,12,18,30,86,113,199,0,205,6,0,10,3.27586,0.275862,36.7931,73.9176,58,4
Pakistan,211,222.621,7.38389,0.393365,235.517,7.54976,0.336493,357,Umar Akmal,0,0,0,0,144,4,25,0,12,18,30,86,113,199,0,205,6,0,10,2.76842,0.2,27.5053,82.7947,95,4
Pakistan,211,222.621,7.38389,0.393365,235.517,7.54976,0.336493,357,Naved-ul-Hasan,0,0,0,0,144,4,25,0,12,18,30,86,113,199,0,205,6,0,10,1.15,0,11.35,83.4559,20,1
Australia,228,239.627,7.69737,0.372807,232.079,7.23246,0.337719,357,MG Johnson,5,0,5,13,157,4,13,3,12,10,22,84,108,192,206,206,14,0,10,1.18519,0.0246914,10.7901,94.181,81,0
Australia,228,239.627,7.69737,0.372807,232.079,7.23246,0.337719,357,NM Hauritz,0,0,0,0,157,4,13,3,12,10,22,84,108,192,206,206,14,0,10,1.04,0.04,11.64,93.5691,25,0
Australia,228,239.627,7.69737,0.372807,232.079,7.23246,0.337719,357,B Lee,3,0,3,8,157,4,13,3,12,10,22,84,108,192,206,206,14,0,10,1.09091,0.0227273,10.8182,81.5068,44,1
England,221,237.176,7.17647,0.289593,230.633,7.45701,0.384615,359,GP Swann,17,8,9,14,202,7,36,0,4,8,12,128,122,250,0,257,7,0,10,1.08696,0,10.3043,90.631,46,0
England,221,237.176,7.17647,0.289593,230.633,7.45701,0.384615,359,JM Anderson,0,0,0,0,202,7,36,0,4,8,12,128,122,250,0,257,7,0,10,0.365385,0,3.92308,52.7132,52,3
England,221,237.176,7.17647,0.289593,230.633,7.45701,0.384615,359,TT Bresnan,75,40,35,72,202,7,36,0,4,8,12,128,122,250,0,257,7,0,10,1.52381,0.015873,13.8095,88.4146,63,0
Pakistan,211,222.621,7.38389,0.393365,235.517,7.54976,0.336493,360,Saeed Ajmal,0,0,0,0,164,5,23,4,24,9,33,110,110,220,0,233,13,0,10,0.34375,0,4.60938,58.3004,64,3
Pakistan,211,222.621,7.38389,0.393365,235.517,7.54976,0.336493,360,Mohammad Amir,0,0,0,7,164,5,23,4,24,9,33,110,110,220,0,233,13,0,10,1.5,0.0714286,12,73.6842,14,1
New Zealand,184,233.745,7.39674,0.36413,227.951,7.30435,0.353261,360,GD Elliott,54,8,46,96,155,4,34,0,18,9,27,94,122,216,234,234,18,0,10,2.67188,0.203125,29.4375,79.7629,64,4
New Zealand,184,233.745,7.39674,0.36413,227.951,7.30435,0.353261,360,DL Vettori,38,12,26,39,155,4,34,0,18,9,27,94,122,216,234,234,18,0,10,1.43662,0.028169,15.7606,86.0108,71,0
New Zealand,184,233.745,7.39674,0.36413,227.951,7.30435,0.353261,360,NT Broom,0,0,0,0,155,4,34,0,18,9,27,94,122,216,234,234,18,0,10,1.42105,0.0526316,16.2632,65.7447,19,1
Australia,228,239.627,7.69737,0.372807,232.079,7.23246,0.337719,361,JR Hopes,2,0,2,3,205,3,25,2,40,14,54,158,126,284,0,292,8,0,10,2.09259,0.0555556,21.2778,91.4809,54,0
Australia,228,239.627,7.69737,0.372807,232.079,7.23246,0.337719,361,MEK Hussey,45,16,29,41,205,3,25,2,40,14,54,158,126,284,0,292,8,0,10,2.7563,0.260504,34.084,82.4893,119,4
Australia,228,239.627,7.69737,0.372807,232.079,7.23246,0.337719,361,MG Johnson,0,0,0,0,205,3,25,2,40,14,54,158,126,284,0,292,8,0,10,1.18519,0.0246914,10.7901,94.181,81,0
Australia,228,239.627,7.69737,0.372807,232.079,7.23246,0.337719,361,B Lee,0,0,0,0,205,3,25,2,40,14,54,158,126,284,0,292,8,0,10,1.09091,0.0227273,10.8182,81.5068,44,1
India,259,242.378,7.15058,0.339768,244.568,7.12741,0.30888,361,Harbhajan Singh,17,8,9,17,180,7,28,0,42,14,56,144,120,264,293,288,24,1,10,0.901639,0,9.98361,76.4115,61,1
India,259,242.378,7.15058,0.339768,244.568,7.12741,0.30888,361,P Kumar,18,10,8,18,180,7,28,0,42,14,56,144,120,264,293,288,24,1,10,1,0.03125,9.03125,86.0119,32,1
India,259,242.378,7.15058,0.339768,244.568,7.12741,0.30888,361,A Nehra,0,0,0,0,180,7,28,0,42,14,56,144,120,264,293,288,24,1,10,0.263158,0,2.84211,43.2,19,3
India,259,242.378,7.15058,0.339768,244.568,7.12741,0.30888,362,SK Raina,33,12,21,38,225,4,47,0,38,21,59,156,175,331,0,354,23,1,10,3.11111,0.216374,28.9064,91.8944,171,0
India,259,242.378,7.15058,0.339768,244.568,7.12741,0.30888,362,MS Dhoni,96,34,62,95,225,4,47,0,38,21,59,156,175,331,0,354,23,1,10,3.47872,0.292553,36.7713,84.1612,188,4
India,259,242.378,7.15058,0.339768,244.568,7.12741,0.30888,362,Harbhajan Singh,0,0,0,0,225,4,47,0,38,21,59,156,175,331,0,354,23,1,10,0.901639,0,9.98361,76.4115,61,1
India,259,242.378,7.15058,0.339768,244.568,7.12741,0.30888,362,P Kumar,0,0,0,0,225,4,47,0,38,21,59,156,175,331,0,354,23,1,10,1,0.03125,9.03125,86.0119,32,1
Australia,228,239.627,7.69737,0.372807,232.079,7.23246,0.337719,362,BW Hilfenhaus,1,0,1,1,190,7,31,2,8,13,21,108,134,242,355,255,13,0,10,0.222222,0,3.22222,40.8451,9,3
Australia,228,239.627,7.69737,0.372807,232.079,7.23246,0.337719,362,NM Hauritz,24,12,12,23,190,7,31,2,8,13,21,108,134,242,355,255,13,0,10,1.04,0.04,11.64,93.5691,25,0
Australia,228,239.627,7.69737,0.372807,232.079,7.23246,0.337719,363,MEK Hussey,62,8,54,71,164,3,22,1,16,17,33,64,155,219,0,229,10,0,10,2.7563,0.260504,34.084,82.4893,119,4
Australia,228,239.627,7.69737,0.372807,232.079,7.23246,0.337719,363,MG Johnson,0,0,0,0,164,3,22,1,16,17,33,64,155,219,0,229,10,0,10,1.18519,0.0246914,10.7901,94.181,81,0
India,259,242.378,7.15058,0.339768,244.568,7.12741,0.30888,363,MS Dhoni,52,8,44,86,163,3,16,1,20,8,28,84,123,207,230,230,23,1,10,3.47872,0.292553,36.7713,84.1612,188,4
India,259,242.378,7.15058,0.339768,244.568,7.12741,0.30888,363,SK Raina,0,0,0,5,163,3,16,1,20,8,28,84,123,207,230,230,23,1,10,3.11111,0.216374,28.9064,91.8944,171,0
Australia,228,239.627,7.69737,0.372807,232.079,7.23246,0.337719,364,MG Johnson,6,0,6,12,195,4,25,2,0,19,19,82,157,239,0,250,11,0,10,1.18519,0.0246914,10.7901,94.181,81,0
Australia,228,239.627,7.69737,0.372807,232.079,7.23246,0.337719,364,NM Hauritz,0,0,0,0,195,4,25,2,0,19,19,82,157,239,0,250,11,0,10,1.04,0.04,11.64,93.5691,25,0
Australia,228,239.627,7.69737,0.372807,232.079,7.23246,0.337719,364,PM Siddle,0,0,0,0,195,4,25,2,0,19,19,82,157,239,0,250,11,0,10,0.25,0,4.25,94.4444,4,0
Australia,228,239.627,7.69737,0.372807,232.079,7.23246,0.337719,364,DE Bollinger,0,0,0,0,195,4,25,2,0,19,19,82,157,239,0,250,11,0,10,0.714286,0,7.14286,92.5926,7,0
India,259,242.378,7.15058,0.339768,244.568,7.12741,0.30888,364,I Sharma,1,0,1,2,157,7,36,2,4,2,6,110,89,199,251,226,27,1,10,0.24,0,2.84,34.1346,25,3
India,259,242.378,7.15058,0.339768,244.568,7.12741,0.30888,364,A Nehra,3,0,3,4,157,7,36,2,4,2,6,110,89,199,251,226,27,1,10,0.263158,0,2.84211,43.2,19,3
Australia,228,239.627,7.69737,0.372807,232.079,7.23246,0.337719,365,MEK Hussey,6,0,6,7,238,2,46,1,36,18,54,170,168,338,0,350,12,0,10,2.7563,0.260504,34.084,82.4893,119,4
Australia,228,239.627,7.69737,0.372807,232.079,7.23246,0.337719,365,CL White,28,18,10,18,238,2,46,1,36,18,54,170,168,338,0,350,12,0,10,2.66176,0.191176,28.8235,80.1308,68,4
India,259,242.378,7.15058,0.339768,244.568,7.12741,0.30888,365,RA Jadeja,5,0,5,6,266,4,32,2,18,14,32,182,148,330,351,347,17,1,10,2.12941,0.117647,21.7529,82.4342,85,4
India,259,242.378,7.15058,0.339768,244.568,7.12741,0.30888,365,SR Tendulkar,173,100,73,141,266,4,32,2,18,14,32,182,148,330,351,347,17,1,10,5.89773,0.363636,45.6023,84.5376,88,4
India,259,242.378,7.15058,0.339768,244.568,7.12741,0.30888,365,P Kumar,0,0,0,0,266,4,32,2,18,14,32,182,148,330,351,347,17,1,10,1,0.03125,9.03125,86.0119,32,1
India,259,242.378,7.15058,0.339768,244.568,7.12741,0.30888,365,A Nehra,0,0,0,0,266,4,32,2,18,14,32,182,148,330,351,347,17,1,10,0.263158,0,2.84211,43.2,19,3
India,259,242.378,7.15058,0.339768,244.568,7.12741,0.30888,365,MM Patel,0,0,0,0,266,4,32,2,18,14,32,182,148,330,351,347,17,1,10,0.363636,0,3.22727,66.9811,22,1
India,259,242.378,7.15058,0.339768,244.568,7.12741,0.30888,366,A Nehra,1,0,1,6,111,7,33,1,8,9,17,80,81,161,0,170,9,1,10,0.263158,0,2.84211,43.2,19,3
India,259,242.378,7.15058,0.339768,244.568,7.12741,0.30888,366,P Kumar,40,26,14,40,111,7,33,1,8,9,17,80,81,161,0,170,9,1,10,1,0.03125,9.03125,86.0119,32,1
India,259,242.378,7.15058,0.339768,244.568,7.12741,0.30888,366,MM Patel,0,0,0,0,111,7,33,1,8,9,17,80,81,161,0,170,9,1,10,0.363636,0,3.22727,66.9811,22,1
Bangladesh,160,218.438,7.70625,0.4,211.106,7.05,0.325,367,Dolar Mahmud,35,30,5,24,124,8,40,0,12,3,15,94,85,179,0,186,7,1,10,2.33333,0,13.6667,117.143,3,0
Bangladesh,160,218.438,7.70625,0.4,211.106,7.05,0.325,367,Mushfiqur Rahim,47,12,35,73,124,8,40,0,12,3,15,94,85,179,0,186,7,1,10,2.61111,0.18254,27.7778,75.2526,126,4
Zimbabwe,142,212.077,7.5,0.380282,227.704,6.97887,0.316901,368,AG Cremer,2,0,2,6,176,5,20,2,0,4,4,90,110,200,0,219,19,0,10,0.766667,0,10.5,54.6875,30,3
Zimbabwe,142,212.077,7.5,0.380282,227.704,6.97887,0.316901,368,RW Price,0,0,0,0,176,5,20,2,0,4,4,90,110,200,0,219,19,0,10,0.666667,0,7.16667,57.2062,36,3
Zimbabwe,142,212.077,7.5,0.380282,227.704,6.97887,0.316901,368,E Chigumbura,8,0,8,12,176,5,20,2,0,4,4,90,110,200,0,219,19,0,10,2.28947,0.114035,22.7895,77.7844,114,4
Zimbabwe,142,212.077,7.5,0.380282,227.704,6.97887,0.316901,368,KM Jarvis,0,0,0,0,176,5,20,2,0,4,4,90,110,200,0,219,19,0,10,0.333333,0,3.75,36.2903,12,3
Zimbabwe,142,212.077,7.5,0.380282,227.704,6.97887,0.316901,370,BRM Taylor,88,34,54,105,158,8,19,0,18,14,32,96,113,209,0,221,12,0,10,3.3,0.26,33.56,76.3421,100,4
Zimbabwe,142,212.077,7.5,0.380282,227.704,6.97887,0.316901,370,RW Price,11,4,7,28,158,8,19,0,18,14,32,96,113,209,0,221,12,0,10,0.666667,0,7.16667,57.2062,36,3
Bangladesh,160,218.438,7.70625,0.4,211.106,7.05,0.325,370,Naeem Islam,40,12,28,72,149,5,24,4,28,6,34,100,107,207,222,222,15,1,10,1.88889,0.111111,18.6889,67.496,45,1
New Zealand,184,233.745,7.39674,0.36413,227.951,7.30435,0.353261,371,NT Broom,56,16,40,67,201,6,63,0,42,17,59,172,151,323,0,336,13,1,10,1.42105,0.0526316,16.2632,65.7447,19,1
New Zealand,184,233.745,7.39674,0.36413,227.951,7.30435,0.353261,371,JDP Oram,52,36,16,29,201,6,63,0,42,17,59,172,151,323,0,336,13,1,10,2.70833,0.1875,25.0417,95.8533,48,0
New Zealand,184,233.745,7.39674,0.36413,227.951,7.30435,0.353261,371,TG Southee,0,0,0,0,201,6,63,0,42,17,59,172,151,323,0,336,13,1,10,0.764706,0,7.03922,92.7649,51,0
New Zealand,184,233.745,7.39674,0.36413,227.951,7.30435,0.353261,371,DR Tuffey,0,0,0,0,201,6,63,0,42,17,59,172,151,323,0,336,13,1,10,1.33333,0,12.3333,112.977,12,0
Bangladesh,160,218.438,7.70625,0.4,211.106,7.05,0.325,372,Mushfiqur Rahim,56,26,30,91,88,6,33,0,42,12,54,96,79,175,0,183,8,0,10,2.61111,0.18254,27.7778,75.2526,126,4
Bangladesh,160,218.438,7.70625,0.4,211.106,7.05,0.325,372,Naeem Islam,36,12,24,75,88,6,33,0,42,12,54,96,79,175,0,183,8,0,10,1.88889,0.111111,18.6889,67.496,45,1
Bangladesh,160,218.438,7.70625,0.4,211.106,7.05,0.325,372,Shahadat Hossain,0,0,0,0,88,6,33,0,42,12,54,96,79,175,0,183,8,0,10,0.375,0,3.5625,50.4425,16,3
Bangladesh,160,218.438,7.70625,0.4,211.106,7.05,0.325,372,Shafiul Islam,0,0,0,0,88,6,33,0,42,12,54,96,79,175,0,183,8,0,10,0.535714,0,4.42857,57.6744,28,3
Bangladesh,160,218.438,7.70625,0.4,211.106,7.05,0.325,373,Mahmudullah,5,0,5,4,179,4,21,1,4,16,20,100,120,220,0,241,21,0,10,2.26531,0.153061,24.4286,70.9544,98,4
Bangladesh,160,218.438,7.70625,0.4,211.106,7.05,0.325,373,Imrul Kayes,98,44,54,139,179,4,21,1,4,16,20,100,120,220,0,241,21,0,10,3,0.207547,26.2642,63.6488,53,4
Bangladesh,160,218.438,7.70625,0.4,211.106,7.05,0.325,373,Naeem Islam,0,0,0,0,179,4,21,1,4,16,20,100,120,220,0,241,21,0,10,1.88889,0.111111,18.6889,67.496,45,1
Bangladesh,160,218.438,7.70625,0.4,211.106,7.05,0.325,373,Shahadat Hossain,0,0,0,0,179,4,21,1,4,16,20,100,120,220,0,241,21,0,10,0.375,0,3.5625,50.4425,16,3
Bangladesh,160,218.438,7.70625,0.4,211.106,7.05,0.325,373,Shafiul Islam,0,0,0,0,179,4,21,1,4,16,20,100,120,220,0,241,21,0,10,0.535714,0,4.42857,57.6744,28,3
Australia,228,239.627,7.69737,0.372807,232.079,7.23246,0.337719,374,JR Hopes,30,8,22,37,192,5,40,0,18,23,41,120,153,273,0,275,2,0,10,2.09259,0.0555556,21.2778,91.4809,54,0
Australia,228,239.627,7.69737,0.372807,232.079,7.23246,0.337719,374,MEK Hussey,46,12,34,51,192,5,40,0,18,23,41,120,153,273,0,275,2,0,10,2.7563,0.260504,34.084,82.4893,119,4
Australia,228,239.627,7.69737,0.372807,232.079,7.23246,0.337719,374,MG Johnson,0,0,0,0,192,5,40,0,18,23,41,120,153,273,0,275,2,0,10,1.18519,0.0246914,10.7901,94.181,81,0
Australia,228,239.627,7.69737,0.372807,232.079,7.23246,0.337719,374,NM Hauritz,0,0,0,0,192,5,40,0,18,23,41,120,153,273,0,275,2,0,10,1.04,0.04,11.64,93.5691,25,0
New Zealand,184,233.745,7.39674,0.36413,227.951,7.30435,0.353261,374,SB Styris,17,8,9,19,195,5,29,2,34,11,45,146,123,269,276,281,12,1,10,3.20755,0.264151,33.8302,78.7094,53,4
New Zealand,184,233.745,7.39674,0.36413,227.951,7.30435,0.353261,374,TG Southee,0,0,0,0,195,5,29,2,34,11,45,146,123,269,276,281,12,1,10,0.764706,0,7.03922,92.7649,51,0
New Zealand,184,233.745,7.39674,0.36413,227.951,7.30435,0.353261,374,SE Bond,0,0,0,0,195,5,29,2,34,11,45,146,123,269,276,281,12,1,10,0.5,0,7,71.7949,20,1
Australia,228,239.627,7.69737,0.372807,232.079,7.23246,0.337719,375,MEK Hussey,50,16,34,64,189,4,37,1,18,23,41,128,139,267,0,273,6,0,10,2.7563,0.260504,34.084,82.4893,119,4
Australia,228,239.627,7.69737,0.372807,232.079,7.23246,0.337719,375,JR Hopes,10,4,6,9,189,4,37,1,18,23,41,128,139,267,0,273,6,0,10,2.09259,0.0555556,21.2778,91.4809,54,0
Australia,228,239.627,7.69737,0.372807,232.079,7.23246,0.337719,375,MG Johnson,0,0,0,0,189,4,37,1,18,23,41,128,139,267,0,273,6,0,10,1.18519,0.0246914,10.7901,94.181,81,0
New Zealand,184,233.745,7.39674,0.36413,227.951,7.30435,0.353261,376,GJ Hopkins,45,24,21,52,193,5,37,2,0,5,5,112,123,235,0,245,10,1,10,1.3125,0,14.75,74.4479,16,1
New Zealand,184,233.745,7.39674,0.36413,227.951,7.30435,0.353261,376,SE Bond,9,6,3,8,193,5,37,2,0,5,5,112,123,235,0,245,10,1,10,0.5,0,7,71.7949,20,1
New Zealand,184,233.745,7.39674,0.36413,227.951,7.30435,0.353261,376,TG Southee,0,0,0,0,193,5,37,2,0,5,5,112,123,235,0,245,10,1,10,0.764706,0,7.03922,92.7649,51,0
Australia,228,239.627,7.69737,0.372807,232.079,7.23246,0.337719,376,AC Voges,6,0,6,11,218,3,15,1,4,4,8,128,113,241,246,248,7,0,10,2.29167,0.125,29.625,84.142,24,4
Australia,228,239.627,7.69737,0.372807,232.079,7.23246,0.337719,376,CL White,24,12,12,31,218,3,15,1,4,4,8,128,113,241,246,248,7,0,10,2.66176,0.191176,28.8235,80.1308,68,4
New Zealand,184,233.745,7.39674,0.36413,227.951,7.30435,0.353261,378,DR Tuffey,16,4,12,25,161,7,25,1,6,20,26,70,142,212,0,241,29,1,10,1.33333,0,12.3333,112.977,12,0
New Zealand,184,233.745,7.39674,0.36413,227.951,7.30435,0.353261,378,SE Bond,0,0,0,0,161,7,25,1,6,20,26,70,142,212,0,241,29,1,10,0.5,0,7,71.7949,20,1
Australia,228,239.627,7.69737,0.372807,232.079,7.23246,0.337719,378,JR Hopes,40,8,32,55,153,6,29,2,0,3,3,64,121,185,242,190,5,0,10,2.09259,0.0555556,21.2778,91.4809,54,0
Australia,228,239.627,7.69737,0.372807,232.079,7.23246,0.337719,378,CJ McKay,0,0,0,2,153,6,29,2,0,3,3,64,121,185,242,190,5,0,10,0.615385,0,6.88462,55.0769,26,3
Australia,228,239.627,7.69737,0.372807,232.079,7.23246,0.337719,378,DE Bollinger,0,0,0,0,153,6,29,2,0,3,3,64,121,185,242,190,5,0,10,0.714286,0,7.14286,92.5926,7,0
Australia,228,239.627,7.69737,0.372807,232.079,7.23246,0.337719,379,MJ Clarke,68,24,44,84,183,5,38,1,16,23,39,104,156,260,0,267,7,0,10,3.10294,0.301471,35.9265,74.0303,136,4
Australia,228,239.627,7.69737,0.372807,232.079,7.23246,0.337719,379,NM Hauritz,2,0,2,2,183,5,38,1,16,23,39,104,156,260,0,267,7,0,10,1.04,0.04,11.64,93.5691,25,0
England,221,237.176,7.17647,0.289593,230.633,7.45701,0.384615,379,TT Bresnan,26,12,14,27,207,5,37,0,8,3,11,144,111,255,268,268,13,1,10,1.52381,0.015873,13.8095,88.4146,63,0
England,221,237.176,7.17647,0.289593,230.633,7.45701,0.384615,379,EJG Morgan,94,56,38,83,207,5,37,0,8,3,11,144,111,255,268,268,13,1,10,3.19549,0.233083,30.0526,86.9291,133,4
England,221,237.176,7.17647,0.289593,230.633,7.45701,0.384615,379,MH Yardy,0,0,0,0,207,5,37,0,8,3,11,144,111,255,268,268,13,1,10,0.875,0.0833333,13.5833,66.5306,24,1
Australia,228,239.627,7.69737,0.372807,232.079,7.23246,0.337719,380,SPD Smith,40,12,28,49,167,5,31,0,18,20,38,108,128,236,0,239,3,0,10,3.19298,0.22807,34.5614,87.0526,57,4
Australia,228,239.627,7.69737,0.372807,232.079,7.23246,0.337719,380,CL White,57,26,31,79,167,5,31,0,18,20,38,108,128,236,0,239,3,0,10,2.66176,0.191176,28.8235,80.1308,68,4
Australia,228,239.627,7.69737,0.372807,232.079,7.23246,0.337719,380,JR Hopes,0,0,0,0,167,5,31,0,18,20,38,108,128,236,0,239,3,0,10,2.09259,0.0555556,21.2778,91.4809,54,0
England,221,237.176,7.17647,0.289593,230.633,7.45701,0.384615,380,GP Swann,11,4,7,12,202,5,23,1,6,2,8,102,131,233,240,243,10,1,10,1.08696,0,10.3043,90.631,46,0
Australia,228,239.627,7.69737,0.372807,232.079,7.23246,0.337719,381,SPD Smith,19,4,15,18,176,5,25,3,0,5,5,92,114,206,0,212,6,0,10,3.19298,0.22807,34.5614,87.0526,57,4
Australia,228,239.627,7.69737,0.372807,232.079,7.23246,0.337719,381,DE Bollinger,0,0,0,1,176,5,25,3,0,5,5,92,114,206,0,212,6,0,10,0.714286,0,7.14286,92.5926,7,0
Australia,228,239.627,7.69737,0.372807,232.079,7.23246,0.337719,381,SW Tait,0,0,0,0,176,5,25,3,0,5,5,92,114,206,0,212,6,0,10,0.666667,0,4.16667,86.2069,6,1
England,221,237.176,7.17647,0.289593,230.633,7.45701,0.384615,381,GP Swann,0,0,0,1,170,3,19,4,8,5,13,88,114,202,213,214,12,1,10,1.08696,0,10.3043,90.631,46,0
England,221,237.176,7.17647,0.289593,230.633,7.45701,0.384615,381,TT Bresnan,2,0,2,3,170,3,19,4,8,5,13,88,114,202,213,214,12,1,10,1.52381,0.015873,13.8095,88.4146,63,0
England,221,237.176,7.17647,0.289593,230.633,7.45701,0.384615,381,SCJ Broad,0,0,0,0,170,3,19,4,8,5,13,88,114,202,213,214,12,1,10,0.725806,0,8.04839,74.0356,62,1
Australia,228,239.627,7.69737,0.372807,232.079,7.23246,0.337719,382,CL White,9,0,9,9,205,2,30,1,24,17,41,118,158,276,0,290,14,0,10,2.66176,0.191176,28.8235,80.1308,68,4
Australia,228,239.627,7.69737,0.372807,232.079,7.23246,0.337719,382,MJ Clarke,85,24,61,94,205,2,30,1,24,17,41,118,158,276,0,290,14,0,10,3.10294,0.301471,35.9265,74.0303,136,4
Australia,228,239.627,7.69737,0.372807,232.079,7.23246,0.337719,382,MEK Hussey,0,0,0,0,205,2,30,1,24,17,41,118,158,276,0,290,14,0,10,2.7563,0.260504,34.084,82.4893,119,4
Australia,228,239.627,7.69737,0.372807,232.079,7.23246,0.337719,382,SPD Smith,0,0,0,0,205,2,30,1,24,17,41,118,158,276,0,290,14,0,10,3.19298,0.22807,34.5614,87.0526,57,4
Australia,228,239.627,7.69737,0.372807,232.079,7.23246,0.337719,383,MEK Hussey,43,4,39,47,155,4,50,1,42,21,63,128,140,268,0,277,9,0,10,2.7563,0.260504,34.084,82.4893,119,4
Australia,228,239.627,7.69737,0.372807,232.079,7.23246,0.337719,383,SPD Smith,0,0,0,0,155,4,50,1,42,21,63,128,140,268,0,277,9,0,10,3.19298,0.22807,34.5614,87.0526,57,4
Australia,228,239.627,7.69737,0.372807,232.079,7.23246,0.337719,383,JR Hopes,0,0,0,0,155,4,50,1,42,21,63,128,140,268,0,277,9,0,10,2.09259,0.0555556,21.2778,91.4809,54,0
England,221,237.176,7.17647,0.289593,230.633,7.45701,0.384615,383,SCJ Broad,3,0,3,7,175,6,36,2,4,2,6,100,117,217,278,235,18,1,10,0.725806,0,8.04839,74.0356,62,1
England,221,237.176,7.17647,0.289593,230.633,7.45701,0.384615,383,JM Anderson,0,0,0,0,175,6,36,2,4,2,6,100,117,217,278,235,18,1,10,0.365385,0,3.92308,52.7132,52,3
England,221,237.176,7.17647,0.289593,230.633,7.45701,0.384615,383,GP Swann,32,20,12,17,175,6,36,2,4,2,6,100,117,217,278,235,18,1,10,1.08696,0,10.3043,90.631,46,0
Bangladesh,160,218.438,7.70625,0.4,211.106,7.05,0.325,384,Mahmudullah,0,0,0,0,176,4,29,1,8,18,26,96,135,231,0,250,19,0,10,2.26531,0.153061,24.4286,70.9544,98,4
Bangladesh,160,218.438,7.70625,0.4,211.106,7.05,0.325,384,Raqibul Hasan,70,24,46,93,176,4,29,1,8,18,26,96,135,231,0,250,19,0,10,1.85106,0.12766,23.2766,59.2312,47,1
Bangladesh,160,218.438,7.70625,0.4,211.106,7.05,0.325,384,Mashrafe Mortaza,0,0,0,0,176,4,29,1,8,18,26,96,135,231,0,250,19,0,10,1.27536,0,11.1594,76.9231,69,1
Bangladesh,160,218.438,7.70625,0.4,211.106,7.05,0.325,384,Abdur Razzak,0,0,0,0,176,4,29,1,8,18,26,96,135,231,0,250,19,0,10,0.849315,0.0136986,8.39726,73.8554,73,1
England,221,237.176,7.17647,0.289593,230.633,7.45701,0.384615,384,IR Bell,83,24,59,101,200,4,31,0,0,1,1,88,144,232,251,251,19,1,10,3.63433,0.246269,35.3806,75.6623,134,4
Bangladesh,160,218.438,7.70625,0.4,211.106,7.05,0.325,385,Mashrafe Mortaza,1,0,1,5,167,5,15,1,14,21,35,72,145,217,0,236,19,0,10,1.27536,0,11.1594,76.9231,69,1
Bangladesh,160,218.438,7.70625,0.4,211.106,7.05,0.325,385,Mahmudullah,11,0,11,25,167,5,15,1,14,21,35,72,145,217,0,236,19,0,10,2.26531,0.153061,24.4286,70.9544,98,4
Bangladesh,160,218.438,7.70625,0.4,211.106,7.05,0.325,385,Abdur Razzak,0,0,0,0,167,5,15,1,14,21,35,72,145,217,0,236,19,0,10,0.849315,0.0136986,8.39726,73.8554,73,1
England,221,237.176,7.17647,0.289593,230.633,7.45701,0.384615,385,SCJ Broad,19,10,9,24,157,7,25,0,12,17,29,90,121,211,237,231,20,1,10,0.725806,0,8.04839,74.0356,62,1
England,221,237.176,7.17647,0.289593,230.633,7.45701,0.384615,385,IJL Trott,69,20,49,117,157,7,25,0,12,17,29,90,121,211,237,231,20,1,10,3.3871,0.403226,43.7903,75.2494,62,4
England,221,237.176,7.17647,0.289593,230.633,7.45701,0.384615,385,JM Anderson,0,0,0,0,157,7,25,0,12,17,29,90,121,211,237,231,20,1,10,0.365385,0,3.92308,52.7132,52,3
England,221,237.176,7.17647,0.289593,230.633,7.45701,0.384615,386,AJ Strauss,154,94,60,140,238,1,35,4,40,23,63,186,150,336,0,347,11,1,10,3.93243,0.27027,33.9054,79.8028,74,4
England,221,237.176,7.17647,0.289593,230.633,7.45701,0.384615,386,RS Bopara,0,0,0,0,238,1,35,4,40,23,63,186,150,336,0,347,11,1,10,2.22115,0.144231,25.1538,75.9361,104,4
England,221,237.176,7.17647,0.289593,230.633,7.45701,0.384615,386,TT Bresnan,0,0,0,0,238,1,35,4,40,23,63,186,150,336,0,347,11,1,10,1.52381,0.015873,13.8095,88.4146,63,0
England,221,237.176,7.17647,0.289593,230.633,7.45701,0.384615,386,MH Yardy,0,0,0,0,238,1,35,4,40,23,63,186,150,336,0,347,11,1,10,0.875,0.0833333,13.5833,66.5306,24,1
Bangladesh,160,218.438,7.70625,0.4,211.106,7.05,0.325,387,Abdur Razzak,1,0,1,7,200,6,16,3,0,2,2,102,116,218,0,228,10,1,10,0.849315,0.0136986,8.39726,73.8554,73,1
Bangladesh,160,218.438,7.70625,0.4,211.106,7.05,0.325,387,Shafiul Islam,10,8,2,10,200,6,16,3,0,2,2,102,116,218,0,228,10,1,10,0.535714,0,4.42857,57.6744,28,3
England,221,237.176,7.17647,0.289593,230.633,7.45701,0.384615,387,MJ Prior,23,8,15,32,191,4,23,0,4,4,8,92,130,222,229,229,7,0,10,2.27083,0.0625,21.6875,76.4879,48,4
England,221,237.176,7.17647,0.289593,230.633,7.45701,0.384615,387,PD Collingwood,74,28,46,99,191,4,23,0,4,4,8,92,130,222,229,229,7,0,10,2.62366,0.193548,30.5161,76.8065,93,4
England,221,237.176,7.17647,0.289593,230.633,7.45701,0.384615,388,C Kieswetter,99,48,51,120,168,3,41,0,40,22,62,126,145,271,0,284,13,0,10,3.43243,0.135135,26.4324,88.0288,37,4
England,221,237.176,7.17647,0.289593,230.633,7.45701,0.384615,388,EJG Morgan,20,12,8,19,168,3,41,0,40,22,62,126,145,271,0,284,13,0,10,3.19549,0.233083,30.0526,86.9291,133,4
England,221,237.176,7.17647,0.289593,230.633,7.45701,0.384615,388,LJ Wright,0,0,0,0,168,3,41,0,40,22,62,126,145,271,0,284,13,0,10,1.92105,0.0263158,17.2368,81.875,38,1
England,221,237.176,7.17647,0.289593,230.633,7.45701,0.384615,388,TT Bresnan,0,0,0,0,168,3,41,0,40,22,62,126,145,271,0,284,13,0,10,1.52381,0.015873,13.8095,88.4146,63,0
Bangladesh,160,218.438,7.70625,0.4,211.106,7.05,0.325,388,Suhrawadi Shuvo,5,0,5,9,176,5,22,2,14,10,24,86,136,222,285,239,17,1,10,1,0,9.7,70.2899,10,1
Bangladesh,160,218.438,7.70625,0.4,211.106,7.05,0.325,388,Abdur Razzak,1,0,1,3,176,5,22,2,14,10,24,86,136,222,285,239,17,1,10,0.849315,0.0136986,8.39726,73.8554,73,1
Bangladesh,160,218.438,7.70625,0.4,211.106,7.05,0.325,388,Shafiul Islam,0,0,0,0,176,5,22,2,14,10,24,86,136,222,285,239,17,1,10,0.535714,0,4.42857,57.6744,28,3
Bangladesh,160,218.438,7.70625,0.4,211.106,7.05,0.325,388,Rubel Hossain,0,0,0,0,176,5,22,2,14,10,24,86,136,222,285,239,17,1,10,0.32,0,2.68,52.3438,25,3
Pakistan,211,222.621,7.38389,0.393365,235.517,7.54976,0.336493,390,Fawad Alam,1,0,1,1,210,3,32,2,14,21,35,130,147,277,0,294,17,0,10,1.85294,0.176471,26.5588,72.6468,34,4
Pakistan,211,222.621,7.38389,0.393365,235.517,7.54976,0.336493,390,Shahid Afridi,0,0,0,0,210,3,32,2,14,21,35,130,147,277,0,294,17,0,10,2.72917,0.0972222,21.4097,127.766,144,0
Pakistan,211,222.621,7.38389,0.393365,235.517,7.54976,0.336493,390,Umar Gul,0,0,0,0,210,3,32,2,14,21,35,130,147,277,0,294,17,0,10,0.77193,0,7.14035,68.2886,57,1
Pakistan,211,222.621,7.38389,0.393365,235.517,7.54976,0.336493,390,Saeed Ajmal,0,0,0,0,210,3,32,2,14,21,35,130,147,277,0,294,17,0,10,0.34375,0,4.60938,58.3004,64,3
England,221,237.176,7.17647,0.289593,230.633,7.45701,0.384615,390,RS Bopara,1,0,1,2,210,3,31,1,20,18,38,98,181,279,295,295,16,1,10,2.22115,0.144231,25.1538,75.9361,104,4
England,221,237.176,7.17647,0.289593,230.633,7.45701,0.384615,390,EJG Morgan,16,4,12,18,210,3,31,1,20,18,38,98,181,279,295,295,16,1,10,3.19549,0.233083,30.0526,86.9291,133,4
England,221,237.176,7.17647,0.289593,230.633,7.45701,0.384615,390,MH Yardy,0,0,0,0,210,3,31,1,20,18,38,98,181,279,295,295,16,1,10,0.875,0.0833333,13.5833,66.5306,24,1
England,221,237.176,7.17647,0.289593,230.633,7.45701,0.384615,390,TT Bresnan,0,0,0,0,210,3,31,1,20,18,38,98,181,279,295,295,16,1,10,1.52381,0.015873,13.8095,88.4146,63,0
Pakistan,211,222.621,7.38389,0.393365,235.517,7.54976,0.336493,391,Umar Gul,5,0,5,22,178,7,22,0,16,11,27,80,147,227,0,241,14,0,10,0.77193,0,7.14035,68.2886,57,1
Pakistan,211,222.621,7.38389,0.393365,235.517,7.54976,0.336493,391,Abdul Razzaq,21,10,11,19,178,7,22,0,16,11,27,80,147,227,0,241,14,0,10,2.225,0.075,20.475,82.0641,40,4
Pakistan,211,222.621,7.38389,0.393365,235.517,7.54976,0.336493,391,Saeed Ajmal,0,0,0,0,178,7,22,0,16,11,27,80,147,227,0,241,14,0,10,0.34375,0,4.60938,58.3004,64,3
Pakistan,211,222.621,7.38389,0.393365,235.517,7.54976,0.336493,391,Shoaib Akhtar,0,0,0,0,178,7,22,0,16,11,27,80,147,227,0,241,14,0,10,0.421053,0,3.21053,67.033,19,1
England,221,237.176,7.17647,0.289593,230.633,7.45701,0.384615,391,LJ Wright,48,16,32,66,192,7,12,2,0,0,0,88,116,204,242,218,14,1,10,1.92105,0.0263158,17.2368,81.875,38,1
England,221,237.176,7.17647,0.289593,230.633,7.45701,0.384615,391,JM Anderson,3,0,3,8,192,7,12,2,0,0,0,88,116,204,242,218,14,1,10,0.365385,0,3.92308,52.7132,52,3
Pakistan,211,222.621,7.38389,0.393365,235.517,7.54976,0.336493,392,Umar Akmal,21,4,17,40,167,5,26,1,38,11,49,122,120,242,0,265,23,0,10,2.76842,0.2,27.5053,82.7947,95,4
Pakistan,211,222.621,7.38389,0.393365,235.517,7.54976,0.336493,392,Abdul Razzaq,0,0,0,1,167,5,26,1,38,11,49,122,120,242,0,265,23,0,10,2.225,0.075,20.475,82.0641,40,4
Pakistan,211,222.621,7.38389,0.393365,235.517,7.54976,0.336493,392,Umar Gul,0,0,0,0,167,5,26,1,38,11,49,122,120,242,0,265,23,0,10,0.77193,0,7.14035,68.2886,57,1
England,221,237.176,7.17647,0.289593,230.633,7.45701,0.384615,392,SCJ Broad,1,0,1,3,175,5,28,4,0,3,3,80,126,206,266,227,21,1,10,0.725806,0,8.04839,74.0356,62,1
England,221,237.176,7.17647,0.289593,230.633,7.45701,0.384615,392,JM Anderson,0,0,0,2,175,5,28,4,0,3,3,80,126,206,266,227,21,1,10,0.365385,0,3.92308,52.7132,52,3
England,221,237.176,7.17647,0.289593,230.633,7.45701,0.384615,393,LJ Wright,1,0,1,2,173,4,22,1,22,29,51,80,166,246,0,256,10,1,10,1.92105,0.0263158,17.2368,81.875,38,1
England,221,237.176,7.17647,0.289593,230.633,7.45701,0.384615,393,TT Bresnan,0,0,0,0,173,4,22,1,22,29,51,80,166,246,0,256,10,1,10,1.52381,0.015873,13.8095,88.4146,63,0
England,221,237.176,7.17647,0.289593,230.633,7.45701,0.384615,393,EJG Morgan,74,24,50,86,173,4,22,1,22,29,51,80,166,246,0,256,10,1,10,3.19549,0.233083,30.0526,86.9291,133,4
Pakistan,211,222.621,7.38389,0.393365,235.517,7.54976,0.336493,394,Abdul Razzaq,10,4,6,9,173,5,39,1,38,16,54,118,148,266,0,287,21,0,10,2.225,0.075,20.475,82.0641,40,4
Pakistan,211,222.621,7.38389,0.393365,235.517,7.54976,0.336493,394,Kamran Akmal,29,18,11,27,173,5,39,1,38,16,54,118,148,266,0,287,21,0,10,3.01124,0.11236,23.0787,81.4433,89,4
Pakistan,211,222.621,7.38389,0.393365,235.517,7.54976,0.336493,394,Umar Gul,0,0,0,0,173,5,39,1,38,16,54,118,148,266,0,287,21,0,10,0.77193,0,7.14035,68.2886,57,1
Pakistan,211,222.621,7.38389,0.393365,235.517,7.54976,0.336493,394,Mohammad Amir,0,0,0,0,173,5,39,1,38,16,54,118,148,266,0,287,21,0,10,1.5,0.0714286,12,73.6842,14,1
Pakistan,211,222.621,7.38389,0.393365,235.517,7.54976,0.336493,394,Saeed Ajmal,0,0,0,0,173,5,39,1,38,16,54,118,148,266,0,287,21,0,10,0.34375,0,4.60938,58.3004,64,3
New Zealand,184,233.745,7.39674,0.36413,227.951,7.30435,0.353261,395,JDP Oram,17,0,17,20,209,6,34,0,20,22,42,128,157,285,0,303,18,0,10,2.70833,0.1875,25.0417,95.8533,48,0
New Zealand,184,233.745,7.39674,0.36413,227.951,7.30435,0.353261,395,BB McCullum,119,64,55,125,209,6,34,0,20,22,42,128,157,285,0,303,18,0,10,3.98611,0.201389,29.9028,98.4004,144,0
New Zealand,184,233.745,7.39674,0.36413,227.951,7.30435,0.353261,395,KD Mills,0,0,0,0,209,6,34,0,20,22,42,128,157,285,0,303,18,0,10,1.52542,0.0338983,12.8644,90.7895,59,0
New Zealand,184,233.745,7.39674,0.36413,227.951,7.30435,0.353261,395,SE Bond,0,0,0,0,209,6,34,0,20,22,42,128,157,285,0,303,18,0,10,0.5,0,7,71.7949,20,1
Pakistan,211,222.621,7.38389,0.393365,235.517,7.54976,0.336493,395,Mohammad Amir,2,0,2,7,184,6,27,2,8,6,14,96,129,225,304,239,14,0,10,1.5,0.0714286,12,73.6842,14,1
Pakistan,211,222.621,7.38389,0.393365,235.517,7.54976,0.336493,395,Abdul Razzaq,34,18,16,28,184,6,27,2,8,6,14,96,129,225,304,239,14,0,10,2.225,0.075,20.475,82.0641,40,4
Pakistan,211,222.621,7.38389,0.393365,235.517,7.54976,0.336493,395,Saeed Ajmal,0,0,0,0,184,6,27,2,8,6,14,96,129,225,304,239,14,0,10,0.34375,0,4.60938,58.3004,64,3
New Zealand,184,233.745,7.39674,0.36413,227.951,7.30435,0.353261,396,SE Bond,4,0,4,6,177,6,12,3,0,10,10,60,139,199,0,211,12,0,10,0.5,0,7,71.7949,20,1
New Zealand,184,233.745,7.39674,0.36413,227.951,7.30435,0.353261,396,TG Southee,1,0,1,3,177,6,12,3,0,10,10,60,139,199,0,211,12,0,10,0.764706,0,7.03922,92.7649,51,0
Pakistan,211,222.621,7.38389,0.393365,235.517,7.54976,0.336493,396,Mohammad Amir,65,46,19,72,141,9,25,0,4,21,25,90,101,191,212,204,13,0,10,1.5,0.0714286,12,73.6842,14,1
Pakistan,211,222.621,7.38389,0.393365,235.517,7.54976,0.336493,396,Saeed Ajmal,16,4,12,29,141,9,25,0,4,21,25,90,101,191,212,204,13,0,10,0.34375,0,4.60938,58.3004,64,3
South Africa,190,234.274,7.4,0.373684,232.363,7.33158,0.342105,397,MV Boucher,5,4,1,2,218,3,38,2,28,24,52,154,154,308,0,331,23,1,10,2.21053,0.0877193,22.2281,89.3512,57,0
South Africa,190,234.274,7.4,0.373684,232.363,7.33158,0.342105,397,JP Duminy,85,36,49,77,218,3,38,2,28,24,52,154,154,308,0,331,23,1,10,2.3252,0.186992,29.9675,80.2351,123,4
India,259,242.378,7.15058,0.339768,244.568,7.12741,0.30888,398,RA Jadeja,3,0,3,4,312,4,29,2,24,22,46,244,143,387,0,414,27,1,10,2.12941,0.117647,21.7529,82.4342,85,4
India,259,242.378,7.15058,0.339768,244.568,7.12741,0.30888,398,V Kohli,13,8,5,9,312,4,29,2,24,22,46,244,143,387,0,414,27,1,10,4.66456,0.379747,44.9937,88.3325,158,4
India,259,242.378,7.15058,0.339768,244.568,7.12741,0.30888,398,P Kumar,0,0,0,0,312,4,29,2,24,22,46,244,143,387,0,414,27,1,10,1,0.03125,9.03125,86.0119,32,1
Sri Lanka,244,223.373,7.09016,0.344262,227.578,7.47541,0.385246,398,AD Mathews,19,8,11,14,327,4,38,1,0,25,25,220,170,390,415,411,21,0,10,2.64122,0.198473,28.6794,82.3362,131,4
Sri Lanka,244,223.373,7.09016,0.344262,227.578,7.47541,0.385246,398,SHT Kandamby,21,8,13,18,327,4,38,1,0,25,25,220,170,390,415,411,21,0,10,2.23333,0.166667,27.1667,69.5392,30,4
Sri Lanka,244,223.373,7.09016,0.344262,227.578,7.47541,0.385246,398,TT Samaraweera,0,0,0,0,327,4,38,1,0,25,25,220,170,390,415,411,21,0,10,2.19231,0.0769231,23.4231,73.8182,26,4
Sri Lanka,244,223.373,7.09016,0.344262,227.578,7.47541,0.385246,398,KMDN Kulasekara,0,0,0,0,327,4,38,1,0,25,25,220,170,390,415,411,21,0,10,1.21,0.04,11.8,80.9328,100,1
India,259,242.378,7.15058,0.339768,244.568,7.12741,0.30888,399,MS Dhoni,76,28,48,93,192,4,49,0,28,21,49,134,156,290,0,301,11,1,10,3.47872,0.292553,36.7713,84.1612,188,4
India,259,242.378,7.15058,0.339768,244.568,7.12741,0.30888,399,SK Raina,62,30,32,51,192,4,49,0,28,21,49,134,156,290,0,301,11,1,10,3.11111,0.216374,28.9064,91.8944,171,0
India,259,242.378,7.15058,0.339768,244.568,7.12741,0.30888,399,RA Jadeja,0,0,0,0,192,4,49,0,28,21,49,134,156,290,0,301,11,1,10,2.12941,0.117647,21.7529,82.4342,85,4
India,259,242.378,7.15058,0.339768,244.568,7.12741,0.30888,399,Harbhajan Singh,0,0,0,0,192,4,49,0,28,21,49,134,156,290,0,301,11,1,10,0.901639,0,9.98361,76.4115,61,1
Sri Lanka,244,223.373,7.09016,0.344262,227.578,7.47541,0.385246,399,AD Mathews,11,0,11,11,233,4,27,2,16,17,33,116,177,293,302,302,9,0,10,2.64122,0.198473,28.6794,82.3362,131,4
Sri Lanka,244,223.373,7.09016,0.344262,227.578,7.47541,0.385246,399,S Randiv,0,0,0,1,233,4,27,2,16,17,33,116,177,293,302,302,9,0,10,1.6875,0.0625,15.875,69.9725,16,1
Sri Lanka,244,223.373,7.09016,0.344262,227.578,7.47541,0.385246,399,BAW Mendis,0,0,0,0,233,4,27,2,16,17,33,116,177,293,302,302,9,0,10,0.447368,0,4.47368,66.4062,38,1
Sri Lanka,244,223.373,7.09016,0.344262,227.578,7.47541,0.385246,401,NLTC Perera,31,22,9,13,204,3,54,1,24,20,44,166,136,302,0,315,13,0,10,1.65333,0.0666667,14.32,105.397,75,0
Sri Lanka,244,223.373,7.09016,0.344262,227.578,7.47541,0.385246,401,DPMD Jayawardene,25,16,9,23,204,3,54,1,24,20,44,166,136,302,0,315,13,0,10,3.20833,0.244792,31.6979,79.1109,192,4
Sri Lanka,244,223.373,7.09016,0.344262,227.578,7.47541,0.385246,401,SHT Kandamby,0,0,0,0,204,3,54,1,24,20,44,166,136,302,0,315,13,0,10,2.23333,0.166667,27.1667,69.5392,30,4
Sri Lanka,244,223.373,7.09016,0.344262,227.578,7.47541,0.385246,401,TT Samaraweera,0,0,0,0,204,3,54,1,24,20,44,166,136,302,0,315,13,0,10,2.19231,0.0769231,23.4231,73.8182,26,4
India,259,242.378,7.15058,0.339768,244.568,7.12741,0.30888,401,G Gambhir,135,56,79,131,232,3,39,0,8,15,23,130,164,294,316,317,23,1,10,3.99145,0.333333,37.4701,84.1944,117,4
India,259,242.378,7.15058,0.339768,244.568,7.12741,0.30888,401,KD Karthik,11,0,11,12,232,3,39,0,8,15,23,130,164,294,316,317,23,1,10,2.46429,0.107143,21.6786,71.8769,56,1
India,259,242.378,7.15058,0.339768,244.568,7.12741,0.30888,402,V Sehwag,168,82,86,139,261,2,55,0,14,20,34,158,192,350,0,370,20,0,10,5.88636,0.238636,38.8295,108.649,88,0
India,259,242.378,7.15058,0.339768,244.568,7.12741,0.30888,402,V Kohli,81,34,47,72,261,2,55,0,14,20,34,158,192,350,0,370,20,0,10,4.66456,0.379747,44.9937,88.3325,158,4
India,259,242.378,7.15058,0.339768,244.568,7.12741,0.30888,402,YK Pathan,0,0,0,0,261,2,55,0,14,20,34,158,192,350,0,370,20,0,10,2.575,0.125,19.975,110.055,40,0
Bangladesh,160,218.438,7.70625,0.4,211.106,7.05,0.325,402,Naeem Islam,1,0,1,2,216,4,27,2,6,10,16,90,169,259,371,283,24,1,10,1.88889,0.111111,18.6889,67.496,45,1
Bangladesh,160,218.438,7.70625,0.4,211.106,7.05,0.325,402,Raqibul Hasan,15,0,15,17,216,4,27,2,6,10,16,90,169,259,371,283,24,1,10,1.85106,0.12766,23.2766,59.2312,47,1
Bangladesh,160,218.438,7.70625,0.4,211.106,7.05,0.325,402,Abdur Razzak,0,0,0,0,216,4,27,2,6,10,16,90,169,259,371,283,24,1,10,0.849315,0.0136986,8.39726,73.8554,73,1
Bangladesh,160,218.438,7.70625,0.4,211.106,7.05,0.325,402,Shafiul Islam,0,0,0,0,216,4,27,2,6,10,16,90,169,259,371,283,24,1,10,0.535714,0,4.42857,57.6744,28,3
Bangladesh,160,218.438,7.70625,0.4,211.106,7.05,0.325,402,Rubel Hossain,0,0,0,0,216,4,27,2,6,10,16,90,169,259,371,283,24,1,10,0.32,0,2.68,52.3438,25,3
Australia,228,239.627,7.69737,0.372807,232.079,7.23246,0.337719,405,MJ Clarke,37,8,29,42,167,3,28,1,32,21,53,90,158,248,0,262,14,0,10,3.10294,0.301471,35.9265,74.0303,136,4
Australia,228,239.627,7.69737,0.372807,232.079,7.23246,0.337719,405,DJ Hussey,0,0,0,0,167,3,28,1,32,21,53,90,158,248,0,262,14,0,10,2.54386,0.245614,29.2105,87.8628,57,4
Australia,228,239.627,7.69737,0.372807,232.079,7.23246,0.337719,405,SPD Smith,0,0,0,0,167,3,28,1,32,21,53,90,158,248,0,262,14,0,10,3.19298,0.22807,34.5614,87.0526,57,4
Australia,228,239.627,7.69737,0.372807,232.079,7.23246,0.337719,405,MG Johnson,0,0,0,0,167,3,28,1,32,21,53,90,158,248,0,262,14,0,10,1.18519,0.0246914,10.7901,94.181,81,0
Zimbabwe,142,212.077,7.5,0.380282,227.704,6.97887,0.316901,405,RW Price,4,0,4,15,139,8,12,1,0,2,2,56,97,153,263,171,18,0,10,0.666667,0,7.16667,57.2062,36,3
West Indies,176,217.33,7.15909,0.3125,225.278,7.57386,0.380682,407,DJG Sammy,0,0,0,3,181,5,18,3,4,4,8,90,117,207,0,222,15,0,10,2.25,0.09,18.25,95.8005,100,0
West Indies,176,217.33,7.15909,0.3125,225.278,7.57386,0.380682,407,KAJ Roach,0,0,0,0,181,5,18,3,4,4,8,90,117,207,0,222,15,0,10,0.526316,0,5.68421,50.5855,38,3
West Indies,176,217.33,7.15909,0.3125,225.278,7.57386,0.380682,407,SJ Benn,0,0,0,0,181,5,18,3,4,4,8,90,117,207,0,222,15,0,10,0.8,0,6.75,72.973,20,1
New Zealand,184,233.745,7.39674,0.36413,227.951,7.30435,0.353261,408,TG Southee,6,0,6,9,147,7,35,2,0,0,0,84,98,182,0,206,24,0,10,0.764706,0,7.03922,92.7649,51,0
Bangladesh,160,218.438,7.70625,0.4,211.106,7.05,0.325,409,Abdur Razzak,7,0,7,7,161,7,12,1,4,17,21,72,122,194,0,205,11,1,10,0.849315,0.0136986,8.39726,73.8554,73,1
Bangladesh,160,218.438,7.70625,0.4,211.106,7.05,0.325,409,Naeem Islam,14,8,6,23,161,7,12,1,4,17,21,72,122,194,0,205,11,1,10,1.88889,0.111111,18.6889,67.496,45,1
Bangladesh,160,218.438,7.70625,0.4,211.106,7.05,0.325,409,Rubel Hossain,0,0,0,0,161,7,12,1,4,17,21,72,122,194,0,205,11,1,10,0.32,0,2.68,52.3438,25,3
Pakistan,211,222.621,7.38389,0.393365,235.517,7.54976,0.336493,410,Misbah-ul-Haq,65,12,53,80,203,3,28,1,24,13,37,106,162,268,0,277,9,0,10,2.95238,0.285714,34.9921,71.8195,126,4
Pakistan,211,222.621,7.38389,0.393365,235.517,7.54976,0.336493,410,Umar Akmal,10,4,6,13,203,3,28,1,24,13,37,106,162,268,0,277,9,0,10,2.76842,0.2,27.5053,82.7947,95,4
Pakistan,211,222.621,7.38389,0.393365,235.517,7.54976,0.336493,410,Shahid Afridi,0,0,0,0,203,3,28,1,24,13,37,106,162,268,0,277,9,0,10,2.72917,0.0972222,21.4097,127.766,144,0
Pakistan,211,222.621,7.38389,0.393365,235.517,7.54976,0.336493,410,Abdul Razzaq,0,0,0,0,203,3,28,1,24,13,37,106,162,268,0,277,9,0,10,2.225,0.075,20.475,82.0641,40,4
Sri Lanka,244,223.373,7.09016,0.344262,227.578,7.47541,0.385246,410,LPC Silva,50,16,34,77,157,5,43,1,18,19,37,104,133,237,278,266,29,1,10,2.55556,0.244444,26.0222,69.4543,45,4
Sri Lanka,244,223.373,7.09016,0.344262,227.578,7.47541,0.385246,410,NLTC Perera,6,4,2,4,157,5,43,1,18,19,37,104,133,237,278,266,29,1,10,1.65333,0.0666667,14.32,105.397,75,0
Sri Lanka,244,223.373,7.09016,0.344262,227.578,7.47541,0.385246,410,KMDN Kulasekara,0,0,0,0,157,5,43,1,18,19,37,104,133,237,278,266,29,1,10,1.21,0.04,11.8,80.9328,100,1
Sri Lanka,244,223.373,7.09016,0.344262,227.578,7.47541,0.385246,410,HMRKB Herath,0,0,0,0,157,5,43,1,18,19,37,104,133,237,278,266,29,1,10,0.444444,0,5.18519,61.674,27,1
Sri Lanka,244,223.373,7.09016,0.344262,227.578,7.47541,0.385246,410,M Muralitharan,0,0,0,0,157,5,43,1,18,19,37,104,133,237,278,266,29,1,10,0.69697,0,5.63636,99.4652,33,0
India,259,242.378,7.15058,0.339768,244.568,7.12741,0.30888,411,MS Dhoni,23,12,11,21,239,3,43,0,24,17,41,182,141,323,0,338,15,1,10,3.47872,0.292553,36.7713,84.1612,188,4
India,259,242.378,7.15058,0.339768,244.568,7.12741,0.30888,411,Yuvraj Singh,53,32,21,49,239,3,43,0,24,17,41,182,141,323,0,338,15,1,10,4.05833,0.258333,32.525,83.8093,120,4
India,259,242.378,7.15058,0.339768,244.568,7.12741,0.30888,411,YK Pathan,0,0,0,0,239,3,43,0,24,17,41,182,141,323,0,338,15,1,10,2.575,0.125,19.975,110.055,40,0
India,259,242.378,7.15058,0.339768,244.568,7.12741,0.30888,411,V Kohli,0,0,0,0,239,3,43,0,24,17,41,182,141,323,0,338,15,1,10,4.66456,0.379747,44.9937,88.3325,158,4
India,259,242.378,7.15058,0.339768,244.568,7.12741,0.30888,411,Z Khan,0,0,0,0,239,3,43,0,24,17,41,182,141,323,0,338,15,1,10,0.974359,0,8.35897,60.9346,39,1
India,259,242.378,7.15058,0.339768,244.568,7.12741,0.30888,411,Harbhajan Singh,0,0,0,0,239,3,43,0,24,17,41,182,141,323,0,338,15,1,10,0.901639,0,9.98361,76.4115,61,1
India,259,242.378,7.15058,0.339768,244.568,7.12741,0.30888,411,PP Chawla,0,0,0,0,239,3,43,0,24,17,41,182,141,323,0,338,15,1,10,0.25,0,3.16667,63.3333,12,1
England,221,237.176,7.17647,0.289593,230.633,7.45701,0.384615,411,MJ Prior,2,0,2,7,265,2,13,3,22,27,49,146,181,327,339,338,11,0,10,2.27083,0.0625,21.6875,76.4879,48,4
England,221,237.176,7.17647,0.289593,230.633,7.45701,0.384615,411,MH Yardy,1,0,1,2,265,2,13,3,22,27,49,146,181,327,339,338,11,0,10,0.875,0.0833333,13.5833,66.5306,24,1
England,221,237.176,7.17647,0.289593,230.633,7.45701,0.384615,411,TT Bresnan,0,0,0,0,265,2,13,3,22,27,49,146,181,327,339,338,11,0,10,1.52381,0.015873,13.8095,88.4146,63,0
England,221,237.176,7.17647,0.289593,230.633,7.45701,0.384615,411,GP Swann,0,0,0,0,265,2,13,3,22,27,49,146,181,327,339,338,11,0,10,1.08696,0,10.3043,90.631,46,0
England,221,237.176,7.17647,0.289593,230.633,7.45701,0.384615,411,A Shahzad,0,0,0,0,265,2,13,3,22,27,49,146,181,327,339,338,11,0,10,0.375,0,4.875,62.9032,8,1
Zimbabwe,142,212.077,7.5,0.380282,227.704,6.97887,0.316901,418,P Utseya,35,12,23,62,123,8,27,1,4,1,5,52,103,155,0,162,7,0,10,0.842105,0.0263158,11.8289,55.8385,76,3
Zimbabwe,142,212.077,7.5,0.380282,227.704,6.97887,0.316901,418,T Panyangara,0,0,0,5,123,8,27,1,4,1,5,52,103,155,0,162,7,0,10,0.6,0,4.84,51.2712,25,3
Ireland,55,219.527,7.65455,0.290909,202.727,7.56364,0.4,419,DT Johnston,3,0,3,12,159,6,13,2,8,9,17,70,119,189,0,207,18,0,10,1.27273,0,12.1818,74.2382,22,1
Ireland,55,219.527,7.65455,0.290909,202.727,7.56364,0.4,419,GH Dockrell,1,0,1,4,159,6,13,2,8,9,17,70,119,189,0,207,18,0,10,0.875,0,9.0625,69.7115,16,1
Ireland,55,219.527,7.65455,0.290909,202.727,7.56364,0.4,419,WB Rankin,0,0,0,0,159,6,13,2,8,9,17,70,119,189,0,207,18,0,10,0.0833333,0,3.08333,35.9223,12,3
India,259,242.378,7.15058,0.339768,244.568,7.12741,0.30888,419,Yuvraj Singh,44,8,36,75,161,4,29,1,8,3,11,86,115,201,208,210,9,1,10,4.05833,0.258333,32.525,83.8093,120,4
India,259,242.378,7.15058,0.339768,244.568,7.12741,0.30888,419,YK Pathan,25,22,3,21,161,4,29,1,8,3,11,86,115,201,208,210,9,1,10,2.575,0.125,19.975,110.055,40,0
England,221,237.176,7.17647,0.289593,230.633,7.45701,0.384615,420,GP Swann,12,8,4,16,132,6,15,3,4,0,4,50,101,151,0,171,20,0,10,1.08696,0,10.3043,90.631,46,0
South Africa,190,234.274,7.4,0.373684,232.363,7.33158,0.342105,420,MN van Wyk,12,0,12,32,139,7,12,0,0,8,8,52,107,159,172,165,6,0,10,3.33333,0.266667,27.2,66.9951,15,4
South Africa,190,234.274,7.4,0.373684,232.363,7.33158,0.342105,420,DW Steyn,15,12,3,26,139,7,12,0,0,8,8,52,107,159,172,165,6,0,10,0.75,0,6.52273,61.588,44,1
South Africa,190,234.274,7.4,0.373684,232.363,7.33158,0.342105,420,M Morkel,0,0,0,0,139,7,12,0,0,8,8,52,107,159,172,165,6,0,10,0.6,0,5.28571,72.2656,35,1
South Africa,190,234.274,7.4,0.373684,232.363,7.33158,0.342105,420,Imran Tahir,0,0,0,0,139,7,12,0,0,8,8,52,107,159,172,165,6,0,10,0.625,0,5.0625,65.8537,16,1
New Zealand,184,233.745,7.39674,0.36413,227.951,7.30435,0.353261,422,NL McCullum,12,10,2,7,148,4,35,1,84,11,95,154,124,278,0,302,24,0,10,1.63934,0.0655738,17.377,85.622,61,0
New Zealand,184,233.745,7.39674,0.36413,227.951,7.30435,0.353261,422,LRPL Taylor,75,22,53,112,148,4,35,1,84,11,95,154,124,278,0,302,24,0,10,3.68382,0.301471,36.7206,79.3959,136,4
New Zealand,184,233.745,7.39674,0.36413,227.951,7.30435,0.353261,422,JDP Oram,0,0,0,0,148,4,35,1,84,11,95,154,124,278,0,302,24,0,10,2.70833,0.1875,25.0417,95.8533,48,0
New Zealand,184,233.745,7.39674,0.36413,227.951,7.30435,0.353261,422,KD Mills,0,0,0,0,148,4,35,1,84,11,95,154,124,278,0,302,24,0,10,1.52542,0.0338983,12.8644,90.7895,59,0
West Indies,176,217.33,7.15909,0.3125,225.278,7.57386,0.380682,424,KA Pollard,58,32,26,43,186,3,30,3,30,17,47,132,131,263,0,275,12,0,10,2.70513,0.115385,24.5,88.0645,78,4
West Indies,176,217.33,7.15909,0.3125,225.278,7.57386,0.380682,424,AD Russell,0,0,0,0,186,3,30,3,30,17,47,132,131,263,0,275,12,0,10,3.38095,0.0952381,23.2857,129.536,42,0
West Indies,176,217.33,7.15909,0.3125,225.278,7.57386,0.380682,424,SJ Benn,0,0,0,0,186,3,30,3,30,17,47,132,131,263,0,275,12,0,10,0.8,0,6.75,72.973,20,1
West Indies,176,217.33,7.15909,0.3125,225.278,7.57386,0.380682,424,NO Miller,0,0,0,0,186,3,30,3,30,17,47,132,131,263,0,275,12,0,10,1,0.0416667,10.3333,79.2332,24,1
West Indies,176,217.33,7.15909,0.3125,225.278,7.57386,0.380682,424,KAJ Roach,0,0,0,0,186,3,30,3,30,17,47,132,131,263,0,275,12,0,10,0.526316,0,5.68421,50.5855,38,3
Ireland,55,219.527,7.65455,0.290909,202.727,7.56364,0.4,424,GH Dockrell,3,0,3,5,185,5,17,3,12,9,21,102,121,223,276,231,8,0,10,0.875,0,9.0625,69.7115,16,1
Ireland,55,219.527,7.65455,0.290909,202.727,7.56364,0.4,424,JF Mooney,6,4,2,6,185,5,17,3,12,9,21,102,121,223,276,231,8,0,10,1.47619,0,13.7619,72.796,21,1
Ireland,55,219.527,7.65455,0.290909,202.727,7.56364,0.4,424,WB Rankin,0,0,0,0,185,5,17,3,12,9,21,102,121,223,276,231,8,0,10,0.0833333,0,3.08333,35.9223,12,3
England,221,237.176,7.17647,0.289593,230.633,7.45701,0.384615,425,GP Swann,5,4,1,2,163,4,26,2,4,22,26,68,147,215,0,225,10,0,10,1.08696,0,10.3043,90.631,46,0
England,221,237.176,7.17647,0.289593,230.633,7.45701,0.384615,425,PD Collingwood,0,0,0,2,163,4,26,2,4,22,26,68,147,215,0,225,10,0,10,2.62366,0.193548,30.5161,76.8065,93,4
England,221,237.176,7.17647,0.289593,230.633,7.45701,0.384615,425,TT Bresnan,0,0,0,0,163,4,26,2,4,22,26,68,147,215,0,225,10,0,10,1.52381,0.015873,13.8095,88.4146,63,0
England,221,237.176,7.17647,0.289593,230.633,7.45701,0.384615,425,A Shahzad,0,0,0,0,163,4,26,2,4,22,26,68,147,215,0,225,10,0,10,0.375,0,4.875,62.9032,8,1
England,221,237.176,7.17647,0.289593,230.633,7.45701,0.384615,425,JM Anderson,0,0,0,0,163,4,26,2,4,22,26,68,147,215,0,225,10,0,10,0.365385,0,3.92308,52.7132,52,3
Bangladesh,160,218.438,7.70625,0.4,211.106,7.05,0.325,425,Mahmudullah,12,4,8,32,152,8,19,0,16,7,23,86,108,194,226,227,33,1,10,2.26531,0.153061,24.4286,70.9544,98,4
Bangladesh,160,218.438,7.70625,0.4,211.106,7.05,0.325,425,Shafiul Islam,10,10,0,12,152,8,19,0,16,7,23,86,108,194,226,227,33,1,10,0.535714,0,4.42857,57.6744,28,3
India,259,242.378,7.15058,0.339768,244.568,7.12741,0.30888,426,Harbhajan Singh,1,0,1,4,253,2,20,4,0,8,8,132,149,281,0,296,15,1,10,0.901639,0,9.98361,76.4115,61,1
India,259,242.378,7.15058,0.339768,244.568,7.12741,0.30888,426,MS Dhoni,6,0,6,11,253,2,20,4,0,8,8,132,149,281,0,296,15,1,10,3.47872,0.292553,36.7713,84.1612,188,4
India,259,242.378,7.15058,0.339768,244.568,7.12741,0.30888,426,Z Khan,0,0,0,0,253,2,20,4,0,8,8,132,149,281,0,296,15,1,10,0.974359,0,8.35897,60.9346,39,1
India,259,242.378,7.15058,0.339768,244.568,7.12741,0.30888,426,A Nehra,0,0,0,0,253,2,20,4,0,8,8,132,149,281,0,296,15,1,10,0.263158,0,2.84211,43.2,19,3
India,259,242.378,7.15058,0.339768,244.568,7.12741,0.30888,426,MM Patel,0,0,0,0,253,2,20,4,0,8,8,132,149,281,0,296,15,1,10,0.363636,0,3.22727,66.9811,22,1
South Africa,190,234.274,7.4,0.373684,232.363,7.33158,0.342105,426,J Botha,1,0,1,3,213,3,30,3,28,21,49,126,166,292,297,300,8,0,10,1.09756,0,11.561,82.2917,41,1
South Africa,190,234.274,7.4,0.373684,232.363,7.33158,0.342105,426,F du Plessis,16,6,10,14,213,3,30,3,28,21,49,126,166,292,297,300,8,0,10,3.45122,0.292683,34.9268,83.135,82,4
South Africa,190,234.274,7.4,0.373684,232.363,7.33158,0.342105,426,RJ Peterson,0,0,0,0,213,3,30,3,28,21,49,126,166,292,297,300,8,0,10,1.62069,0.0344828,15.7931,83.5766,29,1
South Africa,190,234.274,7.4,0.373684,232.363,7.33158,0.342105,431,JP Duminy,68,12,56,86,198,6,27,0,18,20,38,118,145,263,0,272,9,0,10,2.3252,0.186992,29.9675,80.2351,123,4
South Africa,190,234.274,7.4,0.373684,232.363,7.33158,0.342105,431,J Botha,14,4,10,17,198,6,27,0,18,20,38,118,145,263,0,272,9,0,10,1.09756,0,11.561,82.2917,41,1
Sri Lanka,244,223.373,7.09016,0.344262,227.578,7.47541,0.385246,433,LPC Silva,2,0,2,2,185,3,20,2,28,13,41,112,134,246,0,265,19,0,10,2.55556,0.244444,26.0222,69.4543,45,4
Sri Lanka,244,223.373,7.09016,0.344262,227.578,7.47541,0.385246,433,AD Mathews,15,0,15,24,185,3,20,2,28,13,41,112,134,246,0,265,19,0,10,2.64122,0.198473,28.6794,82.3362,131,4
Sri Lanka,244,223.373,7.09016,0.344262,227.578,7.47541,0.385246,433,KMDN Kulasekara,0,0,0,0,185,3,20,2,28,13,41,112,134,246,0,265,19,0,10,1.21,0.04,11.8,80.9328,100,1
Sri Lanka,244,223.373,7.09016,0.344262,227.578,7.47541,0.385246,433,SL Malinga,0,0,0,0,185,3,20,2,28,13,41,112,134,246,0,265,19,0,10,0.617284,0.0123457,4.97531,74.6296,81,1
Sri Lanka,244,223.373,7.09016,0.344262,227.578,7.47541,0.385246,433,M Muralitharan,0,0,0,0,185,3,20,2,28,13,41,112,134,246,0,265,19,0,10,0.69697,0,5.63636,99.4652,33,0
Sri Lanka,244,223.373,7.09016,0.344262,227.578,7.47541,0.385246,433,BAW Mendis,0,0,0,0,185,3,20,2,28,13,41,112,134,246,0,265,19,0,10,0.447368,0,4.47368,66.4062,38,1
Australia,228,239.627,7.69737,0.372807,232.079,7.23246,0.337719,435,SPD Smith,24,4,20,28,134,7,25,1,0,2,2,46,115,161,0,176,15,0,10,3.19298,0.22807,34.5614,87.0526,57,4
Australia,228,239.627,7.69737,0.372807,232.079,7.23246,0.337719,435,B Lee,4,4,0,3,134,7,25,1,0,2,2,46,115,161,0,176,15,0,10,1.09091,0.0227273,10.8182,81.5068,44,1
Australia,228,239.627,7.69737,0.372807,232.079,7.23246,0.337719,435,SW Tait,0,0,0,0,134,7,25,1,0,2,2,46,115,161,0,176,15,0,10,0.666667,0,4.16667,86.2069,6,1
South Africa,190,234.274,7.4,0.373684,232.363,7.33158,0.342105,436,F du Plessis,36,8,28,44,187,3,32,1,42,16,58,120,157,277,0,284,7,0,10,3.45122,0.292683,34.9268,83.135,82,4
South Africa,190,234.274,7.4,0.373684,232.363,7.33158,0.342105,436,MN van Wyk,1,0,1,1,187,3,32,1,42,16,58,120,157,277,0,284,7,0,10,3.33333,0.266667,27.2,66.9951,15,4
South Africa,190,234.274,7.4,0.373684,232.363,7.33158,0.342105,436,J Botha,0,0,0,0,187,3,32,1,42,16,58,120,157,277,0,284,7,0,10,1.09756,0,11.561,82.2917,41,1
South Africa,190,234.274,7.4,0.373684,232.363,7.33158,0.342105,436,RJ Peterson,0,0,0,0,187,3,32,1,42,16,58,120,157,277,0,284,7,0,10,1.62069,0.0344828,15.7931,83.5766,29,1
South Africa,190,234.274,7.4,0.373684,232.363,7.33158,0.342105,436,WD Parnell,0,0,0,0,187,3,32,1,42,16,58,120,157,277,0,284,7,0,10,1.47826,0.0434783,15.8261,74.7433,23,1
South Africa,190,234.274,7.4,0.373684,232.363,7.33158,0.342105,436,LL Tsotsobe,0,0,0,0,187,3,32,1,42,16,58,120,157,277,0,284,7,0,10,0.444444,0,3.16667,50.8929,18,3
India,259,242.378,7.15058,0.339768,244.568,7.12741,0.30888,438,YK Pathan,2,0,2,4,200,3,24,3,12,16,28,104,148,252,0,268,16,1,10,2.575,0.125,19.975,110.055,40,0
India,259,242.378,7.15058,0.339768,244.568,7.12741,0.30888,438,Harbhajan Singh,0,0,0,0,200,3,24,3,12,16,28,104,148,252,0,268,16,1,10,0.901639,0,9.98361,76.4115,61,1
India,259,242.378,7.15058,0.339768,244.568,7.12741,0.30888,438,R Ashwin,0,0,0,0,200,3,24,3,12,16,28,104,148,252,0,268,16,1,10,1.16364,0.0181818,11.9455,84.7742,55,1
India,259,242.378,7.15058,0.339768,244.568,7.12741,0.30888,438,Z Khan,0,0,0,0,200,3,24,3,12,16,28,104,148,252,0,268,16,1,10,0.974359,0,8.35897,60.9346,39,1
India,259,242.378,7.15058,0.339768,244.568,7.12741,0.30888,438,MM Patel,0,0,0,0,200,3,24,3,12,16,28,104,148,252,0,268,16,1,10,0.363636,0,3.22727,66.9811,22,1
Australia,228,239.627,7.69737,0.372807,232.079,7.23246,0.337719,440,DJ Hussey,18,12,6,12,180,4,33,1,6,30,36,102,147,249,0,260,11,0,10,2.54386,0.245614,29.2105,87.8628,57,4
Australia,228,239.627,7.69737,0.372807,232.079,7.23246,0.337719,440,RT Ponting,94,34,60,111,180,4,33,1,6,30,36,102,147,249,0,260,11,0,10,4.17431,0.33945,38.1009,80.8606,109,4
Australia,228,239.627,7.69737,0.372807,232.079,7.23246,0.337719,440,MG Johnson,0,0,0,0,180,4,33,1,6,30,36,102,147,249,0,260,11,0,10,1.18519,0.0246914,10.7901,94.181,81,0
India,259,242.378,7.15058,0.339768,244.568,7.12741,0.30888,440,SK Raina,19,4,15,22,193,5,27,0,14,6,20,98,142,240,261,261,21,1,10,3.11111,0.216374,28.9064,91.8944,171,0
India,259,242.378,7.15058,0.339768,244.568,7.12741,0.30888,440,Yuvraj Singh,52,28,24,57,193,5,27,0,14,6,20,98,142,240,261,261,21,1,10,4.05833,0.258333,32.525,83.8093,120,4
New Zealand,184,233.745,7.39674,0.36413,227.951,7.30435,0.353261,441,KS Williamson,23,6,17,27,157,5,19,0,12,19,31,72,135,207,0,221,14,0,10,4.31707,0.390244,43.0488,82.8833,82,4
New Zealand,184,233.745,7.39674,0.36413,227.951,7.30435,0.353261,441,NL McCullum,6,0,6,16,157,5,19,0,12,19,31,72,135,207,0,221,14,0,10,1.63934,0.0655738,17.377,85.622,61,0
New Zealand,184,233.745,7.39674,0.36413,227.951,7.30435,0.353261,441,JDP Oram,0,0,0,0,157,5,19,0,12,19,31,72,135,207,0,221,14,0,10,2.70833,0.1875,25.0417,95.8533,48,0
New Zealand,184,233.745,7.39674,0.36413,227.951,7.30435,0.353261,441,DL Vettori,0,0,0,0,157,5,19,0,12,19,31,72,135,207,0,221,14,0,10,1.43662,0.028169,15.7606,86.0108,71,0
New Zealand,184,233.745,7.39674,0.36413,227.951,7.30435,0.353261,441,LJ Woodcock,0,0,0,0,157,5,19,0,12,19,31,72,135,207,0,221,14,0,10,0.5,0,6.5,59.0909,2,3
New Zealand,184,233.745,7.39674,0.36413,227.951,7.30435,0.353261,442,NL McCullum,9,6,3,8,158,4,35,1,4,8,12,76,129,205,0,217,12,0,10,1.63934,0.0655738,17.377,85.622,61,0
New Zealand,184,233.745,7.39674,0.36413,227.951,7.30435,0.353261,442,JDP Oram,0,0,0,0,158,4,35,1,4,8,12,76,129,205,0,217,12,0,10,2.70833,0.1875,25.0417,95.8533,48,0
New Zealand,184,233.745,7.39674,0.36413,227.951,7.30435,0.353261,442,SB Styris,55,20,35,73,158,4,35,1,4,8,12,76,129,205,0,217,12,0,10,3.20755,0.264151,33.8302,78.7094,53,4
New Zealand,184,233.745,7.39674,0.36413,227.951,7.30435,0.353261,442,DL Vettori,0,0,0,0,158,4,35,1,4,8,12,76,129,205,0,217,12,0,10,1.43662,0.028169,15.7606,86.0108,71,0
New Zealand,184,233.745,7.39674,0.36413,227.951,7.30435,0.353261,442,TG Southee,0,0,0,0,158,4,35,1,4,8,12,76,129,205,0,217,12,0,10,0.764706,0,7.03922,92.7649,51,0
Sri Lanka,244,223.373,7.09016,0.344262,227.578,7.47541,0.385246,442,AD Mathews,1,0,1,6,167,4,22,1,14,5,19,132,76,208,218,220,12,1,10,2.64122,0.198473,28.6794,82.3362,131,4
Sri Lanka,244,223.373,7.09016,0.344262,227.578,7.47541,0.385246,442,TT Samaraweera,17,8,9,33,167,4,22,1,14,5,19,132,76,208,218,220,12,1,10,2.19231,0.0769231,23.4231,73.8182,26,4
India,259,242.378,7.15058,0.339768,244.568,7.12741,0.30888,443,SK Raina,14,0,14,25,189,5,17,1,20,16,36,120,122,242,0,260,18,1,10,3.11111,0.216374,28.9064,91.8944,171,0
India,259,242.378,7.15058,0.339768,244.568,7.12741,0.30888,443,Harbhajan Singh,8,4,4,14,189,5,17,1,20,16,36,120,122,242,0,260,18,1,10,0.901639,0,9.98361,76.4115,61,1
India,259,242.378,7.15058,0.339768,244.568,7.12741,0.30888,443,Z Khan,0,0,0,0,189,5,17,1,20,16,36,120,122,242,0,260,18,1,10,0.974359,0,8.35897,60.9346,39,1
India,259,242.378,7.15058,0.339768,244.568,7.12741,0.30888,443,A Nehra,0,0,0,0,189,5,17,1,20,16,36,120,122,242,0,260,18,1,10,0.263158,0,2.84211,43.2,19,3
Pakistan,211,222.621,7.38389,0.393365,235.517,7.54976,0.336493,443,Misbah-ul-Haq,33,8,25,55,175,6,22,2,18,8,26,98,125,223,261,231,8,0,10,2.95238,0.285714,34.9921,71.8195,126,4
Pakistan,211,222.621,7.38389,0.393365,235.517,7.54976,0.336493,443,Umar Gul,0,0,0,0,175,6,22,2,18,8,26,98,125,223,261,231,8,0,10,0.77193,0,7.14035,68.2886,57,1
Pakistan,211,222.621,7.38389,0.393365,235.517,7.54976,0.336493,443,Saeed Ajmal,0,0,0,0,175,6,22,2,18,8,26,98,125,223,261,231,8,0,10,0.34375,0,4.60938,58.3004,64,3
Sri Lanka,244,223.373,7.09016,0.344262,227.578,7.47541,0.385246,444,KMDN Kulasekara,16,0,16,21,173,5,27,0,44,18,62,120,142,262,0,274,12,0,10,1.21,0.04,11.8,80.9328,100,1
Sri Lanka,244,223.373,7.09016,0.344262,227.578,7.47541,0.385246,444,DPMD Jayawardene,79,36,43,78,173,5,27,0,44,18,62,120,142,262,0,274,12,0,10,3.20833,0.244792,31.6979,79.1109,192,4
Sri Lanka,244,223.373,7.09016,0.344262,227.578,7.47541,0.385246,444,NLTC Perera,0,0,0,0,173,5,27,0,44,18,62,120,142,262,0,274,12,0,10,1.65333,0.0666667,14.32,105.397,75,0
India,259,242.378,7.15058,0.339768,244.568,7.12741,0.30888,444,Yuvraj Singh,9,4,5,11,208,3,22,1,22,10,32,112,150,262,275,277,15,1,10,4.05833,0.258333,32.525,83.8093,120,4
India,259,242.378,7.15058,0.339768,244.568,7.12741,0.30888,444,MS Dhoni,71,26,45,73,208,3,22,1,22,10,32,112,150,262,275,277,15,1,10,3.47872,0.292553,36.7713,84.1612,188,4
Bangladesh,160,218.438,7.70625,0.4,211.106,7.05,0.325,445,Mohammad Ashraful,60,16,44,85,154,5,35,0,34,19,53,98,144,242,0,260,18,1,10,2.17722,0.113924,19.4557,63.9085,79,1
Bangladesh,160,218.438,7.70625,0.4,211.106,7.05,0.325,445,Mahmudullah,30,8,22,42,154,5,35,0,34,19,53,98,144,242,0,260,18,1,10,2.26531,0.153061,24.4286,70.9544,98,4
Bangladesh,160,218.438,7.70625,0.4,211.106,7.05,0.325,445,Naeem Islam,0,0,0,0,154,5,35,0,34,19,53,98,144,242,0,260,18,1,10,1.88889,0.111111,18.6889,67.496,45,1
Bangladesh,160,218.438,7.70625,0.4,211.106,7.05,0.325,445,Abdur Razzak,0,0,0,0,154,5,35,0,34,19,53,98,144,242,0,260,18,1,10,0.849315,0.0136986,8.39726,73.8554,73,1
India,259,242.378,7.15058,0.339768,244.568,7.12741,0.30888,446,SK Raina,33,16,17,46,198,5,41,0,0,18,18,126,131,257,0,279,22,0,10,3.11111,0.216374,28.9064,91.8944,171,0
India,259,242.378,7.15058,0.339768,244.568,7.12741,0.30888,446,RA Jadeja,31,18,13,22,198,5,41,0,0,18,18,126,131,257,0,279,22,0,10,2.12941,0.117647,21.7529,82.4342,85,4
India,259,242.378,7.15058,0.339768,244.568,7.12741,0.30888,446,Harbhajan Singh,0,0,0,0,198,5,41,0,0,18,18,126,131,257,0,279,22,0,10,0.901639,0,9.98361,76.4115,61,1
India,259,242.378,7.15058,0.339768,244.568,7.12741,0.30888,446,Z Khan,0,0,0,0,198,5,41,0,0,18,18,126,131,257,0,279,22,0,10,0.974359,0,8.35897,60.9346,39,1
India,259,242.378,7.15058,0.339768,244.568,7.12741,0.30888,446,A Nehra,0,0,0,0,198,5,41,0,0,18,18,126,131,257,0,279,22,0,10,0.263158,0,2.84211,43.2,19,3
India,259,242.378,7.15058,0.339768,244.568,7.12741,0.30888,446,S Sreesanth,0,0,0,0,198,5,41,0,0,18,18,126,131,257,0,279,22,0,10,0.125,0,2.4375,32.5,16,3
Sri Lanka,244,223.373,7.09016,0.344262,227.578,7.47541,0.385246,446,TT Samaraweera,98,40,58,102,199,3,27,2,30,9,39,126,139,265,280,283,18,0,10,2.19231,0.0769231,23.4231,73.8182,26,4
Sri Lanka,244,223.373,7.09016,0.344262,227.578,7.47541,0.385246,446,NLTC Perera,4,4,0,1,199,3,27,2,30,9,39,126,139,265,280,283,18,0,10,1.65333,0.0666667,14.32,105.397,75,0
Bangladesh,160,218.438,7.70625,0.4,211.106,7.05,0.325,447,Mahmudullah,20,4,16,27,186,5,34,1,28,23,51,126,145,271,0,296,25,1,10,2.26531,0.153061,24.4286,70.9544,98,4
Bangladesh,160,218.438,7.70625,0.4,211.106,7.05,0.325,447,Naeem Islam,3,0,3,3,186,5,34,1,28,23,51,126,145,271,0,296,25,1,10,1.88889,0.111111,18.6889,67.496,45,1
India,259,242.378,7.15058,0.339768,244.568,7.12741,0.30888,447,MS Dhoni,94,32,62,102,220,4,30,0,14,11,25,106,169,275,297,297,22,0,10,3.47872,0.292553,36.7713,84.1612,188,4
India,259,242.378,7.15058,0.339768,244.568,7.12741,0.30888,447,SK Raina,33,16,17,36,220,4,30,0,14,11,25,106,169,275,297,297,22,0,10,3.11111,0.216374,28.9064,91.8944,171,0
Bangladesh,160,218.438,7.70625,0.4,211.106,7.05,0.325,448,Mahmudullah,10,4,6,9,167,4,47,3,8,13,21,92,143,235,0,249,14,1,10,2.26531,0.153061,24.4286,70.9544,98,4
Bangladesh,160,218.438,7.70625,0.4,211.106,7.05,0.325,448,Rubel Hossain,0,0,0,0,167,4,47,3,8,13,21,92,143,235,0,249,14,1,10,0.32,0,2.68,52.3438,25,3
Bangladesh,160,218.438,7.70625,0.4,211.106,7.05,0.325,448,Syed Rasel,0,0,0,0,167,4,47,3,8,13,21,92,143,235,0,249,14,1,10,0.222222,0,2.88889,37.6812,18,3
Bangladesh,160,218.438,7.70625,0.4,211.106,7.05,0.325,450,Mahmudullah,43,16,27,66,145,5,48,0,24,19,43,118,118,236,0,247,11,1,10,2.26531,0.153061,24.4286,70.9544,98,4
Bangladesh,160,218.438,7.70625,0.4,211.106,7.05,0.325,450,Shakib Al Hasan,85,38,47,97,145,5,48,0,24,19,43,118,118,236,0,247,11,1,10,2.86992,0.252033,29.9106,79.0163,123,4
Bangladesh,160,218.438,7.70625,0.4,211.106,7.05,0.325,450,Naeem Islam,0,0,0,0,145,5,48,0,24,19,43,118,118,236,0,247,11,1,10,1.88889,0.111111,18.6889,67.496,45,1
Zimbabwe,142,212.077,7.5,0.380282,227.704,6.97887,0.316901,451,E Chigumbura,24,10,14,20,169,3,33,0,22,14,36,88,150,238,0,254,16,0,10,2.28947,0.114035,22.7895,77.7844,114,4
Zimbabwe,142,212.077,7.5,0.380282,227.704,6.97887,0.316901,451,V Sibanda,80,12,68,154,169,3,33,0,22,14,36,88,150,238,0,254,16,0,10,2.9697,0.181818,23.5152,63.5545,66,1
Zimbabwe,142,212.077,7.5,0.380282,227.704,6.97887,0.316901,451,S Matsikenyeri,0,0,0,0,169,3,33,0,22,14,36,88,150,238,0,254,16,0,10,2,0.106383,19.9787,75.7869,47,1
Zimbabwe,142,212.077,7.5,0.380282,227.704,6.97887,0.316901,451,GA Lamb,0,0,0,0,169,3,33,0,22,14,36,88,150,238,0,254,16,0,10,0.333333,0,14.0833,46.1749,12,3
West Indies,176,217.33,7.15909,0.3125,225.278,7.57386,0.380682,451,S Chanderpaul,48,12,36,60,162,4,23,1,24,21,45,88,142,230,255,252,22,1,10,3.57143,0.396825,40.8254,68.0783,63,4
West Indies,176,217.33,7.15909,0.3125,225.278,7.57386,0.380682,451,D Ramdin,2,0,2,8,162,4,23,1,24,21,45,88,142,230,255,252,22,1,10,1.7439,0.097561,19.1951,81.1759,82,1
West Indies,176,217.33,7.15909,0.3125,225.278,7.57386,0.380682,451,DR Smith,0,0,0,0,162,4,23,1,24,21,45,88,142,230,255,252,22,1,10,2.5,0.12,17.96,84.5574,50,1
West Indies,176,217.33,7.15909,0.3125,225.278,7.57386,0.380682,451,NO Miller,0,0,0,0,162,4,23,1,24,21,45,88,142,230,255,252,22,1,10,1,0.0416667,10.3333,79.2332,24,1
West Indies,176,217.33,7.15909,0.3125,225.278,7.57386,0.380682,451,SJ Benn,0,0,0,0,162,4,23,1,24,21,45,88,142,230,255,252,22,1,10,0.8,0,6.75,72.973,20,1
West Indies,176,217.33,7.15909,0.3125,225.278,7.57386,0.380682,451,KAJ Roach,0,0,0,0,162,4,23,1,24,21,45,88,142,230,255,252,22,1,10,0.526316,0,5.68421,50.5855,38,3
Zimbabwe,142,212.077,7.5,0.380282,227.704,6.97887,0.316901,452,E Chigumbura,50,20,30,72,149,5,23,1,10,13,23,80,115,195,0,206,11,0,10,2.28947,0.114035,22.7895,77.7844,114,4
Zimbabwe,142,212.077,7.5,0.380282,227.704,6.97887,0.316901,452,P Utseya,0,0,0,0,149,5,23,1,10,13,23,80,115,195,0,206,11,0,10,0.842105,0.0263158,11.8289,55.8385,76,3
Zimbabwe,142,212.077,7.5,0.380282,227.704,6.97887,0.316901,452,AG Cremer,0,0,0,1,149,5,23,1,10,13,23,80,115,195,0,206,11,0,10,0.766667,0,10.5,54.6875,30,3
Zimbabwe,142,212.077,7.5,0.380282,227.704,6.97887,0.316901,452,RW Price,0,0,0,0,149,5,23,1,10,13,23,80,115,195,0,206,11,0,10,0.666667,0,7.16667,57.2062,36,3
West Indies,176,217.33,7.15909,0.3125,225.278,7.57386,0.380682,452,DJG Sammy,1,0,1,2,131,4,38,2,8,10,18,84,103,187,207,208,21,1,10,2.25,0.09,18.25,95.8005,100,0
West Indies,176,217.33,7.15909,0.3125,225.278,7.57386,0.380682,452,N Deonarine,55,26,29,78,131,4,38,2,8,10,18,84,103,187,207,208,21,1,10,2.09091,0.136364,20.9545,65.7632,22,1
West Indies,176,217.33,7.15909,0.3125,225.278,7.57386,0.380682,453,N Deonarine,21,10,11,20,147,4,39,0,20,24,44,74,156,230,0,245,15,1,10,2.09091,0.136364,20.9545,65.7632,22,1
West Indies,176,217.33,7.15909,0.3125,225.278,7.57386,0.380682,453,KA Pollard,0,0,0,0,147,4,39,0,20,24,44,74,156,230,0,245,15,1,10,2.70513,0.115385,24.5,88.0645,78,4
West Indies,176,217.33,7.15909,0.3125,225.278,7.57386,0.380682,453,DJ Bravo,20,4,16,17,147,4,39,0,20,24,44,74,156,230,0,245,15,1,10,2.35514,0.11215,23.1589,80.9011,107,4
West Indies,176,217.33,7.15909,0.3125,225.278,7.57386,0.380682,453,DJG Sammy,0,0,0,0,147,4,39,0,20,24,44,74,156,230,0,245,15,1,10,2.25,0.09,18.25,95.8005,100,0
West Indies,176,217.33,7.15909,0.3125,225.278,7.57386,0.380682,453,R Rampaul,0,0,0,0,147,4,39,0,20,24,44,74,156,230,0,245,15,1,10,1.30303,0.030303,9.90909,77.4882,33,1
West Indies,176,217.33,7.15909,0.3125,225.278,7.57386,0.380682,453,NO Miller,0,0,0,0,147,4,39,0,20,24,44,74,156,230,0,245,15,1,10,1,0.0416667,10.3333,79.2332,24,1
West Indies,176,217.33,7.15909,0.3125,225.278,7.57386,0.380682,453,KAJ Roach,0,0,0,0,147,4,39,0,20,24,44,74,156,230,0,245,15,1,10,0.526316,0,5.68421,50.5855,38,3
Zimbabwe,142,212.077,7.5,0.380282,227.704,6.97887,0.316901,454,AG Cremer,15,0,15,39,86,7,19,1,8,2,10,42,73,115,0,141,26,0,10,0.766667,0,10.5,54.6875,30,3
Zimbabwe,142,212.077,7.5,0.380282,227.704,6.97887,0.316901,454,P Utseya,0,0,0,4,86,7,19,1,8,2,10,42,73,115,0,141,26,0,10,0.842105,0.0263158,11.8289,55.8385,76,3
Zimbabwe,142,212.077,7.5,0.380282,227.704,6.97887,0.316901,454,RW Price,0,0,0,0,86,7,19,1,8,2,10,42,73,115,0,141,26,0,10,0.666667,0,7.16667,57.2062,36,3
Zimbabwe,142,212.077,7.5,0.380282,227.704,6.97887,0.316901,455,AG Cremer,9,4,5,13,103,6,19,2,4,11,15,40,97,137,0,161,24,0,10,0.766667,0,10.5,54.6875,30,3
Zimbabwe,142,212.077,7.5,0.380282,227.704,6.97887,0.316901,455,P Utseya,6,0,6,14,103,6,19,2,4,11,15,40,97,137,0,161,24,0,10,0.842105,0.0263158,11.8289,55.8385,76,3
Zimbabwe,142,212.077,7.5,0.380282,227.704,6.97887,0.316901,455,RW Price,0,0,0,0,103,6,19,2,4,11,15,40,97,137,0,161,24,0,10,0.666667,0,7.16667,57.2062,36,3
South Africa,190,234.274,7.4,0.373684,232.363,7.33158,0.342105,456,J Botha,2,0,2,5,219,3,31,2,4,13,17,94,173,267,0,280,13,0,10,1.09756,0,11.561,82.2917,41,1
South Africa,190,234.274,7.4,0.373684,232.363,7.33158,0.342105,456,DA Miller,10,6,4,7,219,3,31,2,4,13,17,94,173,267,0,280,13,0,10,2.57353,0.132353,24.9412,97.2477,68,0
South Africa,190,234.274,7.4,0.373684,232.363,7.33158,0.342105,456,R McLaren,0,0,0,0,219,3,31,2,4,13,17,94,173,267,0,280,13,0,10,1.2,0.025,11.975,69.8251,40,1
South Africa,190,234.274,7.4,0.373684,232.363,7.33158,0.342105,456,DW Steyn,0,0,0,0,219,3,31,2,4,13,17,94,173,267,0,280,13,0,10,0.75,0,6.52273,61.588,44,1
South Africa,190,234.274,7.4,0.373684,232.363,7.33158,0.342105,457,DA Miller,4,0,4,7,220,2,26,1,20,24,44,86,204,290,0,300,10,0,10,2.57353,0.132353,24.9412,97.2477,68,0
South Africa,190,234.274,7.4,0.373684,232.363,7.33158,0.342105,457,JH Kallis,72,12,60,82,220,2,26,1,20,24,44,86,204,290,0,300,10,0,10,3.58621,0.356322,37.2644,76.4442,87,4
South Africa,190,234.274,7.4,0.373684,232.363,7.33158,0.342105,457,AN Petersen,0,0,0,0,220,2,26,1,20,24,44,86,204,290,0,300,10,0,10,3.11111,0.222222,27.6667,81.6393,18,4
South Africa,190,234.274,7.4,0.373684,232.363,7.33158,0.342105,457,R McLaren,0,0,0,0,220,2,26,1,20,24,44,86,204,290,0,300,10,0,10,1.2,0.025,11.975,69.8251,40,1
West Indies,176,217.33,7.15909,0.3125,225.278,7.57386,0.380682,457,DJG Sammy,30,24,6,13,181,5,51,3,20,12,32,122,142,264,301,283,19,1,10,2.25,0.09,18.25,95.8005,100,0
West Indies,176,217.33,7.15909,0.3125,225.278,7.57386,0.380682,457,R Rampaul,1,0,1,2,181,5,51,3,20,12,32,122,142,264,301,283,19,1,10,1.30303,0.030303,9.90909,77.4882,33,1
West Indies,176,217.33,7.15909,0.3125,225.278,7.57386,0.380682,457,NO Miller,0,0,0,0,181,5,51,3,20,12,32,122,142,264,301,283,19,1,10,1,0.0416667,10.3333,79.2332,24,1
South Africa,190,234.274,7.4,0.373684,232.363,7.33158,0.342105,458,J Botha,16,0,16,19,195,5,16,3,4,7,11,64,158,222,0,224,2,0,10,1.09756,0,11.561,82.2917,41,1
South Africa,190,234.274,7.4,0.373684,232.363,7.33158,0.342105,458,M Morkel,5,4,1,5,195,5,16,3,4,7,11,64,158,222,0,224,2,0,10,0.6,0,5.28571,72.2656,35,1
West Indies,176,217.33,7.15909,0.3125,225.278,7.57386,0.380682,459,DM Bravo,27,10,17,22,195,3,37,1,28,24,52,114,170,284,0,303,19,1,10,3,0.226667,28.52,67.4551,75,4
West Indies,176,217.33,7.15909,0.3125,225.278,7.57386,0.380682,459,KA Pollard,5,0,5,9,195,3,37,1,28,24,52,114,170,284,0,303,19,1,10,2.70513,0.115385,24.5,88.0645,78,4
West Indies,176,217.33,7.15909,0.3125,225.278,7.57386,0.380682,459,DJG Sammy,0,0,0,0,195,3,37,1,28,24,52,114,170,284,0,303,19,1,10,2.25,0.09,18.25,95.8005,100,0
West Indies,176,217.33,7.15909,0.3125,225.278,7.57386,0.380682,459,DE Bernard,0,0,0,0,195,3,37,1,28,24,52,114,170,284,0,303,19,1,10,1,0,13.4,63.5071,10,1
South Africa,190,234.274,7.4,0.373684,232.363,7.33158,0.342105,459,JP Duminy,16,0,16,24,230,3,24,0,16,22,38,86,206,292,304,304,12,0,10,2.3252,0.186992,29.9675,80.2351,123,4
South Africa,190,234.274,7.4,0.373684,232.363,7.33158,0.342105,459,AB de Villiers,35,0,35,48,230,3,24,0,16,22,38,86,206,292,304,304,12,0,10,5.04969,0.403727,47.2174,98.8428,161,4
India,259,242.378,7.15058,0.339768,244.568,7.12741,0.30888,460,RA Jadeja,19,4,15,19,219,6,33,1,10,16,26,136,142,278,0,298,20,1,10,2.12941,0.117647,21.7529,82.4342,85,4
India,259,242.378,7.15058,0.339768,244.568,7.12741,0.30888,460,P Kumar,6,0,6,5,219,6,33,1,10,16,26,136,142,278,0,298,20,1,10,1,0.03125,9.03125,86.0119,32,1
India,259,242.378,7.15058,0.339768,244.568,7.12741,0.30888,460,A Nehra,0,0,0,0,219,6,33,1,10,16,26,136,142,278,0,298,20,1,10,0.263158,0,2.84211,43.2,19,3
South Africa,190,234.274,7.4,0.373684,232.363,7.33158,0.342105,460,WD Parnell,23,4,19,33,195,7,31,1,40,18,58,128,156,284,299,297,13,0,10,1.47826,0.0434783,15.8261,74.7433,23,1
South Africa,190,234.274,7.4,0.373684,232.363,7.33158,0.342105,460,DW Steyn,7,0,7,5,195,7,31,1,40,18,58,128,156,284,299,297,13,0,10,0.75,0,6.52273,61.588,44,1
South Africa,190,234.274,7.4,0.373684,232.363,7.33158,0.342105,460,CK Langeveldt,0,0,0,0,195,7,31,1,40,18,58,128,156,284,299,297,13,0,10,0.571429,0,4.71429,59.4595,14,3
India,259,242.378,7.15058,0.339768,244.568,7.12741,0.30888,461,MS Dhoni,17,8,9,13,278,2,54,1,44,16,60,236,156,392,0,401,9,1,10,3.47872,0.292553,36.7713,84.1612,188,4
India,259,242.378,7.15058,0.339768,244.568,7.12741,0.30888,461,SR Tendulkar,191,118,73,142,278,2,54,1,44,16,60,236,156,392,0,401,9,1,10,5.89773,0.363636,45.6023,84.5376,88,4
South Africa,190,234.274,7.4,0.373684,232.363,7.33158,0.342105,462,JH Kallis,69,12,57,81,240,2,43,0,58,20,78,184,177,361,0,365,4,0,10,3.58621,0.356322,37.2644,76.4442,87,4
South Africa,190,234.274,7.4,0.373684,232.363,7.33158,0.342105,462,AB de Villiers,59,30,29,42,240,2,43,0,58,20,78,184,177,361,0,365,4,0,10,5.04969,0.403727,47.2174,98.8428,161,4
Australia,228,239.627,7.69737,0.372807,232.079,7.23246,0.337719,463,MG Johnson,10,0,10,16,173,5,25,1,4,27,31,56,173,229,0,239,10,1,10,1.18519,0.0246914,10.7901,94.181,81,0
Australia,228,239.627,7.69737,0.372807,232.079,7.23246,0.337719,463,JW Hastings,0,0,0,0,173,5,25,1,4,27,31,56,173,229,0,239,10,1,10,1.76923,0,13.8462,95.2381,13,0
Australia,228,239.627,7.69737,0.372807,232.079,7.23246,0.337719,463,MEK Hussey,59,4,55,81,173,5,25,1,4,27,31,56,173,229,0,239,10,1,10,2.7563,0.260504,34.084,82.4893,119,4
Australia,228,239.627,7.69737,0.372807,232.079,7.23246,0.337719,463,XJ Doherty,0,0,0,0,173,5,25,1,4,27,31,56,173,229,0,239,10,1,10,0.190476,0,4.28571,52.0231,21,3
England,221,237.176,7.17647,0.289593,230.633,7.45701,0.384615,466,TT Bresnan,21,12,9,20,223,6,28,1,16,10,26,114,163,277,0,294,17,0,10,1.52381,0.015873,13.8095,88.4146,63,0
England,221,237.176,7.17647,0.289593,230.633,7.45701,0.384615,466,GP Swann,1,0,1,4,223,6,28,1,16,10,26,114,163,277,0,294,17,0,10,1.08696,0,10.3043,90.631,46,0
England,221,237.176,7.17647,0.289593,230.633,7.45701,0.384615,466,A Shahzad,0,0,0,0,223,6,28,1,16,10,26,114,163,277,0,294,17,0,10,0.375,0,4.875,62.9032,8,1
England,221,237.176,7.17647,0.289593,230.633,7.45701,0.384615,466,CT Tremlett,0,0,0,0,223,6,28,1,16,10,26,114,163,277,0,294,17,0,10,0.4,0,4.2,57.5342,10,3
Australia,228,239.627,7.69737,0.372807,232.079,7.23246,0.337719,466,CL White,5,0,5,9,216,3,32,1,18,21,39,118,169,287,295,297,10,1,10,2.66176,0.191176,28.8235,80.1308,68,4
Australia,228,239.627,7.69737,0.372807,232.079,7.23246,0.337719,466,SR Watson,142,62,80,139,216,3,32,1,18,21,39,118,169,287,295,297,10,1,10,4.71318,0.286822,37.7907,90.0943,129,4
Australia,228,239.627,7.69737,0.372807,232.079,7.23246,0.337719,467,DE Bollinger,27,12,15,23,145,8,58,0,4,8,12,80,135,215,0,230,15,1,10,0.714286,0,7.14286,92.5926,7,0
Australia,228,239.627,7.69737,0.372807,232.079,7.23246,0.337719,467,SE Marsh,101,40,61,107,145,8,58,0,4,8,12,80,135,215,0,230,15,1,10,3.66667,0.291667,35.5417,74.7918,48,4
England,221,237.176,7.17647,0.289593,230.633,7.45701,0.384615,468,IJL Trott,76,12,64,114,167,6,24,2,0,13,13,40,164,204,0,214,10,0,10,3.3871,0.403226,43.7903,75.2494,62,4
England,221,237.176,7.17647,0.289593,230.633,7.45701,0.384615,468,A Shahzad,0,0,0,1,167,6,24,2,0,13,13,40,164,204,0,214,10,0,10,0.375,0,4.875,62.9032,8,1
England,221,237.176,7.17647,0.289593,230.633,7.45701,0.384615,468,CT Tremlett,0,0,0,0,167,6,24,2,0,13,13,40,164,204,0,214,10,0,10,0.4,0,4.2,57.5342,10,3
Australia,228,239.627,7.69737,0.372807,232.079,7.23246,0.337719,468,DJ Hussey,63,26,37,85,162,6,28,0,4,3,7,94,103,197,215,215,18,1,10,2.54386,0.245614,29.2105,87.8628,57,4
Australia,228,239.627,7.69737,0.372807,232.079,7.23246,0.337719,468,JW Hastings,16,4,12,34,162,6,28,0,4,3,7,94,103,197,215,215,18,1,10,1.76923,0,13.8462,95.2381,13,0
Australia,228,239.627,7.69737,0.372807,232.079,7.23246,0.337719,469,MG Johnson,16,8,8,19,173,5,24,1,22,13,35,108,124,232,0,249,17,1,10,1.18519,0.0246914,10.7901,94.181,81,0
Australia,228,239.627,7.69737,0.372807,232.079,7.23246,0.337719,469,JW Hastings,0,0,0,0,173,5,24,1,22,13,35,108,124,232,0,249,17,1,10,1.76923,0,13.8462,95.2381,13,0
Australia,228,239.627,7.69737,0.372807,232.079,7.23246,0.337719,469,SPD Smith,8,0,8,16,173,5,24,1,22,13,35,108,124,232,0,249,17,1,10,3.19298,0.22807,34.5614,87.0526,57,4
Australia,228,239.627,7.69737,0.372807,232.079,7.23246,0.337719,469,B Lee,0,0,0,0,173,5,24,1,22,13,35,108,124,232,0,249,17,1,10,1.09091,0.0227273,10.8182,81.5068,44,1
Australia,228,239.627,7.69737,0.372807,232.079,7.23246,0.337719,469,DE Bollinger,0,0,0,0,173,5,24,1,22,13,35,108,124,232,0,249,17,1,10,0.714286,0,7.14286,92.5926,7,0
England,221,237.176,7.17647,0.289593,230.633,7.45701,0.384615,469,ST Finn,29,20,9,21,151,9,28,0,6,0,6,80,105,185,250,198,13,0,10,0.583333,0,5.41667,59.633,24,3
England,221,237.176,7.17647,0.289593,230.633,7.45701,0.384615,470,IJL Trott,122,40,82,114,234,3,43,0,16,27,43,116,204,320,0,333,13,0,10,3.3871,0.403226,43.7903,75.2494,62,4
England,221,237.176,7.17647,0.289593,230.633,7.45701,0.384615,470,IR Bell,45,20,25,33,234,3,43,0,16,27,43,116,204,320,0,333,13,0,10,3.63433,0.246269,35.3806,75.6623,134,4
England,221,237.176,7.17647,0.289593,230.633,7.45701,0.384615,470,EJG Morgan,0,0,0,0,234,3,43,0,16,27,43,116,204,320,0,333,13,0,10,3.19549,0.233083,30.0526,86.9291,133,4
England,221,237.176,7.17647,0.289593,230.633,7.45701,0.384615,470,PD Collingwood,0,0,0,0,234,3,43,0,16,27,43,116,204,320,0,333,13,0,10,2.62366,0.193548,30.5161,76.8065,93,4
Australia,228,239.627,7.69737,0.372807,232.079,7.23246,0.337719,470,DJ Hussey,24,4,20,29,243,5,44,0,18,18,36,114,209,323,334,334,11,1,10,2.54386,0.245614,29.2105,87.8628,57,4
Australia,228,239.627,7.69737,0.372807,232.079,7.23246,0.337719,470,MJ Clarke,69,18,51,63,243,5,44,0,18,18,36,114,209,323,334,334,11,1,10,3.10294,0.301471,35.9265,74.0303,136,4
Australia,228,239.627,7.69737,0.372807,232.079,7.23246,0.337719,470,SPD Smith,0,0,0,0,243,5,44,0,18,18,36,114,209,323,334,334,11,1,10,3.19298,0.22807,34.5614,87.0526,57,4
Australia,228,239.627,7.69737,0.372807,232.079,7.23246,0.337719,470,JW Hastings,0,0,0,0,243,5,44,0,18,18,36,114,209,323,334,334,11,1,10,1.76923,0,13.8462,95.2381,13,0
Australia,228,239.627,7.69737,0.372807,232.079,7.23246,0.337719,470,B Lee,0,0,0,0,243,5,44,0,18,18,36,114,209,323,334,334,11,1,10,1.09091,0.0227273,10.8182,81.5068,44,1
Australia,228,239.627,7.69737,0.372807,232.079,7.23246,0.337719,471,MG Johnson,18,4,14,19,181,5,25,0,8,35,43,80,169,249,0,279,30,1,10,1.18519,0.0246914,10.7901,94.181,81,0
Australia,228,239.627,7.69737,0.372807,232.079,7.23246,0.337719,471,AC Voges,57,16,41,58,181,5,25,0,8,35,43,80,169,249,0,279,30,1,10,2.29167,0.125,29.625,84.142,24,4
Australia,228,239.627,7.69737,0.372807,232.079,7.23246,0.337719,471,JW Hastings,0,0,0,0,181,5,25,0,8,35,43,80,169,249,0,279,30,1,10,1.76923,0,13.8462,95.2381,13,0
Ireland,55,219.527,7.65455,0.290909,202.727,7.56364,0.4,472,WB Rankin,3,0,3,8,140,6,31,3,0,5,5,74,102,176,0,189,13,1,10,0.0833333,0,3.08333,35.9223,12,3
Ireland,55,219.527,7.65455,0.290909,202.727,7.56364,0.4,472,GH Dockrell,3,0,3,4,140,6,31,3,0,5,5,74,102,176,0,189,13,1,10,0.875,0,9.0625,69.7115,16,1
India,259,242.378,7.15058,0.339768,244.568,7.12741,0.30888,476,RA Jadeja,36,8,28,46,149,4,46,0,42,19,61,98,158,256,0,285,29,0,10,2.12941,0.117647,21.7529,82.4342,85,4
India,259,242.378,7.15058,0.339768,244.568,7.12741,0.30888,476,RG Sharma,89,28,61,110,149,4,46,0,42,19,61,98,158,256,0,285,29,0,10,3.82836,0.268657,35.9179,83.083,134,4
India,259,242.378,7.15058,0.339768,244.568,7.12741,0.30888,476,YK Pathan,0,0,0,0,149,4,46,0,42,19,61,98,158,256,0,285,29,0,10,2.575,0.125,19.975,110.055,40,0
Zimbabwe,142,212.077,7.5,0.380282,227.704,6.97887,0.316901,476,E Chigumbura,4,0,4,6,193,3,43,1,28,13,41,108,169,277,286,289,12,1,10,2.28947,0.114035,22.7895,77.7844,114,4
Zimbabwe,142,212.077,7.5,0.380282,227.704,6.97887,0.316901,476,CR Ervine,46,8,38,52,193,3,43,1,28,13,41,108,169,277,286,289,12,1,10,3.06667,0.2,30.5333,73.9903,30,4
Sri Lanka,244,223.373,7.09016,0.344262,227.578,7.47541,0.385246,477,NLTC Perera,30,14,16,20,152,5,46,0,16,21,37,78,157,235,0,242,7,0,10,1.65333,0.0666667,14.32,105.397,75,0
Sri Lanka,244,223.373,7.09016,0.344262,227.578,7.47541,0.385246,477,KMDN Kulasekara,0,0,0,0,152,5,46,0,16,21,37,78,157,235,0,242,7,0,10,1.21,0.04,11.8,80.9328,100,1
Sri Lanka,244,223.373,7.09016,0.344262,227.578,7.47541,0.385246,477,AD Mathews,62,14,48,88,152,5,46,0,16,21,37,78,157,235,0,242,7,0,10,2.64122,0.198473,28.6794,82.3362,131,4
Sri Lanka,244,223.373,7.09016,0.344262,227.578,7.47541,0.385246,477,S Randiv,0,0,0,0,152,5,46,0,16,21,37,78,157,235,0,242,7,0,10,1.6875,0.0625,15.875,69.9725,16,1
Sri Lanka,244,223.373,7.09016,0.344262,227.578,7.47541,0.385246,477,BAW Mendis,0,0,0,0,152,5,46,0,16,21,37,78,157,235,0,242,7,0,10,0.447368,0,4.47368,66.4062,38,1
India,259,242.378,7.15058,0.339768,244.568,7.12741,0.30888,478,PP Ojha,0,0,0,0,134,7,31,1,0,15,15,54,126,180,0,194,14,0,10,0.333333,0,5.11111,40.3509,9,3
India,259,242.378,7.15058,0.339768,244.568,7.12741,0.30888,478,RA Jadeja,46,24,22,63,134,7,31,1,0,15,15,54,126,180,0,194,14,0,10,2.12941,0.117647,21.7529,82.4342,85,4
India,259,242.378,7.15058,0.339768,244.568,7.12741,0.30888,478,UT Yadav,0,0,0,0,134,7,31,1,0,15,15,54,126,180,0,194,14,0,10,0.533333,0,3.46667,56.5217,15,3
India,259,242.378,7.15058,0.339768,244.568,7.12741,0.30888,479,R Ashwin,7,0,7,15,191,5,23,1,26,16,42,114,142,256,0,268,12,0,10,1.16364,0.0181818,11.9455,84.7742,55,1
India,259,242.378,7.15058,0.339768,244.568,7.12741,0.30888,479,RA Jadeja,16,6,10,20,191,5,23,1,26,16,42,114,142,256,0,268,12,0,10,2.12941,0.117647,21.7529,82.4342,85,4
India,259,242.378,7.15058,0.339768,244.568,7.12741,0.30888,479,AB Dinda,0,0,0,0,191,5,23,1,26,16,42,114,142,256,0,268,12,0,10,0.2,0,4.2,55.2632,5,3
India,259,242.378,7.15058,0.339768,244.568,7.12741,0.30888,479,PP Ojha,0,0,0,0,191,5,23,1,26,16,42,114,142,256,0,268,12,0,10,0.333333,0,5.11111,40.3509,9,3
Sri Lanka,244,223.373,7.09016,0.344262,227.578,7.47541,0.385246,479,BMAJ Mendis,24,12,12,25,208,3,26,1,16,14,30,134,130,264,269,270,6,0,10,1.43243,0.027027,15.1622,82.8656,37,1
Sri Lanka,244,223.373,7.09016,0.344262,227.578,7.47541,0.385246,479,TT Samaraweera,9,0,9,10,208,3,26,1,16,14,30,134,130,264,269,270,6,0,10,2.19231,0.0769231,23.4231,73.8182,26,4
Sri Lanka,244,223.373,7.09016,0.344262,227.578,7.47541,0.385246,480,S Randiv,1,0,1,1,195,6,17,2,10,5,15,86,141,227,0,236,9,0,10,1.6875,0.0625,15.875,69.9725,16,1
Sri Lanka,244,223.373,7.09016,0.344262,227.578,7.47541,0.385246,480,T Thushara,0,0,0,1,195,6,17,2,10,5,15,86,141,227,0,236,9,0,10,1.7619,0.047619,16.4762,93.7669,21,0
Sri Lanka,244,223.373,7.09016,0.344262,227.578,7.47541,0.385246,480,CRD Fernando,0,0,0,0,195,6,17,2,10,5,15,86,141,227,0,236,9,0,10,0.571429,0,5.42857,64.7727,21,1
Zimbabwe,142,212.077,7.5,0.380282,227.704,6.97887,0.316901,480,T Taibu,35,6,29,48,169,2,28,0,14,11,25,70,152,222,237,240,18,1,10,2.36364,0.254545,29.4,71.0145,55,4
Zimbabwe,142,212.077,7.5,0.380282,227.704,6.97887,0.316901,480,BRM Taylor,101,28,73,127,169,2,28,0,14,11,25,70,152,222,237,240,18,1,10,3.3,0.26,33.56,76.3421,100,4
Zimbabwe,142,212.077,7.5,0.380282,227.704,6.97887,0.316901,481,AG Cremer,4,0,4,8,147,4,28,3,0,14,14,48,141,189,0,199,10,1,10,0.766667,0,10.5,54.6875,30,3
Zimbabwe,142,212.077,7.5,0.380282,227.704,6.97887,0.316901,481,P Utseya,3,0,3,6,147,4,28,3,0,14,14,48,141,189,0,199,10,1,10,0.842105,0.0263158,11.8289,55.8385,76,3
Zimbabwe,142,212.077,7.5,0.380282,227.704,6.97887,0.316901,481,RW Price,0,0,0,0,147,4,28,3,0,14,14,48,141,189,0,199,10,1,10,0.666667,0,7.16667,57.2062,36,3
Sri Lanka,244,223.373,7.09016,0.344262,227.578,7.47541,0.385246,482,KMDN Kulasekara,12,0,12,24,168,7,28,0,14,21,35,74,157,231,0,242,11,1,10,1.21,0.04,11.8,80.9328,100,1
Sri Lanka,244,223.373,7.09016,0.344262,227.578,7.47541,0.385246,482,AD Mathews,39,12,27,48,168,7,28,0,14,21,35,74,157,231,0,242,11,1,10,2.64122,0.198473,28.6794,82.3362,131,4
Sri Lanka,244,223.373,7.09016,0.344262,227.578,7.47541,0.385246,482,SL Malinga,0,0,0,0,168,7,28,0,14,21,35,74,157,231,0,242,11,1,10,0.617284,0.0123457,4.97531,74.6296,81,1
Sri Lanka,244,223.373,7.09016,0.344262,227.578,7.47541,0.385246,482,M Muralitharan,0,0,0,0,168,7,28,0,14,21,35,74,157,231,0,242,11,1,10,0.69697,0,5.63636,99.4652,33,0
Pakistan,211,222.621,7.38389,0.393365,235.517,7.54976,0.336493,482,Abdul Razzaq,20,4,16,37,183,6,22,3,4,2,6,90,121,211,243,226,15,0,10,2.225,0.075,20.475,82.0641,40,4
Sri Lanka,244,223.373,7.09016,0.344262,227.578,7.47541,0.385246,484,AD Mathews,22,4,18,28,231,4,27,0,16,25,41,142,157,299,0,312,13,1,10,2.64122,0.198473,28.6794,82.3362,131,4
Sri Lanka,244,223.373,7.09016,0.344262,227.578,7.47541,0.385246,484,CK Kapugedera,16,6,10,15,231,4,27,0,16,25,41,142,157,299,0,312,13,1,10,1.74138,0.12069,21.1379,68.6066,58,1
Pakistan,211,222.621,7.38389,0.393365,235.517,7.54976,0.336493,485,Abdul Razzaq,3,0,3,4,196,5,22,1,22,16,38,104,152,256,0,267,11,0,10,2.225,0.075,20.475,82.0641,40,4
Pakistan,211,222.621,7.38389,0.393365,235.517,7.54976,0.336493,485,Mohammad Amir,0,0,0,0,196,5,22,1,22,16,38,104,152,256,0,267,11,0,10,1.5,0.0714286,12,73.6842,14,1
Pakistan,211,222.621,7.38389,0.393365,235.517,7.54976,0.336493,485,Kamran Akmal,19,4,15,29,196,5,22,1,22,16,38,104,152,256,0,267,11,0,10,3.01124,0.11236,23.0787,81.4433,89,4
Pakistan,211,222.621,7.38389,0.393365,235.517,7.54976,0.336493,485,Shoaib Akhtar,0,0,0,0,196,5,22,1,22,16,38,104,152,256,0,267,11,0,10,0.421053,0,3.21053,67.033,19,1
Pakistan,211,222.621,7.38389,0.393365,235.517,7.54976,0.336493,485,Saeed Ajmal,0,0,0,0,196,5,22,1,22,16,38,104,152,256,0,267,11,0,10,0.34375,0,4.60938,58.3004,64,3
India,259,242.378,7.15058,0.339768,244.568,7.12741,0.30888,485,RA Jadeja,6,0,6,8,187,3,12,2,32,16,48,92,155,247,268,271,24,0,10,2.12941,0.117647,21.7529,82.4342,85,4
India,259,242.378,7.15058,0.339768,244.568,7.12741,0.30888,485,Harbhajan Singh,0,0,0,0,187,3,12,2,32,16,48,92,155,247,268,271,24,0,10,0.901639,0,9.98361,76.4115,61,1
India,259,242.378,7.15058,0.339768,244.568,7.12741,0.30888,485,SK Raina,4,0,4,12,187,3,12,2,32,16,48,92,155,247,268,271,24,0,10,3.11111,0.216374,28.9064,91.8944,171,0
India,259,242.378,7.15058,0.339768,244.568,7.12741,0.30888,485,P Kumar,0,0,0,0,187,3,12,2,32,16,48,92,155,247,268,271,24,0,10,1,0.03125,9.03125,86.0119,32,1
Pakistan,211,222.621,7.38389,0.393365,235.517,7.54976,0.336493,486,Kamran Akmal,5,0,5,5,249,4,60,1,48,17,65,224,150,374,0,385,11,0,10,3.01124,0.11236,23.0787,81.4433,89,4
Pakistan,211,222.621,7.38389,0.393365,235.517,7.54976,0.336493,486,Shahid Afridi,99,68,31,53,249,4,60,1,48,17,65,224,150,374,0,385,11,0,10,2.72917,0.0972222,21.4097,127.766,144,0
Pakistan,211,222.621,7.38389,0.393365,235.517,7.54976,0.336493,486,Abdul Razzaq,0,0,0,0,249,4,60,1,48,17,65,224,150,374,0,385,11,0,10,2.225,0.075,20.475,82.0641,40,4
Pakistan,211,222.621,7.38389,0.393365,235.517,7.54976,0.336493,486,Abdur Rehman,0,0,0,0,249,4,60,1,48,17,65,224,150,374,0,385,11,0,10,0.52381,0,6.04762,55.7018,21,3
Bangladesh,160,218.438,7.70625,0.4,211.106,7.05,0.325,486,Jahurul Islam,2,0,2,7,186,1,25,3,12,11,23,88,146,234,386,246,12,0,10,2.18182,0.0909091,20.5455,69.5385,11,1
Bangladesh,160,218.438,7.70625,0.4,211.106,7.05,0.325,486,Shakib Al Hasan,11,4,7,9,186,1,25,3,12,11,23,88,146,234,386,246,12,0,10,2.86992,0.252033,29.9106,79.0163,123,4
Bangladesh,160,218.438,7.70625,0.4,211.106,7.05,0.325,486,Mahmudullah,0,0,0,0,186,1,25,3,12,11,23,88,146,234,386,246,12,0,10,2.26531,0.153061,24.4286,70.9544,98,4
India,259,242.378,7.15058,0.339768,244.568,7.12741,0.30888,487,RA Jadeja,8,4,4,10,203,4,19,1,0,27,27,102,147,249,0,268,19,0,10,2.12941,0.117647,21.7529,82.4342,85,4
India,259,242.378,7.15058,0.339768,244.568,7.12741,0.30888,487,RG Sharma,38,12,26,46,203,4,19,1,0,27,27,102,147,249,0,268,19,0,10,3.82836,0.268657,35.9179,83.083,134,4
India,259,242.378,7.15058,0.339768,244.568,7.12741,0.30888,487,Harbhajan Singh,0,0,0,0,203,4,19,1,0,27,27,102,147,249,0,268,19,0,10,0.901639,0,9.98361,76.4115,61,1
New Zealand,184,233.745,7.39674,0.36413,227.951,7.30435,0.353261,488,GJ Hopkins,6,0,6,6,215,4,23,3,18,10,28,126,140,266,0,288,22,0,10,1.3125,0,14.75,74.4479,16,1
New Zealand,184,233.745,7.39674,0.36413,227.951,7.30435,0.353261,488,DR Tuffey,4,4,0,2,215,4,23,3,18,10,28,126,140,266,0,288,22,0,10,1.33333,0,12.3333,112.977,12,0
New Zealand,184,233.745,7.39674,0.36413,227.951,7.30435,0.353261,488,KD Mills,0,0,0,0,215,4,23,3,18,10,28,126,140,266,0,288,22,0,10,1.52542,0.0338983,12.8644,90.7895,59,0
Sri Lanka,244,223.373,7.09016,0.344262,227.578,7.47541,0.385246,489,S Randiv,42,16,26,57,131,8,27,1,0,1,1,64,95,159,0,170,11,1,10,1.6875,0.0625,15.875,69.9725,16,1
Sri Lanka,244,223.373,7.09016,0.344262,227.578,7.47541,0.385246,489,CRD Fernando,6,0,6,8,131,8,27,1,0,1,1,64,95,159,0,170,11,1,10,0.571429,0,5.42857,64.7727,21,1
New Zealand,184,233.745,7.39674,0.36413,227.951,7.30435,0.353261,490,TG Southee,9,0,9,22,147,8,15,1,0,8,8,54,116,170,0,192,22,0,10,0.764706,0,7.03922,92.7649,51,0
India,259,242.378,7.15058,0.339768,244.568,7.12741,0.30888,491,I Sharma,2,0,2,7,180,7,9,2,8,4,12,114,87,201,0,223,22,0,10,0.24,0,2.84,34.1346,25,3
India,259,242.378,7.15058,0.339768,244.568,7.12741,0.30888,491,MM Patel,1,0,1,6,180,7,9,2,8,4,12,114,87,201,0,223,22,0,10,0.363636,0,3.22727,66.9811,22,1
Sri Lanka,244,223.373,7.09016,0.344262,227.578,7.47541,0.385246,493,NLTC Perera,0,0,0,0,201,3,39,3,12,23,35,132,143,275,0,299,24,1,10,1.65333,0.0666667,14.32,105.397,75,0
Sri Lanka,244,223.373,7.09016,0.344262,227.578,7.47541,0.385246,493,LPC Silva,1,0,1,3,201,3,39,3,12,23,35,132,143,275,0,299,24,1,10,2.55556,0.244444,26.0222,69.4543,45,4
Sri Lanka,244,223.373,7.09016,0.344262,227.578,7.47541,0.385246,493,S Randiv,0,0,0,0,201,3,39,3,12,23,35,132,143,275,0,299,24,1,10,1.6875,0.0625,15.875,69.9725,16,1
India,259,242.378,7.15058,0.339768,244.568,7.12741,0.30888,493,MS Dhoni,66,26,40,97,190,7,15,1,0,3,3,112,96,208,300,225,17,0,10,3.47872,0.292553,36.7713,84.1612,188,4
India,259,242.378,7.15058,0.339768,244.568,7.12741,0.30888,493,A Nehra,0,0,0,4,190,7,15,1,0,3,3,112,96,208,300,225,17,0,10,0.263158,0,2.84211,43.2,19,3
India,259,242.378,7.15058,0.339768,244.568,7.12741,0.30888,493,MM Patel,0,0,0,0,190,7,15,1,0,3,3,112,96,208,300,225,17,0,10,0.363636,0,3.22727,66.9811,22,1
Pakistan,211,222.621,7.38389,0.393365,235.517,7.54976,0.336493,494,Zulqarnain Haider,7,0,7,19,167,6,11,2,6,7,13,54,137,191,0,203,12,0,10,0.75,0,11.75,67.1429,4,1
Pakistan,211,222.621,7.38389,0.393365,235.517,7.54976,0.336493,494,Saeed Ajmal,1,0,1,3,167,6,11,2,6,7,13,54,137,191,0,203,12,0,10,0.34375,0,4.60938,58.3004,64,3
Pakistan,211,222.621,7.38389,0.393365,235.517,7.54976,0.336493,494,Shoaib Akhtar,0,0,0,0,167,6,11,2,6,7,13,54,137,191,0,203,12,0,10,0.421053,0,3.21053,67.033,19,1
South Africa,190,234.274,7.4,0.373684,232.363,7.33158,0.342105,495,JP Duminy,25,8,17,23,212,3,21,3,18,24,42,112,163,275,0,286,11,0,10,2.3252,0.186992,29.9675,80.2351,123,4
South Africa,190,234.274,7.4,0.373684,232.363,7.33158,0.342105,495,J Botha,1,0,1,4,212,3,21,3,18,24,42,112,163,275,0,286,11,0,10,1.09756,0,11.561,82.2917,41,1
South Africa,190,234.274,7.4,0.373684,232.363,7.33158,0.342105,495,M Morkel,0,0,0,0,212,3,21,3,18,24,42,112,163,275,0,286,11,0,10,0.6,0,5.28571,72.2656,35,1
South Africa,190,234.274,7.4,0.373684,232.363,7.33158,0.342105,495,CK Langeveldt,0,0,0,0,212,3,21,3,18,24,42,112,163,275,0,286,11,0,10,0.571429,0,4.71429,59.4595,14,3
Pakistan,211,222.621,7.38389,0.393365,235.517,7.54976,0.336493,495,Abdul Razzaq,55,40,15,52,191,5,33,2,48,7,55,160,119,279,287,289,10,0,10,2.225,0.075,20.475,82.0641,40,4
Pakistan,211,222.621,7.38389,0.393365,235.517,7.54976,0.336493,495,Wahab Riaz,0,0,0,0,191,5,33,2,48,7,55,160,119,279,287,289,10,0,10,1.29167,0.0416667,10.9792,79.1291,48,1
Pakistan,211,222.621,7.38389,0.393365,235.517,7.54976,0.336493,495,Saeed Ajmal,0,0,0,0,191,5,33,2,48,7,55,160,119,279,287,289,10,0,10,0.34375,0,4.60938,58.3004,64,3
Pakistan,211,222.621,7.38389,0.393365,235.517,7.54976,0.336493,495,Shoaib Akhtar,0,0,0,0,191,5,33,2,48,7,55,160,119,279,287,289,10,0,10,0.421053,0,3.21053,67.033,19,1
South Africa,190,234.274,7.4,0.373684,232.363,7.33158,0.342105,496,CA Ingram,11,4,7,15,181,3,28,1,32,16,48,88,169,257,0,274,17,0,10,3,0.178571,27.1786,81.3904,28,4
South Africa,190,234.274,7.4,0.373684,232.363,7.33158,0.342105,496,JP Duminy,32,4,28,48,181,3,28,1,32,16,48,88,169,257,0,274,17,0,10,2.3252,0.186992,29.9675,80.2351,123,4
South Africa,190,234.274,7.4,0.373684,232.363,7.33158,0.342105,496,DA Miller,0,0,0,0,181,3,28,1,32,16,48,88,169,257,0,274,17,0,10,2.57353,0.132353,24.9412,97.2477,68,0
South Africa,190,234.274,7.4,0.373684,232.363,7.33158,0.342105,496,J Botha,0,0,0,0,181,3,28,1,32,16,48,88,169,257,0,274,17,0,10,1.09756,0,11.561,82.2917,41,1
Pakistan,211,222.621,7.38389,0.393365,235.517,7.54976,0.336493,496,Zulqarnain Haider,5,0,5,9,195,5,24,2,16,23,39,72,186,258,275,275,17,0,10,0.75,0,11.75,67.1429,4,1
Pakistan,211,222.621,7.38389,0.393365,235.517,7.54976,0.336493,496,Abdul Razzaq,26,4,22,36,195,5,24,2,16,23,39,72,186,258,275,275,17,0,10,2.225,0.075,20.475,82.0641,40,4
Pakistan,211,222.621,7.38389,0.393365,235.517,7.54976,0.336493,496,Wahab Riaz,0,0,0,0,195,5,24,2,16,23,39,72,186,258,275,275,17,0,10,1.29167,0.0416667,10.9792,79.1291,48,1
South Africa,190,234.274,7.4,0.373684,232.363,7.33158,0.342105,497,JP Duminy,12,0,12,22,226,5,20,0,36,26,62,130,178,308,0,317,9,0,10,2.3252,0.186992,29.9675,80.2351,123,4
South Africa,190,234.274,7.4,0.373684,232.363,7.33158,0.342105,497,J Botha,13,4,9,16,226,5,20,0,36,26,62,130,178,308,0,317,9,0,10,1.09756,0,11.561,82.2917,41,1
South Africa,190,234.274,7.4,0.373684,232.363,7.33158,0.342105,498,DA Miller,15,8,7,15,242,4,34,0,34,25,59,152,183,335,0,351,16,1,10,2.57353,0.132353,24.9412,97.2477,68,0
South Africa,190,234.274,7.4,0.373684,232.363,7.33158,0.342105,498,CA Ingram,110,34,76,123,242,4,34,0,34,25,59,152,183,335,0,351,16,1,10,3,0.178571,27.1786,81.3904,28,4
South Africa,190,234.274,7.4,0.373684,232.363,7.33158,0.342105,498,JP Duminy,0,0,0,0,242,4,34,0,34,25,59,152,183,335,0,351,16,1,10,2.3252,0.186992,29.9675,80.2351,123,4
South Africa,190,234.274,7.4,0.373684,232.363,7.33158,0.342105,498,J Botha,0,0,0,0,242,4,34,0,34,25,59,152,183,335,0,351,16,1,10,1.09756,0,11.561,82.2917,41,1
Zimbabwe,142,212.077,7.5,0.380282,227.704,6.97887,0.316901,498,BRM Taylor,127,40,87,128,187,5,40,1,20,19,39,100,166,266,352,287,21,0,10,3.3,0.26,33.56,76.3421,100,4
Zimbabwe,142,212.077,7.5,0.380282,227.704,6.97887,0.316901,498,P Utseya,1,0,1,3,187,5,40,1,20,19,39,100,166,266,352,287,21,0,10,0.842105,0.0263158,11.8289,55.8385,76,3
Zimbabwe,142,212.077,7.5,0.380282,227.704,6.97887,0.316901,499,P Utseya,3,0,3,7,187,6,34,1,12,14,26,96,151,247,0,268,21,0,10,0.842105,0.0263158,11.8289,55.8385,76,3
Zimbabwe,142,212.077,7.5,0.380282,227.704,6.97887,0.316901,499,KM Dabengwa,27,20,7,20,187,6,34,1,12,14,26,96,151,247,0,268,21,0,10,1.2,0,16.7,61.1722,20,1
Zimbabwe,142,212.077,7.5,0.380282,227.704,6.97887,0.316901,499,AG Cremer,0,0,0,0,187,6,34,1,12,14,26,96,151,247,0,268,21,0,10,0.766667,0,10.5,54.6875,30,3
Zimbabwe,142,212.077,7.5,0.380282,227.704,6.97887,0.316901,499,SW Masakadza,0,0,0,0,187,6,34,1,12,14,26,96,151,247,0,268,21,0,10,2,0,13.625,97.3214,8,0
South Africa,190,234.274,7.4,0.373684,232.363,7.33158,0.342105,500,JA Morkel,26,18,8,15,267,3,52,1,38,21,59,202,176,378,0,399,21,1,10,2.42424,0.0606061,19.9697,99.5468,33,0
South Africa,190,234.274,7.4,0.373684,232.363,7.33158,0.342105,500,DA Miller,5,4,1,4,267,3,52,1,38,21,59,202,176,378,0,399,21,1,10,2.57353,0.132353,24.9412,97.2477,68,0
South Africa,190,234.274,7.4,0.373684,232.363,7.33158,0.342105,500,CA Ingram,0,0,0,0,267,3,52,1,38,21,59,202,176,378,0,399,21,1,10,3,0.178571,27.1786,81.3904,28,4
South Africa,190,234.274,7.4,0.373684,232.363,7.33158,0.342105,500,J Botha,0,0,0,0,267,3,52,1,38,21,59,202,176,378,0,399,21,1,10,1.09756,0,11.561,82.2917,41,1
South Africa,190,234.274,7.4,0.373684,232.363,7.33158,0.342105,501,J Botha,16,0,16,21,220,5,24,1,10,22,32,94,182,276,0,289,13,1,10,1.09756,0,11.561,82.2917,41,1
South Africa,190,234.274,7.4,0.373684,232.363,7.33158,0.342105,501,WD Parnell,4,0,4,6,220,5,24,1,10,22,32,94,182,276,0,289,13,1,10,1.47826,0.0434783,15.8261,74.7433,23,1
South Africa,190,234.274,7.4,0.373684,232.363,7.33158,0.342105,501,DW Steyn,0,0,0,0,220,5,24,1,10,22,32,94,182,276,0,289,13,1,10,0.75,0,6.52273,61.588,44,1
South Africa,190,234.274,7.4,0.373684,232.363,7.33158,0.342105,501,M Morkel,0,0,0,0,220,5,24,1,10,22,32,94,182,276,0,289,13,1,10,0.6,0,5.28571,72.2656,35,1
South Africa,190,234.274,7.4,0.373684,232.363,7.33158,0.342105,501,LL Tsotsobe,0,0,0,0,220,5,24,1,10,22,32,94,182,276,0,289,13,1,10,0.444444,0,3.16667,50.8929,18,3
India,259,242.378,7.15058,0.339768,244.568,7.12741,0.30888,502,RG Sharma,4,0,4,10,157,4,14,3,8,4,12,56,127,183,0,190,7,0,10,3.82836,0.268657,35.9179,83.083,134,4
India,259,242.378,7.15058,0.339768,244.568,7.12741,0.30888,502,Z Khan,0,0,0,0,157,4,14,3,8,4,12,56,127,183,0,190,7,0,10,0.974359,0,8.35897,60.9346,39,1
India,259,242.378,7.15058,0.339768,244.568,7.12741,0.30888,502,A Nehra,0,0,0,0,157,4,14,3,8,4,12,56,127,183,0,190,7,0,10,0.263158,0,2.84211,43.2,19,3
India,259,242.378,7.15058,0.339768,244.568,7.12741,0.30888,502,MM Patel,0,0,0,0,157,4,14,3,8,4,12,56,127,183,0,190,7,0,10,0.363636,0,3.22727,66.9811,22,1
South Africa,190,234.274,7.4,0.373684,232.363,7.33158,0.342105,503,J Botha,1,0,1,1,169,4,29,1,4,14,18,44,172,216,0,220,4,1,10,1.09756,0,11.561,82.2917,41,1
South Africa,190,234.274,7.4,0.373684,232.363,7.33158,0.342105,503,JP Duminy,52,8,44,59,169,4,29,1,4,14,18,44,172,216,0,220,4,1,10,2.3252,0.186992,29.9675,80.2351,123,4
South Africa,190,234.274,7.4,0.373684,232.363,7.33158,0.342105,503,WD Parnell,0,0,0,0,169,4,29,1,4,14,18,44,172,216,0,220,4,1,10,1.47826,0.0434783,15.8261,74.7433,23,1
South Africa,190,234.274,7.4,0.373684,232.363,7.33158,0.342105,503,DW Steyn,0,0,0,0,169,4,29,1,4,14,18,44,172,216,0,220,4,1,10,0.75,0,6.52273,61.588,44,1
South Africa,190,234.274,7.4,0.373684,232.363,7.33158,0.342105,503,LL Tsotsobe,0,0,0,0,169,4,29,1,4,14,18,44,172,216,0,220,4,1,10,0.444444,0,3.16667,50.8929,18,3
India,259,242.378,7.15058,0.339768,244.568,7.12741,0.30888,503,Harbhajan Singh,13,6,7,19,172,7,20,0,14,6,20,122,90,212,221,223,11,0,10,0.901639,0,9.98361,76.4115,61,1
India,259,242.378,7.15058,0.339768,244.568,7.12741,0.30888,503,Z Khan,10,4,6,21,172,7,20,0,14,6,20,122,90,212,221,223,11,0,10,0.974359,0,8.35897,60.9346,39,1
India,259,242.378,7.15058,0.339768,244.568,7.12741,0.30888,503,A Nehra,0,0,0,0,172,7,20,0,14,6,20,122,90,212,221,223,11,0,10,0.263158,0,2.84211,43.2,19,3
South Africa,190,234.274,7.4,0.373684,232.363,7.33158,0.342105,504,RJ Peterson,18,4,14,27,185,6,23,0,18,25,43,82,169,251,0,265,14,1,10,1.62069,0.0344828,15.7931,83.5766,29,1
South Africa,190,234.274,7.4,0.373684,232.363,7.33158,0.342105,504,JP Duminy,45,4,41,56,185,6,23,0,18,25,43,82,169,251,0,265,14,1,10,2.3252,0.186992,29.9675,80.2351,123,4
South Africa,190,234.274,7.4,0.373684,232.363,7.33158,0.342105,504,DW Steyn,0,0,0,0,185,6,23,0,18,25,43,82,169,251,0,265,14,1,10,0.75,0,6.52273,61.588,44,1
Australia,228,239.627,7.69737,0.372807,232.079,7.23246,0.337719,505,CL White,25,8,17,28,164,3,30,0,66,18,84,126,152,278,0,289,11,0,10,2.66176,0.191176,28.8235,80.1308,68,4
Australia,228,239.627,7.69737,0.372807,232.079,7.23246,0.337719,505,MJ Clarke,91,20,71,131,164,3,30,0,66,18,84,126,152,278,0,289,11,0,10,3.10294,0.301471,35.9265,74.0303,136,4
India,259,242.378,7.15058,0.339768,244.568,7.12741,0.30888,505,SS Tiwary,2,0,2,3,207,3,40,2,18,9,27,132,142,274,290,292,18,1,10,3,0,24.5,85.9649,2,4
India,259,242.378,7.15058,0.339768,244.568,7.12741,0.30888,505,SK Raina,54,32,22,38,207,3,40,2,18,9,27,132,142,274,290,292,18,1,10,3.11111,0.216374,28.9064,91.8944,171,0
West Indies,176,217.33,7.15909,0.3125,225.278,7.57386,0.380682,508,DJG Sammy,4,0,4,6,143,5,25,1,0,17,17,60,125,185,0,203,18,0,10,2.25,0.09,18.25,95.8005,100,0
West Indies,176,217.33,7.15909,0.3125,225.278,7.57386,0.380682,508,CS Baugh,21,4,17,30,143,5,25,1,0,17,17,60,125,185,0,203,18,0,10,1.04545,0,14,60.9901,22,1
West Indies,176,217.33,7.15909,0.3125,225.278,7.57386,0.380682,508,NO Miller,0,0,0,0,143,5,25,1,0,17,17,60,125,185,0,203,18,0,10,1,0.0416667,10.3333,79.2332,24,1
West Indies,176,217.33,7.15909,0.3125,225.278,7.57386,0.380682,508,R Rampaul,0,0,0,0,143,5,25,1,0,17,17,60,125,185,0,203,18,0,10,1.30303,0.030303,9.90909,77.4882,33,1
West Indies,176,217.33,7.15909,0.3125,225.278,7.57386,0.380682,508,KAJ Roach,0,0,0,0,143,5,25,1,0,17,17,60,125,185,0,203,18,0,10,0.526316,0,5.68421,50.5855,38,3
Sri Lanka,244,223.373,7.09016,0.344262,227.578,7.47541,0.385246,509,AD Mathews,3,0,3,3,192,3,26,3,14,29,43,78,183,261,0,277,16,1,10,2.64122,0.198473,28.6794,82.3362,131,4
Sri Lanka,244,223.373,7.09016,0.344262,227.578,7.47541,0.385246,509,NLTC Perera,6,0,6,8,192,3,26,3,14,29,43,78,183,261,0,277,16,1,10,1.65333,0.0666667,14.32,105.397,75,0
Sri Lanka,244,223.373,7.09016,0.344262,227.578,7.47541,0.385246,509,HMRKB Herath,0,0,0,0,192,3,26,3,14,29,43,78,183,261,0,277,16,1,10,0.444444,0,5.18519,61.674,27,1
Sri Lanka,244,223.373,7.09016,0.344262,227.578,7.47541,0.385246,509,BAW Mendis,0,0,0,0,192,3,26,3,14,29,43,78,183,261,0,277,16,1,10,0.447368,0,4.47368,66.4062,38,1
West Indies,176,217.33,7.15909,0.3125,225.278,7.57386,0.380682,509,NO Miller,11,0,11,14,185,7,33,0,8,10,18,92,144,236,278,251,15,0,10,1,0.0416667,10.3333,79.2332,24,1
West Indies,176,217.33,7.15909,0.3125,225.278,7.57386,0.380682,509,CS Baugh,39,12,27,44,185,7,33,0,8,10,18,92,144,236,278,251,15,0,10,1.04545,0,14,60.9901,22,1
West Indies,176,217.33,7.15909,0.3125,225.278,7.57386,0.380682,509,SJ Benn,0,0,0,0,185,7,33,0,8,10,18,92,144,236,278,251,15,0,10,0.8,0,6.75,72.973,20,1
India,259,242.378,7.15058,0.339768,244.568,7.12741,0.30888,510,WP Saha,4,0,4,4,210,3,35,2,14,6,20,138,127,265,0,276,11,1,10,0.75,0,6,64.8649,4,1
India,259,242.378,7.15058,0.339768,244.568,7.12741,0.30888,510,R Ashwin,0,0,0,0,210,3,35,2,14,6,20,138,127,265,0,276,11,1,10,1.16364,0.0181818,11.9455,84.7742,55,1
India,259,242.378,7.15058,0.339768,244.568,7.12741,0.30888,510,A Nehra,0,0,0,0,210,3,35,2,14,6,20,138,127,265,0,276,11,1,10,0.263158,0,2.84211,43.2,19,3
India,259,242.378,7.15058,0.339768,244.568,7.12741,0.30888,510,YK Pathan,14,8,6,11,210,3,35,2,14,6,20,138,127,265,0,276,11,1,10,2.575,0.125,19.975,110.055,40,0
India,259,242.378,7.15058,0.339768,244.568,7.12741,0.30888,510,S Sreesanth,0,0,0,0,210,3,35,2,14,6,20,138,127,265,0,276,11,1,10,0.125,0,2.4375,32.5,16,3
India,259,242.378,7.15058,0.339768,244.568,7.12741,0.30888,510,MM Patel,0,0,0,0,210,3,35,2,14,6,20,138,127,265,0,276,11,1,10,0.363636,0,3.22727,66.9811,22,1
New Zealand,184,233.745,7.39674,0.36413,227.951,7.30435,0.353261,510,NL McCullum,35,16,19,34,192,8,40,0,0,0,0,110,122,232,277,236,4,0,10,1.63934,0.0655738,17.377,85.622,61,0
New Zealand,184,233.745,7.39674,0.36413,227.951,7.30435,0.353261,510,KD Mills,32,20,12,27,192,8,40,0,0,0,0,110,122,232,277,236,4,0,10,1.52542,0.0338983,12.8644,90.7895,59,0
New Zealand,184,233.745,7.39674,0.36413,227.951,7.30435,0.353261,511,SB Styris,59,26,33,56,169,4,40,0,18,20,38,104,143,247,0,258,11,0,10,3.20755,0.264151,33.8302,78.7094,53,4
New Zealand,184,233.745,7.39674,0.36413,227.951,7.30435,0.353261,511,DL Vettori,31,16,15,31,169,4,40,0,18,20,38,104,143,247,0,258,11,0,10,1.43662,0.028169,15.7606,86.0108,71,0
New Zealand,184,233.745,7.39674,0.36413,227.951,7.30435,0.353261,511,NL McCullum,0,0,0,0,169,4,40,0,18,20,38,104,143,247,0,258,11,0,10,1.63934,0.0655738,17.377,85.622,61,0
New Zealand,184,233.745,7.39674,0.36413,227.951,7.30435,0.353261,511,GJ Hopkins,0,0,0,0,169,4,40,0,18,20,38,104,143,247,0,258,11,0,10,1.3125,0,14.75,74.4479,16,1
New Zealand,184,233.745,7.39674,0.36413,227.951,7.30435,0.353261,511,KD Mills,0,0,0,0,169,4,40,0,18,20,38,104,143,247,0,258,11,0,10,1.52542,0.0338983,12.8644,90.7895,59,0
New Zealand,184,233.745,7.39674,0.36413,227.951,7.30435,0.353261,511,TG Southee,0,0,0,0,169,4,40,0,18,20,38,104,143,247,0,258,11,0,10,0.764706,0,7.03922,92.7649,51,0
New Zealand,184,233.745,7.39674,0.36413,227.951,7.30435,0.353261,512,JEC Franklin,52,16,36,96,134,7,21,0,24,19,43,82,116,198,0,224,26,0,10,1.67308,0.0769231,18.7115,77.5299,52,1
New Zealand,184,233.745,7.39674,0.36413,227.951,7.30435,0.353261,512,NL McCullum,35,12,23,47,134,7,21,0,24,19,43,82,116,198,0,224,26,0,10,1.63934,0.0655738,17.377,85.622,61,0
New Zealand,184,233.745,7.39674,0.36413,227.951,7.30435,0.353261,512,KD Mills,0,0,0,0,134,7,21,0,24,19,43,82,116,198,0,224,26,0,10,1.52542,0.0338983,12.8644,90.7895,59,0
New Zealand,184,233.745,7.39674,0.36413,227.951,7.30435,0.353261,513,NL McCullum,1,0,1,2,212,5,22,2,42,19,61,166,129,295,0,315,20,0,10,1.63934,0.0655738,17.377,85.622,61,0
New Zealand,184,233.745,7.39674,0.36413,227.951,7.30435,0.353261,513,JEC Franklin,49,28,21,49,212,5,22,2,42,19,61,166,129,295,0,315,20,0,10,1.67308,0.0769231,18.7115,77.5299,52,1
India,259,242.378,7.15058,0.339768,244.568,7.12741,0.30888,513,YK Pathan,107,64,43,88,226,5,40,0,24,14,38,168,136,304,316,321,17,1,10,2.575,0.125,19.975,110.055,40,0
India,259,242.378,7.15058,0.339768,244.568,7.12741,0.30888,513,SS Tiwary,15,0,15,29,226,5,40,0,24,14,38,168,136,304,316,321,17,1,10,3,0,24.5,85.9649,2,4
Pakistan,211,222.621,7.38389,0.393365,235.517,7.54976,0.336493,515,Shahid Afridi,3,0,3,3,159,4,54,1,50,20,70,150,133,283,0,293,10,0,10,2.72917,0.0972222,21.4097,127.766,144,0
Pakistan,211,222.621,7.38389,0.393365,235.517,7.54976,0.336493,515,Umar Akmal,42,28,14,26,159,4,54,1,50,20,70,150,133,283,0,293,10,0,10,2.76842,0.2,27.5053,82.7947,95,4
Pakistan,211,222.621,7.38389,0.393365,235.517,7.54976,0.336493,515,Abdul Razzaq,0,0,0,0,159,4,54,1,50,20,70,150,133,283,0,293,10,0,10,2.225,0.075,20.475,82.0641,40,4
Pakistan,211,222.621,7.38389,0.393365,235.517,7.54976,0.336493,515,Wahab Riaz,0,0,0,0,159,4,54,1,50,20,70,150,133,283,0,293,10,0,10,1.29167,0.0416667,10.9792,79.1291,48,1
New Zealand,184,233.745,7.39674,0.36413,227.951,7.30435,0.353261,515,KD Mills,10,4,6,11,174,6,34,2,10,13,23,82,149,231,294,250,19,1,10,1.52542,0.0338983,12.8644,90.7895,59,0
New Zealand,184,233.745,7.39674,0.36413,227.951,7.30435,0.353261,515,TG Southee,1,0,1,2,174,6,34,2,10,13,23,82,149,231,294,250,19,1,10,0.764706,0,7.03922,92.7649,51,0
New Zealand,184,233.745,7.39674,0.36413,227.951,7.30435,0.353261,516,DL Vettori,2,0,2,6,151,6,42,1,18,18,36,112,117,229,0,262,33,1,10,1.43662,0.028169,15.7606,86.0108,71,0
New Zealand,184,233.745,7.39674,0.36413,227.951,7.30435,0.353261,516,NL McCullum,28,12,16,41,151,6,42,1,18,18,36,112,117,229,0,262,33,1,10,1.63934,0.0655738,17.377,85.622,61,0
Pakistan,211,222.621,7.38389,0.393365,235.517,7.54976,0.336493,516,Abdul Razzaq,14,6,8,9,181,4,42,2,26,11,37,114,146,260,263,264,4,0,10,2.225,0.075,20.475,82.0641,40,4
Pakistan,211,222.621,7.38389,0.393365,235.517,7.54976,0.336493,516,Misbah-ul-Haq,79,24,55,84,181,4,42,2,26,11,37,114,146,260,263,264,4,0,10,2.95238,0.285714,34.9921,71.8195,126,4
Pakistan,211,222.621,7.38389,0.393365,235.517,7.54976,0.336493,516,Wahab Riaz,0,0,0,0,181,4,42,2,26,11,37,114,146,260,263,264,4,0,10,1.29167,0.0416667,10.9792,79.1291,48,1
Pakistan,211,222.621,7.38389,0.393365,235.517,7.54976,0.336493,516,Sohail Tanvir,0,0,0,0,181,4,42,2,26,11,37,114,146,260,263,264,4,0,10,1.18919,0,9.08108,81.5534,37,1
Pakistan,211,222.621,7.38389,0.393365,235.517,7.54976,0.336493,517,Umar Akmal,20,4,16,22,199,5,35,0,4,16,20,112,142,254,0,268,14,0,10,2.76842,0.2,27.5053,82.7947,95,4
Pakistan,211,222.621,7.38389,0.393365,235.517,7.54976,0.336493,517,Shahid Afridi,22,10,12,18,199,5,35,0,4,16,20,112,142,254,0,268,14,0,10,2.72917,0.0972222,21.4097,127.766,144,0
Pakistan,211,222.621,7.38389,0.393365,235.517,7.54976,0.336493,517,Abdul Razzaq,0,0,0,0,199,5,35,0,4,16,20,112,142,254,0,268,14,0,10,2.225,0.075,20.475,82.0641,40,4
Pakistan,211,222.621,7.38389,0.393365,235.517,7.54976,0.336493,517,Wahab Riaz,0,0,0,0,199,5,35,0,4,16,20,112,142,254,0,268,14,0,10,1.29167,0.0416667,10.9792,79.1291,48,1
Pakistan,211,222.621,7.38389,0.393365,235.517,7.54976,0.336493,517,Umar Gul,0,0,0,0,199,5,35,0,4,16,20,112,142,254,0,268,14,0,10,0.77193,0,7.14035,68.2886,57,1
New Zealand,184,233.745,7.39674,0.36413,227.951,7.30435,0.353261,517,NL McCullum,12,6,6,9,166,5,38,3,0,7,7,76,135,211,269,227,16,1,10,1.63934,0.0655738,17.377,85.622,61,0
New Zealand,184,233.745,7.39674,0.36413,227.951,7.30435,0.353261,517,KD Mills,2,0,2,3,166,5,38,3,0,7,7,76,135,211,269,227,16,1,10,1.52542,0.0338983,12.8644,90.7895,59,0
New Zealand,184,233.745,7.39674,0.36413,227.951,7.30435,0.353261,518,NL McCullum,23,10,13,34,199,5,30,0,54,16,70,172,127,299,0,311,12,1,10,1.63934,0.0655738,17.377,85.622,61,0
New Zealand,184,233.745,7.39674,0.36413,227.951,7.30435,0.353261,518,SB Styris,30,12,18,31,199,5,30,0,54,16,70,172,127,299,0,311,12,1,10,3.20755,0.264151,33.8302,78.7094,53,4
Sri Lanka,244,223.373,7.09016,0.344262,227.578,7.47541,0.385246,520,DPMD Jayawardene,144,60,84,152,207,3,51,0,18,17,35,126,167,293,0,309,16,0,10,3.20833,0.244792,31.6979,79.1109,192,4
Sri Lanka,244,223.373,7.09016,0.344262,227.578,7.47541,0.385246,520,KMDN Kulasekara,0,0,0,0,207,3,51,0,18,17,35,126,167,293,0,309,16,0,10,1.21,0.04,11.8,80.9328,100,1
Sri Lanka,244,223.373,7.09016,0.344262,227.578,7.47541,0.385246,520,AD Mathews,31,20,11,25,207,3,51,0,18,17,35,126,167,293,0,309,16,0,10,2.64122,0.198473,28.6794,82.3362,131,4
Sri Lanka,244,223.373,7.09016,0.344262,227.578,7.47541,0.385246,520,BMAJ Mendis,0,0,0,0,207,3,51,0,18,17,35,126,167,293,0,309,16,0,10,1.43243,0.027027,15.1622,82.8656,37,1
England,221,237.176,7.17647,0.289593,230.633,7.45701,0.384615,520,GP Swann,12,4,8,10,202,7,25,2,4,2,6,92,141,233,310,240,7,1,10,1.08696,0,10.3043,90.631,46,0
England,221,237.176,7.17647,0.289593,230.633,7.45701,0.384615,520,JW Dernbach,0,0,0,4,202,7,25,2,4,2,6,92,141,233,310,240,7,1,10,0.125,0,2.375,47.5,8,3
England,221,237.176,7.17647,0.289593,230.633,7.45701,0.384615,521,AN Cook,100,44,56,128,171,5,28,0,18,20,38,94,143,237,0,246,9,1,10,4.17045,0.272727,35.75,75.5524,88,4
England,221,237.176,7.17647,0.289593,230.633,7.45701,0.384615,521,TT Bresnan,19,4,15,21,171,5,28,0,18,20,38,94,143,237,0,246,9,1,10,1.52381,0.015873,13.8095,88.4146,63,0
England,221,237.176,7.17647,0.289593,230.633,7.45701,0.384615,521,SCJ Broad,0,0,0,0,171,5,28,0,18,20,38,94,143,237,0,246,9,1,10,0.725806,0,8.04839,74.0356,62,1
England,221,237.176,7.17647,0.289593,230.633,7.45701,0.384615,521,GP Swann,0,0,0,0,171,5,28,0,18,20,38,94,143,237,0,246,9,1,10,1.08696,0,10.3043,90.631,46,0
Sri Lanka,244,223.373,7.09016,0.344262,227.578,7.47541,0.385246,521,LD Chandimal,91,46,45,121,192,3,17,1,10,5,15,104,120,224,247,249,25,0,10,2.18478,0.184783,25.7391,73.8615,92,4
Sri Lanka,244,223.373,7.09016,0.344262,227.578,7.47541,0.385246,521,AD Mathews,0,0,0,11,192,3,17,1,10,5,15,104,120,224,247,249,25,0,10,2.64122,0.198473,28.6794,82.3362,131,4
India,259,242.378,7.15058,0.339768,244.568,7.12741,0.30888,524,R Ashwin,2,0,2,2,137,5,22,1,36,22,58,90,127,217,0,234,17,0,10,1.16364,0.0181818,11.9455,84.7742,55,1
India,259,242.378,7.15058,0.339768,244.568,7.12741,0.30888,524,RA Jadeja,55,24,31,81,137,5,22,1,36,22,58,90,127,217,0,234,17,0,10,2.12941,0.117647,21.7529,82.4342,85,4
India,259,242.378,7.15058,0.339768,244.568,7.12741,0.30888,524,P Kumar,0,0,0,0,137,5,22,1,36,22,58,90,127,217,0,234,17,0,10,1,0.03125,9.03125,86.0119,32,1
India,259,242.378,7.15058,0.339768,244.568,7.12741,0.30888,525,SK Raina,53,18,35,61,157,4,42,0,42,21,63,142,120,262,0,280,18,0,10,3.11111,0.216374,28.9064,91.8944,171,0
India,259,242.378,7.15058,0.339768,244.568,7.12741,0.30888,525,MS Dhoni,46,22,24,58,157,4,42,0,42,21,63,142,120,262,0,280,18,0,10,3.47872,0.292553,36.7713,84.1612,188,4
England,221,237.176,7.17647,0.289593,230.633,7.45701,0.384615,525,RS Bopara,91,24,67,102,203,5,35,1,8,16,24,94,168,262,281,270,8,1,10,2.22115,0.144231,25.1538,75.9361,104,4
England,221,237.176,7.17647,0.289593,230.633,7.45701,0.384615,525,GP Swann,12,4,8,9,203,5,35,1,8,16,24,94,168,262,281,270,8,1,10,1.08696,0,10.3043,90.631,46,0
India,259,242.378,7.15058,0.339768,244.568,7.12741,0.30888,526,SK Raina,10,6,4,6,204,2,32,2,32,18,50,108,178,286,0,304,18,0,10,3.11111,0.216374,28.9064,91.8944,171,0
India,259,242.378,7.15058,0.339768,244.568,7.12741,0.30888,526,MS Dhoni,5,0,5,6,204,2,32,2,32,18,50,108,178,286,0,304,18,0,10,3.47872,0.292553,36.7713,84.1612,188,4
India,259,242.378,7.15058,0.339768,244.568,7.12741,0.30888,526,RA Jadeja,0,0,0,0,204,2,32,2,32,18,50,108,178,286,0,304,18,0,10,2.12941,0.117647,21.7529,82.4342,85,4
Bangladesh,160,218.438,7.70625,0.4,211.106,7.05,0.325,527,Shakib Al Hasan,38,12,26,45,158,5,12,1,34,6,40,98,112,210,0,228,18,1,10,2.86992,0.252033,29.9106,79.0163,123,4
Bangladesh,160,218.438,7.70625,0.4,211.106,7.05,0.325,527,Naeem Islam,5,0,5,18,158,5,12,1,34,6,40,98,112,210,0,228,18,1,10,1.88889,0.111111,18.6889,67.496,45,1
Bangladesh,160,218.438,7.70625,0.4,211.106,7.05,0.325,527,Mashrafe Mortaza,0,0,0,0,158,5,12,1,34,6,40,98,112,210,0,228,18,1,10,1.27536,0,11.1594,76.9231,69,1
Bangladesh,160,218.438,7.70625,0.4,211.106,7.05,0.325,527,Abdur Razzak,0,0,0,0,158,5,12,1,34,6,40,98,112,210,0,228,18,1,10,0.849315,0.0136986,8.39726,73.8554,73,1
Bangladesh,160,218.438,7.70625,0.4,211.106,7.05,0.325,529,Mahmudullah,35,16,19,54,193,5,24,1,8,7,15,106,126,232,0,241,9,1,10,2.26531,0.153061,24.4286,70.9544,98,4
Bangladesh,160,218.438,7.70625,0.4,211.106,7.05,0.325,529,Suhrawadi Shuvo,3,0,3,5,193,5,24,1,8,7,15,106,126,232,0,241,9,1,10,1,0,9.7,70.2899,10,1
Bangladesh,160,218.438,7.70625,0.4,211.106,7.05,0.325,529,Abdur Razzak,0,0,0,0,193,5,24,1,8,7,15,106,126,232,0,241,9,1,10,0.849315,0.0136986,8.39726,73.8554,73,1
Bangladesh,160,218.438,7.70625,0.4,211.106,7.05,0.325,529,Shafiul Islam,0,0,0,0,193,5,24,1,8,7,15,106,126,232,0,241,9,1,10,0.535714,0,4.42857,57.6744,28,3
New Zealand,184,233.745,7.39674,0.36413,227.951,7.30435,0.353261,529,NL McCullum,14,0,14,17,166,7,25,0,12,22,34,60,165,225,242,232,7,0,10,1.63934,0.0655738,17.377,85.622,61,0
New Zealand,184,233.745,7.39674,0.36413,227.951,7.30435,0.353261,529,KS Williamson,93,28,65,125,166,7,25,0,12,22,34,60,165,225,242,232,7,0,10,4.31707,0.390244,43.0488,82.8833,82,4
New Zealand,184,233.745,7.39674,0.36413,227.951,7.30435,0.353261,529,DR Tuffey,0,0,0,0,166,7,25,0,12,22,34,60,165,225,242,232,7,0,10,1.33333,0,12.3333,112.977,12,0
New Zealand,184,233.745,7.39674,0.36413,227.951,7.30435,0.353261,530,KD Mills,9,0,9,31,118,7,9,2,20,4,24,58,93,151,175,171,20,0,10,1.52542,0.0338983,12.8644,90.7895,59,0
Zimbabwe,142,212.077,7.5,0.380282,227.704,6.97887,0.316901,532,CR Ervine,41,16,25,40,145,6,36,1,0,2,2,74,109,183,0,191,8,0,10,3.06667,0.2,30.5333,73.9903,30,4
Zimbabwe,142,212.077,7.5,0.380282,227.704,6.97887,0.316901,532,KO Meth,0,0,0,0,145,6,36,1,0,2,2,74,109,183,0,191,8,0,10,0.8,0,6.4,61.5385,5,1
Zimbabwe,142,212.077,7.5,0.380282,227.704,6.97887,0.316901,532,RW Price,0,0,0,0,145,6,36,1,0,2,2,74,109,183,0,191,8,0,10,0.666667,0,7.16667,57.2062,36,3
Bangladesh,160,218.438,7.70625,0.4,211.106,7.05,0.325,533,Naeem Islam,5,0,5,10,158,4,27,1,20,19,39,94,130,224,0,246,22,1,10,1.88889,0.111111,18.6889,67.496,45,1
Bangladesh,160,218.438,7.70625,0.4,211.106,7.05,0.325,533,Shakib Al Hasan,71,20,51,95,158,4,27,1,20,19,39,94,130,224,0,246,22,1,10,2.86992,0.252033,29.9106,79.0163,123,4
Bangladesh,160,218.438,7.70625,0.4,211.106,7.05,0.325,533,Suhrawadi Shuvo,0,0,0,0,158,4,27,1,20,19,39,94,130,224,0,246,22,1,10,1,0,9.7,70.2899,10,1
Bangladesh,160,218.438,7.70625,0.4,211.106,7.05,0.325,533,Mashrafe Mortaza,0,0,0,0,158,4,27,1,20,19,39,94,130,224,0,246,22,1,10,1.27536,0,11.1594,76.9231,69,1
Zimbabwe,142,212.077,7.5,0.380282,227.704,6.97887,0.316901,533,P Utseya,48,14,34,92,122,8,16,1,16,3,19,70,87,157,247,181,24,0,10,0.842105,0.0263158,11.8289,55.8385,76,3
Zimbabwe,142,212.077,7.5,0.380282,227.704,6.97887,0.316901,534,E Chigumbura,20,10,10,27,109,4,25,0,22,18,40,40,134,174,0,188,14,0,10,2.28947,0.114035,22.7895,77.7844,114,4
Zimbabwe,142,212.077,7.5,0.380282,227.704,6.97887,0.316901,534,T Taibu,53,4,49,100,109,4,25,0,22,18,40,40,134,174,0,188,14,0,10,2.36364,0.254545,29.4,71.0145,55,4
Zimbabwe,142,212.077,7.5,0.380282,227.704,6.97887,0.316901,534,P Utseya,0,0,0,0,109,4,25,0,22,18,40,40,134,174,0,188,14,0,10,0.842105,0.0263158,11.8289,55.8385,76,3
Zimbabwe,142,212.077,7.5,0.380282,227.704,6.97887,0.316901,534,RW Chakabva,0,0,0,0,109,4,25,0,22,18,40,40,134,174,0,188,14,0,10,0.846154,0,13.2692,51.3393,26,3
West Indies,176,217.33,7.15909,0.3125,225.278,7.57386,0.380682,535,DJG Sammy,0,0,0,1,121,4,31,2,28,11,39,54,137,191,0,221,30,1,10,2.25,0.09,18.25,95.8005,100,0
West Indies,176,217.33,7.15909,0.3125,225.278,7.57386,0.380682,535,CS Baugh,0,0,0,2,121,4,31,2,28,11,39,54,137,191,0,221,30,1,10,1.04545,0,14,60.9901,22,1
West Indies,176,217.33,7.15909,0.3125,225.278,7.57386,0.380682,536,KAJ Roach,2,0,2,19,159,7,10,2,14,12,26,92,103,195,0,220,25,1,10,0.526316,0,5.68421,50.5855,38,3
Pakistan,211,222.621,7.38389,0.393365,235.517,7.54976,0.336493,536,Misbah-ul-Haq,29,8,21,37,164,2,22,0,20,11,31,72,145,217,221,223,6,0,10,2.95238,0.285714,34.9921,71.8195,126,4
Pakistan,211,222.621,7.38389,0.393365,235.517,7.54976,0.336493,536,Ahmed Shehzad,102,34,68,148,164,2,22,0,20,11,31,72,145,217,221,223,6,0,10,3.67143,0.242857,33.2714,70.8118,70,4
Pakistan,211,222.621,7.38389,0.393365,235.517,7.54976,0.336493,536,Umar Akmal,0,0,0,0,164,2,22,0,20,11,31,72,145,217,221,223,6,0,10,2.76842,0.2,27.5053,82.7947,95,4
Pakistan,211,222.621,7.38389,0.393365,235.517,7.54976,0.336493,538,Mohammad Hafeez,121,46,75,139,169,2,43,2,16,13,29,86,155,241,0,248,7,0,10,4.04511,0.255639,34.3534,78.0625,133,4
Pakistan,211,222.621,7.38389,0.393365,235.517,7.54976,0.336493,538,Hammad Azam,1,0,1,4,169,2,43,2,16,13,29,86,155,241,0,248,7,0,10,1.4,0,14.8,62.1849,5,1
Pakistan,211,222.621,7.38389,0.393365,235.517,7.54976,0.336493,538,Mohammad Salman,0,0,0,0,169,2,43,2,16,13,29,86,155,241,0,248,7,0,10,0.666667,0,7.33333,55,3,3
Pakistan,211,222.621,7.38389,0.393365,235.517,7.54976,0.336493,538,Tanvir Ahmed,0,0,0,0,169,2,43,2,16,13,29,86,155,241,0,248,7,0,10,3,0,18,150,1,2
Pakistan,211,222.621,7.38389,0.393365,235.517,7.54976,0.336493,538,Saeed Ajmal,0,0,0,0,169,2,43,2,16,13,29,86,155,241,0,248,7,0,10,0.34375,0,4.60938,58.3004,64,3
Pakistan,211,222.621,7.38389,0.393365,235.517,7.54976,0.336493,538,Junaid Khan,0,0,0,0,169,2,43,2,16,13,29,86,155,241,0,248,7,0,10,0.210526,0,2.84211,47.7876,19,3
West Indies,176,217.33,7.15909,0.3125,225.278,7.57386,0.380682,540,CS Baugh,10,4,6,6,140,4,34,2,4,17,21,70,125,195,0,214,19,1,10,1.04545,0,14,60.9901,22,1
West Indies,176,217.33,7.15909,0.3125,225.278,7.57386,0.380682,540,DJG Sammy,0,0,0,1,140,4,34,2,4,17,21,70,125,195,0,214,19,1,10,2.25,0.09,18.25,95.8005,100,0
West Indies,176,217.33,7.15909,0.3125,225.278,7.57386,0.380682,540,R Rampaul,0,0,0,0,140,4,34,2,4,17,21,70,125,195,0,214,19,1,10,1.30303,0.030303,9.90909,77.4882,33,1
West Indies,176,217.33,7.15909,0.3125,225.278,7.57386,0.380682,540,D Bishoo,0,0,0,0,140,4,34,2,4,17,21,70,125,195,0,214,19,1,10,0.285714,0,1.42857,37.037,7,3
West Indies,176,217.33,7.15909,0.3125,225.278,7.57386,0.380682,541,AD Russell,47,28,19,45,143,7,24,0,34,18,52,98,121,219,0,225,6,1,10,3.38095,0.0952381,23.2857,129.536,42,0
West Indies,176,217.33,7.15909,0.3125,225.278,7.57386,0.380682,541,CS Baugh,36,0,36,73,143,7,24,0,34,18,52,98,121,219,0,225,6,1,10,1.04545,0,14,60.9901,22,1
West Indies,176,217.33,7.15909,0.3125,225.278,7.57386,0.380682,541,KAJ Roach,0,0,0,0,143,7,24,0,34,18,52,98,121,219,0,225,6,1,10,0.526316,0,5.68421,50.5855,38,3
India,259,242.378,7.15058,0.339768,244.568,7.12741,0.30888,541,P Kumar,23,16,7,14,159,6,44,1,8,6,14,84,133,217,226,228,11,0,10,1,0.03125,9.03125,86.0119,32,1
India,259,242.378,7.15058,0.339768,244.568,7.12741,0.30888,541,RG Sharma,74,24,50,87,159,6,44,1,8,6,14,84,133,217,226,228,11,0,10,3.82836,0.268657,35.9179,83.083,134,4
West Indies,176,217.33,7.15909,0.3125,225.278,7.57386,0.380682,542,CS Baugh,27,4,23,45,156,5,39,1,22,14,36,104,127,231,0,249,18,1,10,1.04545,0,14,60.9901,22,1
West Indies,176,217.33,7.15909,0.3125,225.278,7.57386,0.380682,542,AD Russell,6,4,2,4,156,5,39,1,22,14,36,104,127,231,0,249,18,1,10,3.38095,0.0952381,23.2857,129.536,42,0
West Indies,176,217.33,7.15909,0.3125,225.278,7.57386,0.380682,542,DJG Sammy,0,0,0,0,156,5,39,1,22,14,36,104,127,231,0,249,18,1,10,2.25,0.09,18.25,95.8005,100,0
West Indies,176,217.33,7.15909,0.3125,225.278,7.57386,0.380682,542,KAJ Roach,0,0,0,0,156,5,39,1,22,14,36,104,127,231,0,249,18,1,10,0.526316,0,5.68421,50.5855,38,3
India,259,242.378,7.15058,0.339768,244.568,7.12741,0.30888,543,YK Pathan,30,14,16,30,192,5,34,1,0,4,4,86,144,230,0,251,21,0,10,2.575,0.125,19.975,110.055,40,0
India,259,242.378,7.15058,0.339768,244.568,7.12741,0.30888,543,A Mishra,0,0,0,0,192,5,34,1,0,4,4,86,144,230,0,251,21,0,10,0.375,0,3.5,42.4242,8,3
India,259,242.378,7.15058,0.339768,244.568,7.12741,0.30888,543,R Vinay Kumar,0,0,0,0,192,5,34,1,0,4,4,86,144,230,0,251,21,0,10,0.636364,0,7.72727,57.047,11,3
India,259,242.378,7.15058,0.339768,244.568,7.12741,0.30888,543,R Ashwin,6,4,2,5,192,5,34,1,0,4,4,86,144,230,0,251,21,0,10,1.16364,0.0181818,11.9455,84.7742,55,1
India,259,242.378,7.15058,0.339768,244.568,7.12741,0.30888,543,I Sharma,0,0,0,0,192,5,34,1,0,4,4,86,144,230,0,251,21,0,10,0.24,0,2.84,34.1346,25,3
West Indies,176,217.33,7.15909,0.3125,225.278,7.57386,0.380682,543,DM Bravo,86,48,38,103,151,3,44,0,30,11,41,108,128,236,252,255,19,1,10,3,0.226667,28.52,67.4551,75,4
West Indies,176,217.33,7.15909,0.3125,225.278,7.57386,0.380682,543,KA Pollard,0,0,0,0,151,3,44,0,30,11,41,108,128,236,252,255,19,1,10,2.70513,0.115385,24.5,88.0645,78,4
West Indies,176,217.33,7.15909,0.3125,225.278,7.57386,0.380682,543,MN Samuels,11,0,11,17,151,3,44,0,30,11,41,108,128,236,252,255,19,1,10,3.74757,0.23301,31.6214,74.5821,103,4
Australia,228,239.627,7.69737,0.372807,232.079,7.23246,0.337719,544,MEK Hussey,33,4,29,50,178,4,36,0,26,22,48,118,144,262,0,270,8,0,10,2.7563,0.260504,34.084,82.4893,119,4
Australia,228,239.627,7.69737,0.372807,232.079,7.23246,0.337719,544,MJ Clarke,80,30,50,100,178,4,36,0,26,22,48,118,144,262,0,270,8,0,10,3.10294,0.301471,35.9265,74.0303,136,4
Australia,228,239.627,7.69737,0.372807,232.079,7.23246,0.337719,544,SPD Smith,0,0,0,0,178,4,36,0,26,22,48,118,144,262,0,270,8,0,10,3.19298,0.22807,34.5614,87.0526,57,4
Australia,228,239.627,7.69737,0.372807,232.079,7.23246,0.337719,544,MG Johnson,0,0,0,0,178,4,36,0,26,22,48,118,144,262,0,270,8,0,10,1.18519,0.0246914,10.7901,94.181,81,0
Bangladesh,160,218.438,7.70625,0.4,211.106,7.05,0.325,544,Mushfiqur Rahim,23,0,23,46,137,4,15,1,24,20,44,66,130,196,271,210,14,1,10,2.61111,0.18254,27.7778,75.2526,126,4
Bangladesh,160,218.438,7.70625,0.4,211.106,7.05,0.325,544,Mahmudullah,5,0,5,14,137,4,15,1,24,20,44,66,130,196,271,210,14,1,10,2.26531,0.153061,24.4286,70.9544,98,4
Bangladesh,160,218.438,7.70625,0.4,211.106,7.05,0.325,545,Mushfiqur Rahim,47,12,35,65,143,5,18,1,46,12,58,98,121,219,0,229,10,1,10,2.61111,0.18254,27.7778,75.2526,126,4
Bangladesh,160,218.438,7.70625,0.4,211.106,7.05,0.325,545,Suhrawadi Shuvo,1,0,1,8,143,5,18,1,46,12,58,98,121,219,0,229,10,1,10,1,0,9.7,70.2899,10,1
Bangladesh,160,218.438,7.70625,0.4,211.106,7.05,0.325,545,Shafiul Islam,0,0,0,0,143,5,18,1,46,12,58,98,121,219,0,229,10,1,10,0.535714,0,4.42857,57.6744,28,3
Australia,228,239.627,7.69737,0.372807,232.079,7.23246,0.337719,546,TD Paine,1,0,1,1,261,5,42,1,30,20,50,202,151,353,0,361,8,0,10,3.3913,0.217391,27.6522,65.7704,23,4
Australia,228,239.627,7.69737,0.372807,232.079,7.23246,0.337719,546,MEK Hussey,87,36,51,80,261,5,42,1,30,20,50,202,151,353,0,361,8,0,10,2.7563,0.260504,34.084,82.4893,119,4
Australia,228,239.627,7.69737,0.372807,232.079,7.23246,0.337719,546,JW Hastings,0,0,0,0,261,5,42,1,30,20,50,202,151,353,0,361,8,0,10,1.76923,0,13.8462,95.2381,13,0
Australia,228,239.627,7.69737,0.372807,232.079,7.23246,0.337719,546,XJ Doherty,0,0,0,0,261,5,42,1,30,20,50,202,151,353,0,361,8,0,10,0.190476,0,4.28571,52.0231,21,3
Bangladesh,160,218.438,7.70625,0.4,211.106,7.05,0.325,546,Mahmudullah,46,20,26,47,218,5,31,0,16,14,30,134,145,279,362,295,16,1,10,2.26531,0.153061,24.4286,70.9544,98,4
Bangladesh,160,218.438,7.70625,0.4,211.106,7.05,0.325,546,Alok Kapali,8,0,8,11,218,5,31,0,16,14,30,134,145,279,362,295,16,1,10,2.38462,0.0769231,20.7692,76.2712,13,1
Bangladesh,160,218.438,7.70625,0.4,211.106,7.05,0.325,546,Suhrawadi Shuvo,0,0,0,0,218,5,31,0,16,14,30,134,145,279,362,295,16,1,10,1,0,9.7,70.2899,10,1
South Africa,190,234.274,7.4,0.373684,232.363,7.33158,0.342105,549,JP Duminy,31,8,23,44,197,4,36,0,16,26,42,126,149,275,0,303,28,1,10,2.3252,0.186992,29.9675,80.2351,123,4
South Africa,190,234.274,7.4,0.373684,232.363,7.33158,0.342105,549,DA Miller,57,30,27,49,197,4,36,0,16,26,42,126,149,275,0,303,28,1,10,2.57353,0.132353,24.9412,97.2477,68,0
South Africa,190,234.274,7.4,0.373684,232.363,7.33158,0.342105,549,MV Boucher,0,0,0,0,197,4,36,0,16,26,42,126,149,275,0,303,28,1,10,2.21053,0.0877193,22.2281,89.3512,57,0
South Africa,190,234.274,7.4,0.373684,232.363,7.33158,0.342105,549,J Botha,0,0,0,0,197,4,36,0,16,26,42,126,149,275,0,303,28,1,10,1.09756,0,11.561,82.2917,41,1
Australia,228,239.627,7.69737,0.372807,232.079,7.23246,0.337719,549,BJ Haddin,13,0,13,22,171,6,14,1,8,19,27,70,142,212,304,223,11,0,10,3.14737,0.147368,26.7789,81.382,95,4
Australia,228,239.627,7.69737,0.372807,232.079,7.23246,0.337719,549,DE Bollinger,0,0,0,0,171,6,14,1,8,19,27,70,142,212,304,223,11,0,10,0.714286,0,7.14286,92.5926,7,0
Australia,228,239.627,7.69737,0.372807,232.079,7.23246,0.337719,549,XJ Doherty,0,0,0,4,171,6,14,1,8,19,27,70,142,212,304,223,11,0,10,0.190476,0,4.28571,52.0231,21,3
Australia,228,239.627,7.69737,0.372807,232.079,7.23246,0.337719,549,PJ Cummins,0,0,0,0,171,6,14,1,8,19,27,70,142,212,304,223,11,0,10,0.571429,0,4.85714,53.9683,7,3
South Africa,190,234.274,7.4,0.373684,232.363,7.33158,0.342105,550,JA Morkel,19,10,9,15,229,2,32,1,6,17,23,106,178,284,0,301,17,1,10,2.42424,0.0606061,19.9697,99.5468,33,0
South Africa,190,234.274,7.4,0.373684,232.363,7.33158,0.342105,550,HM Amla,112,32,80,131,229,2,32,1,6,17,23,106,178,284,0,301,17,1,10,5.20168,0.403361,48.7899,86.9292,119,4
South Africa,190,234.274,7.4,0.373684,232.363,7.33158,0.342105,550,F du Plessis,0,0,0,0,229,2,32,1,6,17,23,106,178,284,0,301,17,1,10,3.45122,0.292683,34.9268,83.135,82,4
South Africa,190,234.274,7.4,0.373684,232.363,7.33158,0.342105,550,JP Duminy,0,0,0,0,229,2,32,1,6,17,23,106,178,284,0,301,17,1,10,2.3252,0.186992,29.9675,80.2351,123,4
South Africa,190,234.274,7.4,0.373684,232.363,7.33158,0.342105,550,RJ Peterson,0,0,0,0,229,2,32,1,6,17,23,106,178,284,0,301,17,1,10,1.62069,0.0344828,15.7931,83.5766,29,1
South Africa,190,234.274,7.4,0.373684,232.363,7.33158,0.342105,550,DW Steyn,0,0,0,0,229,2,32,1,6,17,23,106,178,284,0,301,17,1,10,0.75,0,6.52273,61.588,44,1
South Africa,190,234.274,7.4,0.373684,232.363,7.33158,0.342105,550,M Morkel,0,0,0,0,229,2,32,1,6,17,23,106,178,284,0,301,17,1,10,0.6,0,5.28571,72.2656,35,1
Sri Lanka,244,223.373,7.09016,0.344262,227.578,7.47541,0.385246,551,LD Chandimal,70,12,58,102,161,5,32,0,16,21,37,88,142,230,0,236,6,0,10,2.18478,0.184783,25.7391,73.8615,92,4
Sri Lanka,244,223.373,7.09016,0.344262,227.578,7.47541,0.385246,551,AD Mathews,13,6,7,15,161,5,32,0,16,21,37,88,142,230,0,236,6,0,10,2.64122,0.198473,28.6794,82.3362,131,4
South Africa,190,234.274,7.4,0.373684,232.363,7.33158,0.342105,551,JP Duminy,62,6,56,80,186,3,30,1,4,13,17,78,155,233,237,237,4,1,10,2.3252,0.186992,29.9675,80.2351,123,4
South Africa,190,234.274,7.4,0.373684,232.363,7.33158,0.342105,551,F du Plessis,17,8,9,13,186,3,30,1,4,13,17,78,155,233,237,237,4,1,10,3.45122,0.292683,34.9268,83.135,82,4
South Africa,190,234.274,7.4,0.373684,232.363,7.33158,0.342105,551,JA Morkel,0,0,0,0,186,3,30,1,4,13,17,78,155,233,237,237,4,1,10,2.42424,0.0606061,19.9697,99.5468,33,0
Sri Lanka,244,223.373,7.09016,0.344262,227.578,7.47541,0.385246,552,KMDN Kulasekara,24,0,24,29,201,5,23,1,10,23,33,92,165,257,0,266,9,0,10,1.21,0.04,11.8,80.9328,100,1
Sri Lanka,244,223.373,7.09016,0.344262,227.578,7.47541,0.385246,552,SL Malinga,0,0,0,0,201,5,23,1,10,23,33,92,165,257,0,266,9,0,10,0.617284,0.0123457,4.97531,74.6296,81,1
Sri Lanka,244,223.373,7.09016,0.344262,227.578,7.47541,0.385246,552,HMRKB Herath,0,0,0,0,201,5,23,1,10,23,33,92,165,257,0,266,9,0,10,0.444444,0,5.18519,61.674,27,1
South Africa,190,234.274,7.4,0.373684,232.363,7.33158,0.342105,553,RJ Peterson,4,0,4,14,240,4,17,2,14,18,32,128,161,289,0,299,10,1,10,1.62069,0.0344828,15.7931,83.5766,29,1
South Africa,190,234.274,7.4,0.373684,232.363,7.33158,0.342105,553,WD Parnell,10,0,10,10,240,4,17,2,14,18,32,128,161,289,0,299,10,1,10,1.47826,0.0434783,15.8261,74.7433,23,1
South Africa,190,234.274,7.4,0.373684,232.363,7.33158,0.342105,553,VD Philander,0,0,0,0,240,4,17,2,14,18,32,128,161,289,0,299,10,1,10,0.8125,0,8.8125,66.5094,16,1
Sri Lanka,244,223.373,7.09016,0.344262,227.578,7.47541,0.385246,553,NLTC Perera,52,32,20,35,229,4,27,1,10,21,31,118,169,287,300,304,17,0,10,1.65333,0.0666667,14.32,105.397,75,0
Sri Lanka,244,223.373,7.09016,0.344262,227.578,7.47541,0.385246,553,AD Mathews,7,0,7,14,229,4,27,1,10,21,31,118,169,287,300,304,17,0,10,2.64122,0.198473,28.6794,82.3362,131,4
South Africa,190,234.274,7.4,0.373684,232.363,7.33158,0.342105,554,GC Smith,125,60,65,143,195,2,52,0,38,18,56,152,151,303,0,312,9,1,10,3.97,0.29,33.57,79.6819,100,4
South Africa,190,234.274,7.4,0.373684,232.363,7.33158,0.342105,554,JA Morkel,0,0,0,0,195,2,52,0,38,18,56,152,151,303,0,312,9,1,10,2.42424,0.0606061,19.9697,99.5468,33,0
South Africa,190,234.274,7.4,0.373684,232.363,7.33158,0.342105,554,AB de Villiers,92,42,50,84,195,2,52,0,38,18,56,152,151,303,0,312,9,1,10,5.04969,0.403727,47.2174,98.8428,161,4
South Africa,190,234.274,7.4,0.373684,232.363,7.33158,0.342105,554,JP Duminy,0,0,0,0,195,2,52,0,38,18,56,152,151,303,0,312,9,1,10,2.3252,0.186992,29.9675,80.2351,123,4
Sri Lanka,244,223.373,7.09016,0.344262,227.578,7.47541,0.385246,554,HDRL Thirimanne,51,16,35,50,232,3,29,1,22,10,32,136,157,293,313,314,21,0,10,2.77778,0.246914,31.5802,71.4725,81,4
Sri Lanka,244,223.373,7.09016,0.344262,227.578,7.47541,0.385246,554,AD Mathews,1,0,1,1,232,3,29,1,22,10,32,136,157,293,313,314,21,0,10,2.64122,0.198473,28.6794,82.3362,131,4
Sri Lanka,244,223.373,7.09016,0.344262,227.578,7.47541,0.385246,554,NLTC Perera,0,0,0,0,232,3,29,1,22,10,32,136,157,293,313,314,21,0,10,1.65333,0.0666667,14.32,105.397,75,0
Sri Lanka,244,223.373,7.09016,0.344262,227.578,7.47541,0.385246,554,KMDN Kulasekara,0,0,0,0,232,3,29,1,22,10,32,136,157,293,313,314,21,0,10,1.21,0.04,11.8,80.9328,100,1
Sri Lanka,244,223.373,7.09016,0.344262,227.578,7.47541,0.385246,554,HMRKB Herath,0,0,0,0,232,3,29,1,22,10,32,136,157,293,313,314,21,0,10,0.444444,0,5.18519,61.674,27,1
Sri Lanka,244,223.373,7.09016,0.344262,227.578,7.47541,0.385246,554,SMSM Senanayake,0,0,0,0,232,3,29,1,22,10,32,136,157,293,313,314,21,0,10,1.0625,0,8.625,87.0662,32,1
Sri Lanka,244,223.373,7.09016,0.344262,227.578,7.47541,0.385246,556,HMRKB Herath,5,0,5,8,143,6,35,2,4,15,19,64,133,197,0,208,11,1,10,0.444444,0,5.18519,61.674,27,1
Sri Lanka,244,223.373,7.09016,0.344262,227.578,7.47541,0.385246,556,KMDN Kulasekara,26,18,8,18,143,6,35,2,4,15,19,64,133,197,0,208,11,1,10,1.21,0.04,11.8,80.9328,100,1
Sri Lanka,244,223.373,7.09016,0.344262,227.578,7.47541,0.385246,556,BAW Mendis,0,0,0,0,143,6,35,2,4,15,19,64,133,197,0,208,11,1,10,0.447368,0,4.47368,66.4062,38,1
Sri Lanka,244,223.373,7.09016,0.344262,227.578,7.47541,0.385246,557,DPMD Jayawardene,10,0,10,19,219,3,18,1,18,17,35,114,158,272,0,286,14,1,10,3.20833,0.244792,31.6979,79.1109,192,4
Sri Lanka,244,223.373,7.09016,0.344262,227.578,7.47541,0.385246,557,LPC Silva,8,4,4,15,219,3,18,1,18,17,35,114,158,272,0,286,14,1,10,2.55556,0.244444,26.0222,69.4543,45,4
Sri Lanka,244,223.373,7.09016,0.344262,227.578,7.47541,0.385246,557,BMAJ Mendis,0,0,0,0,219,3,18,1,18,17,35,114,158,272,0,286,14,1,10,1.43243,0.027027,15.1622,82.8656,37,1
Sri Lanka,244,223.373,7.09016,0.344262,227.578,7.47541,0.385246,557,KMDN Kulasekara,0,0,0,0,219,3,18,1,18,17,35,114,158,272,0,286,14,1,10,1.21,0.04,11.8,80.9328,100,1
Sri Lanka,244,223.373,7.09016,0.344262,227.578,7.47541,0.385246,557,RMS Eranga,0,0,0,0,219,3,18,1,18,17,35,114,158,272,0,286,14,1,10,0.444444,0,3.77778,51.5152,9,3
Sri Lanka,244,223.373,7.09016,0.344262,227.578,7.47541,0.385246,557,SL Malinga,0,0,0,0,219,3,18,1,18,17,35,114,158,272,0,286,14,1,10,0.617284,0.0123457,4.97531,74.6296,81,1
Sri Lanka,244,223.373,7.09016,0.344262,227.578,7.47541,0.385246,560,HDRL Thirimanne,4,0,4,7,160,5,27,1,4,29,33,64,156,220,0,233,13,0,10,2.77778,0.246914,31.5802,71.4725,81,4
Sri Lanka,244,223.373,7.09016,0.344262,227.578,7.47541,0.385246,560,AD Mathews,11,4,7,12,160,5,27,1,4,29,33,64,156,220,0,233,13,0,10,2.64122,0.198473,28.6794,82.3362,131,4
Sri Lanka,244,223.373,7.09016,0.344262,227.578,7.47541,0.385246,560,KMDN Kulasekara,0,0,0,0,160,5,27,1,4,29,33,64,156,220,0,233,13,0,10,1.21,0.04,11.8,80.9328,100,1
Sri Lanka,244,223.373,7.09016,0.344262,227.578,7.47541,0.385246,560,SL Malinga,0,0,0,0,160,5,27,1,4,29,33,64,156,220,0,233,13,0,10,0.617284,0.0123457,4.97531,74.6296,81,1
India,259,242.378,7.15058,0.339768,244.568,7.12741,0.30888,560,RA Jadeja,22,4,18,25,189,6,27,0,8,3,11,102,125,227,234,234,7,0,10,2.12941,0.117647,21.7529,82.4342,85,4
India,259,242.378,7.15058,0.339768,244.568,7.12741,0.30888,560,R Ashwin,21,4,17,31,189,6,27,0,8,3,11,102,125,227,234,234,7,0,10,1.16364,0.0181818,11.9455,84.7742,55,1
Australia,228,239.627,7.69737,0.372807,232.079,7.23246,0.337719,561,CJ McKay,9,4,5,9,176,6,20,2,8,16,24,106,114,220,0,231,11,1,10,0.615385,0,6.88462,55.0769,26,3
Australia,228,239.627,7.69737,0.372807,232.079,7.23246,0.337719,561,MA Starc,8,4,4,12,176,6,20,2,8,16,24,106,114,220,0,231,11,1,10,0.692308,0,8.46154,70.0637,13,1
Australia,228,239.627,7.69737,0.372807,232.079,7.23246,0.337719,561,XJ Doherty,0,0,0,0,176,6,20,2,8,16,24,106,114,220,0,231,11,1,10,0.190476,0,4.28571,52.0231,21,3
Sri Lanka,244,223.373,7.09016,0.344262,227.578,7.47541,0.385246,561,AD Mathews,35,8,27,59,164,7,9,2,18,26,44,78,139,217,232,226,9,0,10,2.64122,0.198473,28.6794,82.3362,131,4
Sri Lanka,244,223.373,7.09016,0.344262,227.578,7.47541,0.385246,561,KTGD Prasad,0,0,0,1,164,7,9,2,18,26,44,78,139,217,232,226,9,0,10,1.33333,0,12.4444,106.667,9,0
Australia,228,239.627,7.69737,0.372807,232.079,7.23246,0.337719,562,MS Wade,1,0,1,4,208,4,22,1,8,22,30,96,164,260,0,269,9,1,10,1.86275,0.117647,20.3333,78.2642,51,1
Australia,228,239.627,7.69737,0.372807,232.079,7.23246,0.337719,562,DT Christian,29,4,25,28,208,4,22,1,8,22,30,96,164,260,0,269,9,1,10,1.44444,0,15.1111,86.901,18,0
Australia,228,239.627,7.69737,0.372807,232.079,7.23246,0.337719,562,CJ McKay,0,0,0,0,208,4,22,1,8,22,30,96,164,260,0,269,9,1,10,0.615385,0,6.88462,55.0769,26,3
India,259,242.378,7.15058,0.339768,244.568,7.12741,0.30888,562,SK Raina,32,14,18,27,187,4,32,0,10,29,39,78,180,258,270,270,12,0,10,3.11111,0.216374,28.9064,91.8944,171,0
India,259,242.378,7.15058,0.339768,244.568,7.12741,0.30888,562,MS Dhoni,24,0,24,44,187,4,32,0,10,29,39,78,180,258,270,270,12,0,10,3.47872,0.292553,36.7713,84.1612,188,4
India,259,242.378,7.15058,0.339768,244.568,7.12741,0.30888,562,RA Jadeja,0,0,0,0,187,4,32,0,10,29,39,78,180,258,270,270,12,0,10,2.12941,0.117647,21.7529,82.4342,85,4
India,259,242.378,7.15058,0.339768,244.568,7.12741,0.30888,562,R Ashwin,0,0,0,0,187,4,32,0,10,29,39,78,180,258,270,270,12,0,10,1.16364,0.0181818,11.9455,84.7742,55,1
Sri Lanka,244,223.373,7.09016,0.344262,227.578,7.47541,0.385246,563,AD Mathews,10,0,10,24,180,6,12,0,16,20,36,72,156,228,0,236,8,0,10,2.64122,0.198473,28.6794,82.3362,131,4
Sri Lanka,244,223.373,7.09016,0.344262,227.578,7.47541,0.385246,563,KMDN Kulasekara,6,0,6,16,180,6,12,0,16,20,36,72,156,228,0,236,8,0,10,1.21,0.04,11.8,80.9328,100,1
Sri Lanka,244,223.373,7.09016,0.344262,227.578,7.47541,0.385246,563,SMSM Senanayake,0,0,0,0,180,6,12,0,16,20,36,72,156,228,0,236,8,0,10,1.0625,0,8.625,87.0662,32,1
Sri Lanka,244,223.373,7.09016,0.344262,227.578,7.47541,0.385246,563,HMRKB Herath,0,0,0,0,180,6,12,0,16,20,36,72,156,228,0,236,8,0,10,0.444444,0,5.18519,61.674,27,1
India,259,242.378,7.15058,0.339768,244.568,7.12741,0.30888,563,MS Dhoni,34,8,26,53,173,4,12,2,20,23,43,72,156,228,237,236,8,0,10,3.47872,0.292553,36.7713,84.1612,188,4
India,259,242.378,7.15058,0.339768,244.568,7.12741,0.30888,563,R Ashwin,4,0,4,5,173,4,12,2,20,23,43,72,156,228,237,236,8,0,10,1.16364,0.0181818,11.9455,84.7742,55,1
India,259,242.378,7.15058,0.339768,244.568,7.12741,0.30888,563,IK Pathan,0,0,0,0,173,4,12,2,20,23,43,72,156,228,237,236,8,0,10,1.875,0.025,16.85,78.2811,40,1
India,259,242.378,7.15058,0.339768,244.568,7.12741,0.30888,563,R Vinay Kumar,0,0,0,0,173,4,12,2,20,23,43,72,156,228,237,236,8,0,10,0.636364,0,7.72727,57.047,11,3
Australia,228,239.627,7.69737,0.372807,232.079,7.23246,0.337719,565,DT Christian,4,0,4,4,174,3,41,2,30,17,47,106,156,262,0,288,26,1,10,1.44444,0,15.1111,86.901,18,0
Australia,228,239.627,7.69737,0.372807,232.079,7.23246,0.337719,565,DJ Hussey,5,0,5,4,174,3,41,2,30,17,47,106,156,262,0,288,26,1,10,2.54386,0.245614,29.2105,87.8628,57,4
Sri Lanka,244,223.373,7.09016,0.344262,227.578,7.47541,0.385246,566,HDRL Thirimanne,59,24,35,61,188,4,37,0,14,28,42,88,179,267,0,289,22,0,10,2.77778,0.246914,31.5802,71.4725,81,4
Sri Lanka,244,223.373,7.09016,0.344262,227.578,7.47541,0.385246,566,AD Mathews,24,12,12,23,188,4,37,0,14,28,42,88,179,267,0,289,22,0,10,2.64122,0.198473,28.6794,82.3362,131,4
Sri Lanka,244,223.373,7.09016,0.344262,227.578,7.47541,0.385246,566,NLTC Perera,0,0,0,0,188,4,37,0,14,28,42,88,179,267,0,289,22,0,10,1.65333,0.0666667,14.32,105.397,75,0
Sri Lanka,244,223.373,7.09016,0.344262,227.578,7.47541,0.385246,566,MF Maharoof,0,0,0,0,188,4,37,0,14,28,42,88,179,267,0,289,22,0,10,1.38889,0.0277778,14.3611,81.2893,36,1
India,259,242.378,7.15058,0.339768,244.568,7.12741,0.30888,566,IK Pathan,47,28,19,35,197,6,25,3,0,0,0,72,150,222,290,238,16,0,10,1.875,0.025,16.85,78.2811,40,1
Australia,228,239.627,7.69737,0.372807,232.079,7.23246,0.337719,567,DJ Hussey,29,14,15,18,192,3,48,2,10,25,35,124,151,275,0,280,5,1,10,2.54386,0.245614,29.2105,87.8628,57,4
Australia,228,239.627,7.69737,0.372807,232.079,7.23246,0.337719,567,DT Christian,2,0,2,1,192,3,48,2,10,25,35,124,151,275,0,280,5,1,10,1.44444,0,15.1111,86.901,18,0
Australia,228,239.627,7.69737,0.372807,232.079,7.23246,0.337719,567,B Lee,0,0,0,0,192,3,48,2,10,25,35,124,151,275,0,280,5,1,10,1.09091,0.0227273,10.8182,81.5068,44,1
Sri Lanka,244,223.373,7.09016,0.344262,227.578,7.47541,0.385246,567,MF Maharoof,2,0,2,3,210,4,22,1,18,18,36,92,176,268,281,283,15,0,10,1.38889,0.0277778,14.3611,81.2893,36,1
Sri Lanka,244,223.373,7.09016,0.344262,227.578,7.47541,0.385246,567,AD Mathews,16,4,12,21,210,4,22,1,18,18,36,92,176,268,281,283,15,0,10,2.64122,0.198473,28.6794,82.3362,131,4
Sri Lanka,244,223.373,7.09016,0.344262,227.578,7.47541,0.385246,567,NLTC Perera,0,0,0,0,210,4,22,1,18,18,36,92,176,268,281,283,15,0,10,1.65333,0.0666667,14.32,105.397,75,0
Sri Lanka,244,223.373,7.09016,0.344262,227.578,7.47541,0.385246,567,KMDN Kulasekara,0,0,0,0,210,4,22,1,18,18,36,92,176,268,281,283,15,0,10,1.21,0.04,11.8,80.9328,100,1
Sri Lanka,244,223.373,7.09016,0.344262,227.578,7.47541,0.385246,568,TM Dilshan,128,46,82,149,207,1,51,1,20,28,48,120,186,306,0,320,14,0,10,4.60199,0.273632,38.3632,86.0219,201,4
Sri Lanka,244,223.373,7.09016,0.344262,227.578,7.47541,0.385246,568,AD Mathews,0,0,0,0,207,1,51,1,20,28,48,120,186,306,0,320,14,0,10,2.64122,0.198473,28.6794,82.3362,131,4
Sri Lanka,244,223.373,7.09016,0.344262,227.578,7.47541,0.385246,568,LD Chandimal,0,0,0,0,207,1,51,1,20,28,48,120,186,306,0,320,14,0,10,2.18478,0.184783,25.7391,73.8615,92,4
Sri Lanka,244,223.373,7.09016,0.344262,227.578,7.47541,0.385246,569,HDRL Thirimanne,41,4,37,50,186,4,20,4,10,14,24,62,168,230,0,238,8,0,10,2.77778,0.246914,31.5802,71.4725,81,4
Sri Lanka,244,223.373,7.09016,0.344262,227.578,7.47541,0.385246,569,HMRKB Herath,2,0,2,5,186,4,20,4,10,14,24,62,168,230,0,238,8,0,10,0.444444,0,5.18519,61.674,27,1
Sri Lanka,244,223.373,7.09016,0.344262,227.578,7.47541,0.385246,569,SL Malinga,0,0,0,0,186,4,20,4,10,14,24,62,168,230,0,238,8,0,10,0.617284,0.0123457,4.97531,74.6296,81,1
Australia,228,239.627,7.69737,0.372807,232.079,7.23246,0.337719,569,DJ Hussey,55,16,39,63,163,6,27,2,6,17,23,66,147,213,239,229,16,1,10,2.54386,0.245614,29.2105,87.8628,57,4
Australia,228,239.627,7.69737,0.372807,232.079,7.23246,0.337719,569,XJ Doherty,3,0,3,4,163,6,27,2,6,17,23,66,147,213,239,229,16,1,10,0.190476,0,4.28571,52.0231,21,3
Australia,228,239.627,7.69737,0.372807,232.079,7.23246,0.337719,569,BW Hilfenhaus,0,0,0,0,163,6,27,2,6,17,23,66,147,213,239,229,16,1,10,0.222222,0,3.22222,40.8451,9,3
Australia,228,239.627,7.69737,0.372807,232.079,7.23246,0.337719,570,MJ Clarke,24,12,12,20,225,4,36,0,24,30,54,130,185,315,0,321,6,1,10,3.10294,0.301471,35.9265,74.0303,136,4
Australia,228,239.627,7.69737,0.372807,232.079,7.23246,0.337719,570,DA Warner,141,60,81,145,225,4,36,0,24,30,54,130,185,315,0,321,6,1,10,4.20312,0.265625,35.2031,87.7336,64,4
Australia,228,239.627,7.69737,0.372807,232.079,7.23246,0.337719,570,MEK Hussey,0,0,0,0,225,4,36,0,24,30,54,130,185,315,0,321,6,1,10,2.7563,0.260504,34.084,82.4893,119,4
Sri Lanka,244,223.373,7.09016,0.344262,227.578,7.47541,0.385246,570,KTGD Prasad,16,8,8,9,215,6,50,1,6,18,24,120,169,289,322,306,17,0,10,1.33333,0,12.4444,106.667,9,0
Sri Lanka,244,223.373,7.09016,0.344262,227.578,7.47541,0.385246,570,WU Tharanga,57,12,45,66,215,6,50,1,6,18,24,120,169,289,322,306,17,0,10,3.93985,0.263158,32.9699,71.6035,133,4
Sri Lanka,244,223.373,7.09016,0.344262,227.578,7.47541,0.385246,570,HMRKB Herath,0,0,0,0,215,6,50,1,6,18,24,120,169,289,322,306,17,0,10,0.444444,0,5.18519,61.674,27,1
Sri Lanka,244,223.373,7.09016,0.344262,227.578,7.47541,0.385246,570,SL Malinga,0,0,0,0,215,6,50,1,6,18,24,120,169,289,322,306,17,0,10,0.617284,0.0123457,4.97531,74.6296,81,1
Australia,228,239.627,7.69737,0.372807,232.079,7.23246,0.337719,571,DA Warner,99,22,77,137,182,2,46,0,10,25,35,78,185,263,0,271,8,1,10,4.20312,0.265625,35.2031,87.7336,64,4
Australia,228,239.627,7.69737,0.372807,232.079,7.23246,0.337719,571,MJ Clarke,100,38,62,83,182,2,46,0,10,25,35,78,185,263,0,271,8,1,10,3.10294,0.301471,35.9265,74.0303,136,4
Australia,228,239.627,7.69737,0.372807,232.079,7.23246,0.337719,571,MEK Hussey,0,0,0,0,182,2,46,0,10,25,35,78,185,263,0,271,8,1,10,2.7563,0.260504,34.084,82.4893,119,4
Australia,228,239.627,7.69737,0.372807,232.079,7.23246,0.337719,571,DJ Hussey,0,0,0,0,182,2,46,0,10,25,35,78,185,263,0,271,8,1,10,2.54386,0.245614,29.2105,87.8628,57,4
Australia,228,239.627,7.69737,0.372807,232.079,7.23246,0.337719,571,DT Christian,0,0,0,0,182,2,46,0,10,25,35,78,185,263,0,271,8,1,10,1.44444,0,15.1111,86.901,18,0
Australia,228,239.627,7.69737,0.372807,232.079,7.23246,0.337719,572,CJ McKay,24,14,10,27,181,7,24,0,4,14,18,86,137,223,0,231,8,1,10,0.615385,0,6.88462,55.0769,26,3
Australia,228,239.627,7.69737,0.372807,232.079,7.23246,0.337719,572,B Lee,23,8,15,42,181,7,24,0,4,14,18,86,137,223,0,231,8,1,10,1.09091,0.0227273,10.8182,81.5068,44,1
Australia,228,239.627,7.69737,0.372807,232.079,7.23246,0.337719,572,XJ Doherty,0,0,0,0,181,7,24,0,4,14,18,86,137,223,0,231,8,1,10,0.190476,0,4.28571,52.0231,21,3
Australia,228,239.627,7.69737,0.372807,232.079,7.23246,0.337719,572,NM Lyon,0,0,0,0,181,7,24,0,4,14,18,86,137,223,0,231,8,1,10,0.666667,0,4,133.333,3,0
Sri Lanka,244,223.373,7.09016,0.344262,227.578,7.47541,0.385246,572,WU Tharanga,70,22,48,121,153,7,28,0,4,9,13,70,124,194,232,215,21,0,10,3.93985,0.263158,32.9699,71.6035,133,4
Sri Lanka,244,223.373,7.09016,0.344262,227.578,7.47541,0.385246,572,MF Maharoof,12,4,8,15,153,7,28,0,4,9,13,70,124,194,232,215,21,0,10,1.38889,0.0277778,14.3611,81.2893,36,1
Sri Lanka,244,223.373,7.09016,0.344262,227.578,7.47541,0.385246,572,HMRKB Herath,0,0,0,0,153,7,28,0,4,9,13,70,124,194,232,215,21,0,10,0.444444,0,5.18519,61.674,27,1
Sri Lanka,244,223.373,7.09016,0.344262,227.578,7.47541,0.385246,572,SL Malinga,0,0,0,0,153,7,28,0,4,9,13,70,124,194,232,215,21,0,10,0.617284,0.0123457,4.97531,74.6296,81,1
New Zealand,184,233.745,7.39674,0.36413,227.951,7.30435,0.353261,573,DAJ Bracewell,3,0,3,7,192,6,25,2,4,11,15,104,128,232,0,248,16,1,10,0.428571,0,8.42857,65.5556,7,1
New Zealand,184,233.745,7.39674,0.36413,227.951,7.30435,0.353261,573,KD Mills,0,0,0,3,192,6,25,2,4,11,15,104,128,232,0,248,16,1,10,1.52542,0.0338983,12.8644,90.7895,59,0
New Zealand,184,233.745,7.39674,0.36413,227.951,7.30435,0.353261,573,TG Southee,0,0,0,0,192,6,25,2,4,11,15,104,128,232,0,248,16,1,10,0.764706,0,7.03922,92.7649,51,0
New Zealand,184,233.745,7.39674,0.36413,227.951,7.30435,0.353261,574,RJ Nicol,108,44,64,124,248,3,31,1,66,18,84,212,151,363,0,372,9,1,10,3.3,0.2,29.25,73.4003,20,4
New Zealand,184,233.745,7.39674,0.36413,227.951,7.30435,0.353261,574,TWM Latham,11,4,7,15,248,3,31,1,66,18,84,212,151,363,0,372,9,1,10,2.76471,0.147059,25.3529,75.2182,34,4
New Zealand,184,233.745,7.39674,0.36413,227.951,7.30435,0.353261,574,DG Brownlie,0,0,0,0,248,3,31,1,66,18,84,212,151,363,0,372,9,1,10,3,0,22.5556,72.5,9,1
New Zealand,184,233.745,7.39674,0.36413,227.951,7.30435,0.353261,574,AM Ellis,0,0,0,0,248,3,31,1,66,18,84,212,151,363,0,372,9,1,10,1,0,12.75,80.9524,12,1
Zimbabwe,142,212.077,7.5,0.380282,227.704,6.97887,0.316901,574,P Utseya,15,4,11,25,161,7,26,0,18,14,32,78,141,219,373,231,12,0,10,0.842105,0.0263158,11.8289,55.8385,76,3
Zimbabwe,142,212.077,7.5,0.380282,227.704,6.97887,0.316901,574,SW Masakadza,18,10,8,19,161,7,26,0,18,14,32,78,141,219,373,231,12,0,10,2,0,13.625,97.3214,8,0
New Zealand,184,233.745,7.39674,0.36413,227.951,7.30435,0.353261,575,BB McCullum,79,32,47,69,243,3,66,1,32,21,53,200,162,362,0,373,11,1,10,3.98611,0.201389,29.9028,98.4004,144,0
New Zealand,184,233.745,7.39674,0.36413,227.951,7.30435,0.353261,575,NL McCullum,21,18,3,7,243,3,66,1,32,21,53,200,162,362,0,373,11,1,10,1.63934,0.0655738,17.377,85.622,61,0
New Zealand,184,233.745,7.39674,0.36413,227.951,7.30435,0.353261,575,AM Ellis,0,0,0,0,243,3,66,1,32,21,53,200,162,362,0,373,11,1,10,1,0,12.75,80.9524,12,1
New Zealand,184,233.745,7.39674,0.36413,227.951,7.30435,0.353261,575,DAJ Bracewell,0,0,0,0,243,3,66,1,32,21,53,200,162,362,0,373,11,1,10,0.428571,0,8.42857,65.5556,7,1
New Zealand,184,233.745,7.39674,0.36413,227.951,7.30435,0.353261,575,TWM Latham,0,0,0,0,243,3,66,1,32,21,53,200,162,362,0,373,11,1,10,2.76471,0.147059,25.3529,75.2182,34,4
New Zealand,184,233.745,7.39674,0.36413,227.951,7.30435,0.353261,576,NL McCullum,0,0,0,0,174,4,29,2,10,16,26,86,143,229,0,253,24,1,10,1.63934,0.0655738,17.377,85.622,61,0
New Zealand,184,233.745,7.39674,0.36413,227.951,7.30435,0.353261,576,AM Ellis,17,8,9,13,174,4,29,2,10,16,26,86,143,229,0,253,24,1,10,1,0,12.75,80.9524,12,1
New Zealand,184,233.745,7.39674,0.36413,227.951,7.30435,0.353261,576,DAJ Bracewell,0,0,0,0,174,4,29,2,10,16,26,86,143,229,0,253,24,1,10,0.428571,0,8.42857,65.5556,7,1
New Zealand,184,233.745,7.39674,0.36413,227.951,7.30435,0.353261,576,KD Mills,0,0,0,0,174,4,29,2,10,16,26,86,143,229,0,253,24,1,10,1.52542,0.0338983,12.8644,90.7895,59,0
New Zealand,184,233.745,7.39674,0.36413,227.951,7.30435,0.353261,576,TG Southee,0,0,0,0,174,4,29,2,10,16,26,86,143,229,0,253,24,1,10,0.764706,0,7.03922,92.7649,51,0
South Africa,190,234.274,7.4,0.373684,232.363,7.33158,0.342105,576,F du Plessis,65,42,23,48,204,4,43,0,0,1,1,102,146,248,254,254,6,0,10,3.45122,0.292683,34.9268,83.135,82,4
New Zealand,184,233.745,7.39674,0.36413,227.951,7.30435,0.353261,577,MD Bates,4,4,0,1,159,5,22,4,6,5,11,82,110,192,0,206,14,1,10,2,0,9,90,1,0
India,259,242.378,7.15058,0.339768,244.568,7.12741,0.30888,578,RA Jadeja,25,16,9,20,190,5,40,0,26,21,47,118,159,277,0,300,23,1,10,2.12941,0.117647,21.7529,82.4342,85,4
India,259,242.378,7.15058,0.339768,244.568,7.12741,0.30888,578,MS Dhoni,51,24,27,50,190,5,40,0,26,21,47,118,159,277,0,300,23,1,10,3.47872,0.292553,36.7713,84.1612,188,4
India,259,242.378,7.15058,0.339768,244.568,7.12741,0.30888,578,R Ashwin,0,0,0,0,190,5,40,0,26,21,47,118,159,277,0,300,23,1,10,1.16364,0.0181818,11.9455,84.7742,55,1
India,259,242.378,7.15058,0.339768,244.568,7.12741,0.30888,578,P Kumar,0,0,0,0,190,5,40,0,26,21,47,118,159,277,0,300,23,1,10,1,0.03125,9.03125,86.0119,32,1
England,221,237.176,7.17647,0.289593,230.633,7.45701,0.384615,579,GP Swann,7,4,3,6,178,5,34,2,0,9,9,108,113,221,0,237,16,0,10,1.08696,0,10.3043,90.631,46,0
England,221,237.176,7.17647,0.289593,230.633,7.45701,0.384615,579,ST Finn,0,0,0,0,178,5,34,2,0,9,9,108,113,221,0,237,16,0,10,0.583333,0,5.41667,59.633,24,3
England,221,237.176,7.17647,0.289593,230.633,7.45701,0.384615,579,TT Bresnan,12,4,8,11,178,5,34,2,0,9,9,108,113,221,0,237,16,0,10,1.52381,0.015873,13.8095,88.4146,63,0
England,221,237.176,7.17647,0.289593,230.633,7.45701,0.384615,579,JW Dernbach,0,0,0,0,178,5,34,2,0,9,9,108,113,221,0,237,16,0,10,0.125,0,2.375,47.5,8,3
England,221,237.176,7.17647,0.289593,230.633,7.45701,0.384615,580,SR Patel,33,16,17,23,204,4,41,0,24,26,50,144,151,295,0,298,3,0,10,2.22727,0.0454545,21.9091,90.6015,22,0
England,221,237.176,7.17647,0.289593,230.633,7.45701,0.384615,580,IJL Trott,85,32,53,106,204,4,41,0,24,26,50,144,151,295,0,298,3,0,10,3.3871,0.403226,43.7903,75.2494,62,4
India,259,242.378,7.15058,0.339768,244.568,7.12741,0.30888,580,RA Jadeja,9,4,5,11,219,4,24,1,16,24,40,98,185,283,299,300,17,1,10,2.12941,0.117647,21.7529,82.4342,85,4
India,259,242.378,7.15058,0.339768,244.568,7.12741,0.30888,580,MS Dhoni,12,0,12,17,219,4,24,1,16,24,40,98,185,283,299,300,17,1,10,3.47872,0.292553,36.7713,84.1612,188,4
England,221,237.176,7.17647,0.289593,230.633,7.45701,0.384615,581,TT Bresnan,41,24,17,42,175,7,20,2,0,5,5,102,98,200,0,220,20,0,10,1.52381,0.015873,13.8095,88.4146,63,0
England,221,237.176,7.17647,0.289593,230.633,7.45701,0.384615,581,ST Finn,0,0,0,1,175,7,20,2,0,5,5,102,98,200,0,220,20,0,10,0.583333,0,5.41667,59.633,24,3
India,259,242.378,7.15058,0.339768,244.568,7.12741,0.30888,582,R Ashwin,3,0,3,6,178,5,30,1,26,27,53,130,131,261,0,271,10,1,10,1.16364,0.0181818,11.9455,84.7742,55,1
India,259,242.378,7.15058,0.339768,244.568,7.12741,0.30888,582,MS Dhoni,42,20,22,56,178,5,30,1,26,27,53,130,131,261,0,271,10,1,10,3.47872,0.292553,36.7713,84.1612,188,4
India,259,242.378,7.15058,0.339768,244.568,7.12741,0.30888,582,P Kumar,0,0,0,0,178,5,30,1,26,27,53,130,131,261,0,271,10,1,10,1,0.03125,9.03125,86.0119,32,1
Bangladesh,160,218.438,7.70625,0.4,211.106,7.05,0.325,583,Suhrawadi Shuvo,9,0,9,15,142,6,15,2,8,12,20,48,129,177,0,184,7,0,10,1,0,9.7,70.2899,10,1
Bangladesh,160,218.438,7.70625,0.4,211.106,7.05,0.325,583,Shafiul Islam,0,0,0,2,142,6,15,2,8,12,20,48,129,177,0,184,7,0,10,0.535714,0,4.42857,57.6744,28,3
Bangladesh,160,218.438,7.70625,0.4,211.106,7.05,0.325,583,Rubel Hossain,0,0,0,0,142,6,15,2,8,12,20,48,129,177,0,184,7,0,10,0.32,0,2.68,52.3438,25,3
Bangladesh,160,218.438,7.70625,0.4,211.106,7.05,0.325,584,Abdur Razzak,30,10,20,27,122,7,43,0,0,8,8,58,115,173,0,188,15,0,10,0.849315,0.0136986,8.39726,73.8554,73,1
Bangladesh,160,218.438,7.70625,0.4,211.106,7.05,0.325,584,Nasir Hossain,63,24,39,91,122,7,43,0,0,8,8,58,115,173,0,188,15,0,10,2.75,0.159091,27.0455,79.3863,44,4
Bangladesh,160,218.438,7.70625,0.4,211.106,7.05,0.325,584,Shafiul Islam,0,0,0,0,122,7,43,0,0,8,8,58,115,173,0,188,15,0,10,0.535714,0,4.42857,57.6744,28,3
Bangladesh,160,218.438,7.70625,0.4,211.106,7.05,0.325,584,Rubel Hossain,0,0,0,0,122,7,43,0,0,8,8,58,115,173,0,188,15,0,10,0.32,0,2.68,52.3438,25,3
Zimbabwe,142,212.077,7.5,0.380282,227.704,6.97887,0.316901,585,E Chigumbura,3,0,3,2,163,2,42,2,16,23,39,106,138,244,0,250,6,1,10,2.28947,0.114035,22.7895,77.7844,114,4
Zimbabwe,142,212.077,7.5,0.380282,227.704,6.97887,0.316901,585,T Taibu,79,32,47,100,163,2,42,2,16,23,39,106,138,244,0,250,6,1,10,2.36364,0.254545,29.4,71.0145,55,4
Zimbabwe,142,212.077,7.5,0.380282,227.704,6.97887,0.316901,585,F Mutizwa,0,0,0,0,163,2,42,2,16,23,39,106,138,244,0,250,6,1,10,1,0.111111,16.1111,57.3123,9,3
Zimbabwe,142,212.077,7.5,0.380282,227.704,6.97887,0.316901,585,KM Jarvis,0,0,0,0,163,2,42,2,16,23,39,106,138,244,0,250,6,1,10,0.333333,0,3.75,36.2903,12,3
Zimbabwe,142,212.077,7.5,0.380282,227.704,6.97887,0.316901,585,P Utseya,0,0,0,0,163,2,42,2,16,23,39,106,138,244,0,250,6,1,10,0.842105,0.0263158,11.8289,55.8385,76,3
Bangladesh,160,218.438,7.70625,0.4,211.106,7.05,0.325,585,Mahmudullah,11,4,7,7,163,4,42,1,18,16,34,88,151,239,251,245,6,0,10,2.26531,0.153061,24.4286,70.9544,98,4
Bangladesh,160,218.438,7.70625,0.4,211.106,7.05,0.325,585,Mushfiqur Rahim,71,20,51,85,163,4,42,1,18,16,34,88,151,239,251,245,6,0,10,2.61111,0.18254,27.7778,75.2526,126,4
Bangladesh,160,218.438,7.70625,0.4,211.106,7.05,0.325,585,Nasir Hossain,0,0,0,0,163,4,42,1,18,16,34,88,151,239,251,245,6,0,10,2.75,0.159091,27.0455,79.3863,44,4
Bangladesh,160,218.438,7.70625,0.4,211.106,7.05,0.325,585,Shafiul Islam,0,0,0,0,163,4,42,1,18,16,34,88,151,239,251,245,6,0,10,0.535714,0,4.42857,57.6744,28,3
Bangladesh,160,218.438,7.70625,0.4,211.106,7.05,0.325,585,Rubel Hossain,0,0,0,0,163,4,42,1,18,16,34,88,151,239,251,245,6,0,10,0.32,0,2.68,52.3438,25,3
Bangladesh,160,218.438,7.70625,0.4,211.106,7.05,0.325,586,Shakib Al Hasan,67,18,49,64,159,5,33,0,28,19,47,92,147,239,0,253,14,0,10,2.86992,0.252033,29.9106,79.0163,123,4
Bangladesh,160,218.438,7.70625,0.4,211.106,7.05,0.325,586,Mahmudullah,33,10,23,53,159,5,33,0,28,19,47,92,147,239,0,253,14,0,10,2.26531,0.153061,24.4286,70.9544,98,4
Bangladesh,160,218.438,7.70625,0.4,211.106,7.05,0.325,586,Nasir Hossain,0,0,0,0,159,5,33,0,28,19,47,92,147,239,0,253,14,0,10,2.75,0.159091,27.0455,79.3863,44,4
Pakistan,211,222.621,7.38389,0.393365,235.517,7.54976,0.336493,587,Adnan Akmal,9,0,9,14,188,5,17,1,14,22,36,90,151,241,0,247,6,0,10,0.75,0,15.25,66.3043,4,1
Pakistan,211,222.621,7.38389,0.393365,235.517,7.54976,0.336493,587,Sohail Tanvir,0,0,0,5,188,5,17,1,14,22,36,90,151,241,0,247,6,0,10,1.18919,0,9.08108,81.5534,37,1
Pakistan,211,222.621,7.38389,0.393365,235.517,7.54976,0.336493,587,Saeed Ajmal,0,0,0,0,188,5,17,1,14,22,36,90,151,241,0,247,6,0,10,0.34375,0,4.60938,58.3004,64,3
Zimbabwe,142,212.077,7.5,0.380282,227.704,6.97887,0.316901,587,E Chigumbura,6,4,2,9,169,3,31,2,12,23,35,94,141,235,248,242,7,1,10,2.28947,0.114035,22.7895,77.7844,114,4
Zimbabwe,142,212.077,7.5,0.380282,227.704,6.97887,0.316901,587,BRM Taylor,69,20,49,89,169,3,31,2,12,23,35,94,141,235,248,242,7,1,10,3.3,0.26,33.56,76.3421,100,4
Zimbabwe,142,212.077,7.5,0.380282,227.704,6.97887,0.316901,587,GA Lamb,0,0,0,0,169,3,31,2,12,23,35,94,141,235,248,242,7,1,10,0.333333,0,14.0833,46.1749,12,3
Zimbabwe,142,212.077,7.5,0.380282,227.704,6.97887,0.316901,587,P Utseya,0,0,0,0,169,3,31,2,12,23,35,94,141,235,248,242,7,1,10,0.842105,0.0263158,11.8289,55.8385,76,3
Zimbabwe,142,212.077,7.5,0.380282,227.704,6.97887,0.316901,588,T Taibu,22,12,10,24,137,3,29,1,26,16,42,82,126,208,0,225,17,1,10,2.36364,0.254545,29.4,71.0145,55,4
Zimbabwe,142,212.077,7.5,0.380282,227.704,6.97887,0.316901,588,MN Waller,3,0,3,5,137,3,29,1,26,16,42,82,126,208,0,225,17,1,10,2.07895,0.0789474,19.3684,68.9784,38,1
Zimbabwe,142,212.077,7.5,0.380282,227.704,6.97887,0.316901,588,E Chigumbura,0,0,0,0,137,3,29,1,26,16,42,82,126,208,0,225,17,1,10,2.28947,0.114035,22.7895,77.7844,114,4
Zimbabwe,142,212.077,7.5,0.380282,227.704,6.97887,0.316901,588,P Utseya,0,0,0,0,137,3,29,1,26,16,42,82,126,208,0,225,17,1,10,0.842105,0.0263158,11.8289,55.8385,76,3
Pakistan,211,222.621,7.38389,0.393365,235.517,7.54976,0.336493,589,Misbah-ul-Haq,13,4,9,14,206,4,20,1,8,25,33,108,151,259,0,270,11,0,10,2.95238,0.285714,34.9921,71.8195,126,4
Pakistan,211,222.621,7.38389,0.393365,235.517,7.54976,0.336493,589,Adnan Akmal,7,0,7,17,206,4,20,1,8,25,33,108,151,259,0,270,11,0,10,0.75,0,15.25,66.3043,4,1
Zimbabwe,142,212.077,7.5,0.380282,227.704,6.97887,0.316901,589,P Utseya,3,0,3,4,180,5,28,2,4,25,29,90,147,237,271,242,5,1,10,0.842105,0.0263158,11.8289,55.8385,76,3
Zimbabwe,142,212.077,7.5,0.380282,227.704,6.97887,0.316901,589,RW Price,2,0,2,3,180,5,28,2,4,25,29,90,147,237,271,242,5,1,10,0.666667,0,7.16667,57.2062,36,3
Zimbabwe,142,212.077,7.5,0.380282,227.704,6.97887,0.316901,589,KM Jarvis,0,0,0,0,180,5,28,2,4,25,29,90,147,237,271,242,5,1,10,0.333333,0,3.75,36.2903,12,3
Zimbabwe,142,212.077,7.5,0.380282,227.704,6.97887,0.316901,589,BV Vitori,0,0,0,0,180,5,28,2,4,25,29,90,147,237,271,242,5,1,10,0.9,0,6.3,86.3014,10,1
Zimbabwe,142,212.077,7.5,0.380282,227.704,6.97887,0.316901,592,BRM Taylor,96,40,56,103,155,4,34,2,18,21,39,88,140,228,0,231,3,1,10,3.3,0.26,33.56,76.3421,100,4
Zimbabwe,142,212.077,7.5,0.380282,227.704,6.97887,0.316901,592,P Utseya,0,0,0,0,155,4,34,2,18,21,39,88,140,228,0,231,3,1,10,0.842105,0.0263158,11.8289,55.8385,76,3
Zimbabwe,142,212.077,7.5,0.380282,227.704,6.97887,0.316901,593,KO Meth,3,0,3,7,178,5,21,1,30,13,43,128,114,242,0,259,17,1,10,0.8,0,6.4,61.5385,5,1
Zimbabwe,142,212.077,7.5,0.380282,227.704,6.97887,0.316901,593,BRM Taylor,93,46,47,96,178,5,21,1,30,13,43,128,114,242,0,259,17,1,10,3.3,0.26,33.56,76.3421,100,4
Zimbabwe,142,212.077,7.5,0.380282,227.704,6.97887,0.316901,593,P Utseya,0,0,0,0,178,5,21,1,30,13,43,128,114,242,0,259,17,1,10,0.842105,0.0263158,11.8289,55.8385,76,3
Zimbabwe,142,212.077,7.5,0.380282,227.704,6.97887,0.316901,593,RW Price,0,0,0,0,178,5,21,1,30,13,43,128,114,242,0,259,17,1,10,0.666667,0,7.16667,57.2062,36,3
New Zealand,184,233.745,7.39674,0.36413,227.951,7.30435,0.353261,593,KS Williamson,5,0,5,8,199,2,31,2,12,8,20,96,154,250,260,261,11,0,10,4.31707,0.390244,43.0488,82.8833,82,4
New Zealand,184,233.745,7.39674,0.36413,227.951,7.30435,0.353261,593,BJ Watling,13,8,5,11,199,2,31,2,12,8,20,96,154,250,260,261,11,0,10,3,0.263158,27.7895,66.9202,19,4
New Zealand,184,233.745,7.39674,0.36413,227.951,7.30435,0.353261,593,JEC Franklin,0,0,0,0,199,2,31,2,12,8,20,96,154,250,260,261,11,0,10,1.67308,0.0769231,18.7115,77.5299,52,1
New Zealand,184,233.745,7.39674,0.36413,227.951,7.30435,0.353261,593,JDP Oram,0,0,0,0,199,2,31,2,12,8,20,96,154,250,260,261,11,0,10,2.70833,0.1875,25.0417,95.8533,48,0
New Zealand,184,233.745,7.39674,0.36413,227.951,7.30435,0.353261,594,KS Williamson,61,24,37,57,198,4,42,0,40,25,65,154,151,305,0,328,23,0,10,4.31707,0.390244,43.0488,82.8833,82,4
New Zealand,184,233.745,7.39674,0.36413,227.951,7.30435,0.353261,594,LRPL Taylor,94,40,54,114,198,4,42,0,40,25,65,154,151,305,0,328,23,0,10,3.68382,0.301471,36.7206,79.3959,136,4
New Zealand,184,233.745,7.39674,0.36413,227.951,7.30435,0.353261,594,NL McCullum,0,0,0,0,198,4,42,0,40,25,65,154,151,305,0,328,23,0,10,1.63934,0.0655738,17.377,85.622,61,0
Zimbabwe,142,212.077,7.5,0.380282,227.704,6.97887,0.316901,594,MN Waller,77,38,39,60,257,5,31,2,14,17,31,162,157,319,329,329,10,1,10,2.07895,0.0789474,19.3684,68.9784,38,1
Zimbabwe,142,212.077,7.5,0.380282,227.704,6.97887,0.316901,594,N Mushangwe,0,0,0,3,257,5,31,2,14,17,31,162,157,319,329,329,10,1,10,1.25,0,9.5,86.3636,4,1
Zimbabwe,142,212.077,7.5,0.380282,227.704,6.97887,0.316901,594,RW Price,0,0,0,0,257,5,31,2,14,17,31,162,157,319,329,329,10,1,10,0.666667,0,7.16667,57.2062,36,3
Sri Lanka,244,223.373,7.09016,0.344262,227.578,7.47541,0.385246,595,BMAJ Mendis,5,0,5,9,153,3,25,2,10,22,32,82,128,210,0,235,25,0,10,1.43243,0.027027,15.1622,82.8656,37,1
Sri Lanka,244,223.373,7.09016,0.344262,227.578,7.47541,0.385246,595,DPMD Jayawardene,45,20,25,52,153,3,25,2,10,22,32,82,128,210,0,235,25,0,10,3.20833,0.244792,31.6979,79.1109,192,4
Sri Lanka,244,223.373,7.09016,0.344262,227.578,7.47541,0.385246,595,NLTC Perera,0,0,0,0,153,3,25,2,10,22,32,82,128,210,0,235,25,0,10,1.65333,0.0666667,14.32,105.397,75,0
Sri Lanka,244,223.373,7.09016,0.344262,227.578,7.47541,0.385246,595,SL Malinga,0,0,0,0,153,3,25,2,10,22,32,82,128,210,0,235,25,0,10,0.617284,0.0123457,4.97531,74.6296,81,1
Pakistan,211,222.621,7.38389,0.393365,235.517,7.54976,0.336493,595,Saeed Ajmal,5,0,5,15,158,8,31,1,4,4,8,68,129,197,236,210,13,0,10,0.34375,0,4.60938,58.3004,64,3
Pakistan,211,222.621,7.38389,0.393365,235.517,7.54976,0.336493,595,Aizaz Cheema,1,0,1,7,158,8,31,1,4,4,8,68,129,197,236,210,13,0,10,0.333333,0,4.33333,57.7778,6,3
Pakistan,211,222.621,7.38389,0.393365,235.517,7.54976,0.336493,596,Shahid Afridi,15,4,11,15,188,5,26,0,16,13,29,100,143,243,0,257,14,0,10,2.72917,0.0972222,21.4097,127.766,144,0
Pakistan,211,222.621,7.38389,0.393365,235.517,7.54976,0.336493,596,Younis Khan,26,4,22,38,188,5,26,0,16,13,29,100,143,243,0,257,14,0,10,2.64655,0.215517,28.5,73.2713,116,4
Pakistan,211,222.621,7.38389,0.393365,235.517,7.54976,0.336493,596,Sarfraz Ahmed,0,0,0,0,188,5,26,0,16,13,29,100,143,243,0,257,14,0,10,2.04878,0.097561,25.4878,83.9357,41,4
Pakistan,211,222.621,7.38389,0.393365,235.517,7.54976,0.336493,596,Sohail Tanvir,0,0,0,0,188,5,26,0,16,13,29,100,143,243,0,257,14,0,10,1.18919,0,9.08108,81.5534,37,1
Pakistan,211,222.621,7.38389,0.393365,235.517,7.54976,0.336493,596,Umar Gul,0,0,0,0,188,5,26,0,16,13,29,100,143,243,0,257,14,0,10,0.77193,0,7.14035,68.2886,57,1
Sri Lanka,244,223.373,7.09016,0.344262,227.578,7.47541,0.385246,596,NLTC Perera,1,0,1,1,173,5,33,2,4,11,15,90,131,221,258,236,15,0,10,1.65333,0.0666667,14.32,105.397,75,0
Sri Lanka,244,223.373,7.09016,0.344262,227.578,7.47541,0.385246,596,AD Mathews,25,14,11,34,173,5,33,2,4,11,15,90,131,221,258,236,15,0,10,2.64122,0.198473,28.6794,82.3362,131,4
Sri Lanka,244,223.373,7.09016,0.344262,227.578,7.47541,0.385246,596,S Prasanna,0,0,0,0,173,5,33,2,4,11,15,90,131,221,258,236,15,0,10,1.25,0,9.5,78.8382,20,1
Sri Lanka,244,223.373,7.09016,0.344262,227.578,7.47541,0.385246,596,CRD Fernando,0,0,0,0,173,5,33,2,4,11,15,90,131,221,258,236,15,0,10,0.571429,0,5.42857,64.7727,21,1
Pakistan,211,222.621,7.38389,0.393365,235.517,7.54976,0.336493,597,Saeed Ajmal,14,0,14,29,138,7,38,1,4,10,14,70,120,190,0,200,10,0,10,0.34375,0,4.60938,58.3004,64,3
Pakistan,211,222.621,7.38389,0.393365,235.517,7.54976,0.336493,597,Umar Gul,2,0,2,3,138,7,38,1,4,10,14,70,120,190,0,200,10,0,10,0.77193,0,7.14035,68.2886,57,1
Pakistan,211,222.621,7.38389,0.393365,235.517,7.54976,0.336493,597,Aizaz Cheema,0,0,0,0,138,7,38,1,4,10,14,70,120,190,0,200,10,0,10,0.333333,0,4.33333,57.7778,6,3
Sri Lanka,244,223.373,7.09016,0.344262,227.578,7.47541,0.385246,597,NLTC Perera,7,4,3,9,150,5,14,4,0,0,0,70,94,164,201,174,10,0,10,1.65333,0.0666667,14.32,105.397,75,0
Sri Lanka,244,223.373,7.09016,0.344262,227.578,7.47541,0.385246,598,S Prasanna,1,0,1,7,158,5,14,2,10,19,29,70,131,201,0,218,17,0,10,1.25,0,9.5,78.8382,20,1
Sri Lanka,244,223.373,7.09016,0.344262,227.578,7.47541,0.385246,598,NLTC Perera,7,0,7,7,158,5,14,2,10,19,29,70,131,201,0,218,17,0,10,1.65333,0.0666667,14.32,105.397,75,0
Sri Lanka,244,223.373,7.09016,0.344262,227.578,7.47541,0.385246,598,SL Malinga,0,0,0,0,158,5,14,2,10,19,29,70,131,201,0,218,17,0,10,0.617284,0.0123457,4.97531,74.6296,81,1
Pakistan,211,222.621,7.38389,0.393365,235.517,7.54976,0.336493,598,Umar Akmal,47,20,27,49,166,4,25,2,12,3,15,80,126,206,219,219,13,0,10,2.76842,0.2,27.5053,82.7947,95,4
Pakistan,211,222.621,7.38389,0.393365,235.517,7.54976,0.336493,598,Sohail Tanvir,0,0,0,3,166,4,25,2,12,3,15,80,126,206,219,219,13,0,10,1.18919,0,9.08108,81.5534,37,1
England,221,237.176,7.17647,0.289593,230.633,7.45701,0.384615,599,AN Cook,133,56,77,140,184,4,24,1,16,19,35,92,151,243,0,260,17,0,10,4.17045,0.272727,35.75,75.5524,88,4
England,221,237.176,7.17647,0.289593,230.633,7.45701,0.384615,599,SR Patel,0,0,0,0,184,4,24,1,16,19,35,92,151,243,0,260,17,0,10,2.22727,0.0454545,21.9091,90.6015,22,0
England,221,237.176,7.17647,0.289593,230.633,7.45701,0.384615,599,SCJ Broad,0,0,0,0,184,4,24,1,16,19,35,92,151,243,0,260,17,0,10,0.725806,0,8.04839,74.0356,62,1
England,221,237.176,7.17647,0.289593,230.633,7.45701,0.384615,599,GP Swann,0,0,0,0,184,4,24,1,16,19,35,92,151,243,0,260,17,0,10,1.08696,0,10.3043,90.631,46,0
England,221,237.176,7.17647,0.289593,230.633,7.45701,0.384615,600,EJG Morgan,6,0,6,15,181,2,20,1,10,23,33,82,152,234,0,250,16,0,10,3.19549,0.233083,30.0526,86.9291,133,4
England,221,237.176,7.17647,0.289593,230.633,7.45701,0.384615,600,RS Bopara,44,12,32,52,181,2,20,1,10,23,33,82,152,234,0,250,16,0,10,2.22115,0.144231,25.1538,75.9361,104,4
Pakistan,211,222.621,7.38389,0.393365,235.517,7.54976,0.336493,600,Misbah-ul-Haq,40,4,36,54,161,5,27,1,12,9,21,82,127,209,251,230,21,0,10,2.95238,0.285714,34.9921,71.8195,126,4
Pakistan,211,222.621,7.38389,0.393365,235.517,7.54976,0.336493,600,Abdur Rehman,0,0,0,4,161,5,27,1,12,9,21,82,127,209,251,230,21,0,10,0.52381,0,6.04762,55.7018,21,3
Pakistan,211,222.621,7.38389,0.393365,235.517,7.54976,0.336493,600,Umar Gul,0,0,0,0,161,5,27,1,12,9,21,82,127,209,251,230,21,0,10,0.77193,0,7.14035,68.2886,57,1
Pakistan,211,222.621,7.38389,0.393365,235.517,7.54976,0.336493,600,Saeed Ajmal,0,0,0,0,161,5,27,1,12,9,21,82,127,209,251,230,21,0,10,0.34375,0,4.60938,58.3004,64,3
Pakistan,211,222.621,7.38389,0.393365,235.517,7.54976,0.336493,600,Aizaz Cheema,0,0,0,0,161,5,27,1,12,9,21,82,127,209,251,230,21,0,10,0.333333,0,4.33333,57.7778,6,3
Pakistan,211,222.621,7.38389,0.393365,235.517,7.54976,0.336493,601,Adnan Akmal,8,0,8,12,163,6,19,1,10,16,26,66,142,208,0,222,14,0,10,0.75,0,15.25,66.3043,4,1
Pakistan,211,222.621,7.38389,0.393365,235.517,7.54976,0.336493,601,Umar Gul,11,6,5,16,163,6,19,1,10,16,26,66,142,208,0,222,14,0,10,0.77193,0,7.14035,68.2886,57,1
Pakistan,211,222.621,7.38389,0.393365,235.517,7.54976,0.336493,601,Saeed Ajmal,0,0,0,0,163,6,19,1,10,16,26,66,142,208,0,222,14,0,10,0.34375,0,4.60938,58.3004,64,3
Pakistan,211,222.621,7.38389,0.393365,235.517,7.54976,0.336493,601,Aizaz Cheema,0,0,0,0,163,6,19,1,10,16,26,66,142,208,0,222,14,0,10,0.333333,0,4.33333,57.7778,6,3
Pakistan,211,222.621,7.38389,0.393365,235.517,7.54976,0.336493,602,Shahid Afridi,4,0,4,5,173,4,29,1,12,15,27,70,159,229,0,237,8,0,10,2.72917,0.0972222,21.4097,127.766,144,0
Pakistan,211,222.621,7.38389,0.393365,235.517,7.54976,0.336493,602,Misbah-ul-Haq,39,10,29,42,173,4,29,1,12,15,27,70,159,229,0,237,8,0,10,2.95238,0.285714,34.9921,71.8195,126,4
Pakistan,211,222.621,7.38389,0.393365,235.517,7.54976,0.336493,602,Adnan Akmal,0,0,0,0,173,4,29,1,12,15,27,70,159,229,0,237,8,0,10,0.75,0,15.25,66.3043,4,1
Pakistan,211,222.621,7.38389,0.393365,235.517,7.54976,0.336493,602,Abdur Rehman,0,0,0,0,173,4,29,1,12,15,27,70,159,229,0,237,8,0,10,0.52381,0,6.04762,55.7018,21,3
Pakistan,211,222.621,7.38389,0.393365,235.517,7.54976,0.336493,602,Saeed Ajmal,0,0,0,0,173,4,29,1,12,15,27,70,159,229,0,237,8,0,10,0.34375,0,4.60938,58.3004,64,3
England,221,237.176,7.17647,0.289593,230.633,7.45701,0.384615,602,SR Patel,7,0,7,13,167,5,32,0,14,15,29,96,132,228,238,241,13,0,10,2.22727,0.0454545,21.9091,90.6015,22,0
England,221,237.176,7.17647,0.289593,230.633,7.45701,0.384615,602,KP Pietersen,115,50,65,148,167,5,32,0,14,15,29,96,132,228,238,241,13,0,10,3.69892,0.236559,33.4946,82.2117,93,4
England,221,237.176,7.17647,0.289593,230.633,7.45701,0.384615,602,TT Bresnan,0,0,0,0,167,5,32,0,14,15,29,96,132,228,238,241,13,0,10,1.52381,0.015873,13.8095,88.4146,63,0
West Indies,176,217.33,7.15909,0.3125,225.278,7.57386,0.380682,603,DM Bravo,10,4,6,9,202,1,39,2,28,19,47,130,158,288,0,298,10,0,10,3,0.226667,28.52,67.4551,75,4
West Indies,176,217.33,7.15909,0.3125,225.278,7.57386,0.380682,603,KA Pollard,17,10,7,12,202,1,39,2,28,19,47,130,158,288,0,298,10,0,10,2.70513,0.115385,24.5,88.0645,78,4
West Indies,176,217.33,7.15909,0.3125,225.278,7.57386,0.380682,603,DP Hyatt,0,0,0,0,202,1,39,2,28,19,47,130,158,288,0,298,10,0,10,1.55556,0,12.4444,59.2593,9,3
West Indies,176,217.33,7.15909,0.3125,225.278,7.57386,0.380682,603,AD Russell,0,0,0,0,202,1,39,2,28,19,47,130,158,288,0,298,10,0,10,3.38095,0.0952381,23.2857,129.536,42,0
Bangladesh,160,218.438,7.70625,0.4,211.106,7.05,0.325,603,Shakib Al Hasan,50,14,36,44,181,5,31,1,12,18,30,80,162,242,299,258,16,1,10,2.86992,0.252033,29.9106,79.0163,123,4
Bangladesh,160,218.438,7.70625,0.4,211.106,7.05,0.325,603,Nasir Hossain,4,0,4,6,181,5,31,1,12,18,30,80,162,242,299,258,16,1,10,2.75,0.159091,27.0455,79.3863,44,4
Bangladesh,160,218.438,7.70625,0.4,211.106,7.05,0.325,603,Abdur Razzak,0,0,0,0,181,5,31,1,12,18,30,80,162,242,299,258,16,1,10,0.849315,0.0136986,8.39726,73.8554,73,1
England,221,237.176,7.17647,0.289593,230.633,7.45701,0.384615,605,SCJ Broad,1,0,1,1,211,5,25,1,18,24,42,104,174,278,0,288,10,1,10,0.725806,0,8.04839,74.0356,62,1
England,221,237.176,7.17647,0.289593,230.633,7.45701,0.384615,605,C Kieswetter,17,4,13,23,211,5,25,1,18,24,42,104,174,278,0,288,10,1,10,3.43243,0.135135,26.4324,88.0288,37,4
West Indies,176,217.33,7.15909,0.3125,225.278,7.57386,0.380682,606,DJ Bravo,72,44,28,78,173,5,39,0,4,13,17,130,99,229,0,238,9,0,10,2.35514,0.11215,23.1589,80.9011,107,4
West Indies,176,217.33,7.15909,0.3125,225.278,7.57386,0.380682,606,DJG Sammy,21,10,11,18,173,5,39,0,4,13,17,130,99,229,0,238,9,0,10,2.25,0.09,18.25,95.8005,100,0
West Indies,176,217.33,7.15909,0.3125,225.278,7.57386,0.380682,606,D Ramdin,0,0,0,0,173,5,39,0,4,13,17,130,99,229,0,238,9,0,10,1.7439,0.097561,19.1951,81.1759,82,1
West Indies,176,217.33,7.15909,0.3125,225.278,7.57386,0.380682,606,TL Best,0,0,0,0,173,5,39,0,4,13,17,130,99,229,0,238,9,0,10,0.375,0,4,42.6667,8,3
West Indies,176,217.33,7.15909,0.3125,225.278,7.57386,0.380682,606,SP Narine,0,0,0,0,173,5,39,0,4,13,17,130,99,229,0,238,9,0,10,1.05882,0,8.55882,76.378,34,1
West Indies,176,217.33,7.15909,0.3125,225.278,7.57386,0.380682,606,R Rampaul,0,0,0,0,173,5,39,0,4,13,17,130,99,229,0,238,9,0,10,1.30303,0.030303,9.90909,77.4882,33,1
England,221,237.176,7.17647,0.289593,230.633,7.45701,0.384615,607,C Kieswetter,9,0,9,16,181,3,29,1,34,20,54,108,156,264,0,272,8,1,10,3.43243,0.135135,26.4324,88.0288,37,4
England,221,237.176,7.17647,0.289593,230.633,7.45701,0.384615,607,EJG Morgan,51,18,33,47,181,3,29,1,34,20,54,108,156,264,0,272,8,1,10,3.19549,0.233083,30.0526,86.9291,133,4
Australia,228,239.627,7.69737,0.372807,232.079,7.23246,0.337719,607,CJ McKay,2,0,2,5,177,5,40,2,12,18,30,110,137,247,273,257,10,0,10,0.615385,0,6.88462,55.0769,26,3
Australia,228,239.627,7.69737,0.372807,232.079,7.23246,0.337719,607,B Lee,9,8,1,8,177,5,40,2,12,18,30,110,137,247,273,257,10,0,10,1.09091,0.0227273,10.8182,81.5068,44,1
Australia,228,239.627,7.69737,0.372807,232.079,7.23246,0.337719,607,PJ Cummins,0,0,0,0,177,5,40,2,12,18,30,110,137,247,273,257,10,0,10,0.571429,0,4.85714,53.9683,7,3
Australia,228,239.627,7.69737,0.372807,232.079,7.23246,0.337719,607,XJ Doherty,0,0,0,0,177,5,40,2,12,18,30,110,137,247,273,257,10,0,10,0.190476,0,4.28571,52.0231,21,3
Australia,228,239.627,7.69737,0.372807,232.079,7.23246,0.337719,608,GJ Bailey,63,28,35,83,155,4,35,1,10,26,36,86,140,226,0,251,25,0,10,3.34921,0.301587,36.3492,84.658,63,4
Australia,228,239.627,7.69737,0.372807,232.079,7.23246,0.337719,608,MS Wade,0,0,0,2,155,4,35,1,10,26,36,86,140,226,0,251,25,0,10,1.86275,0.117647,20.3333,78.2642,51,1
Australia,228,239.627,7.69737,0.372807,232.079,7.23246,0.337719,608,B Lee,0,0,0,0,155,4,35,1,10,26,36,86,140,226,0,251,25,0,10,1.09091,0.0227273,10.8182,81.5068,44,1
Australia,228,239.627,7.69737,0.372807,232.079,7.23246,0.337719,608,MG Johnson,0,0,0,0,155,4,35,1,10,26,36,86,140,226,0,251,25,0,10,1.18519,0.0246914,10.7901,94.181,81,0
England,221,237.176,7.17647,0.289593,230.633,7.45701,0.384615,608,RS Bopara,82,32,50,83,197,3,36,0,0,2,2,102,133,235,252,252,17,1,10,2.22115,0.144231,25.1538,75.9361,104,4
England,221,237.176,7.17647,0.289593,230.633,7.45701,0.384615,608,EJG Morgan,41,20,21,38,197,3,36,0,0,2,2,102,133,235,252,252,17,1,10,3.19549,0.233083,30.0526,86.9291,133,4
Australia,228,239.627,7.69737,0.372807,232.079,7.23246,0.337719,609,B Lee,21,8,13,40,123,6,31,0,22,17,39,88,105,193,0,200,7,0,10,1.09091,0.0227273,10.8182,81.5068,44,1
Australia,228,239.627,7.69737,0.372807,232.079,7.23246,0.337719,609,DJ Hussey,51,24,27,64,123,6,31,0,22,17,39,88,105,193,0,200,7,0,10,2.54386,0.245614,29.2105,87.8628,57,4
Australia,228,239.627,7.69737,0.372807,232.079,7.23246,0.337719,609,CJ McKay,0,0,0,0,123,6,31,0,22,17,39,88,105,193,0,200,7,0,10,0.615385,0,6.88462,55.0769,26,3
Australia,228,239.627,7.69737,0.372807,232.079,7.23246,0.337719,609,JL Pattinson,0,0,0,0,123,6,31,0,22,17,39,88,105,193,0,200,7,0,10,0.285714,0,5.85714,51.25,7,3
England,221,237.176,7.17647,0.289593,230.633,7.45701,0.384615,609,RS Bopara,17,4,13,34,152,2,24,0,8,11,19,84,111,195,201,201,6,1,10,2.22115,0.144231,25.1538,75.9361,104,4
England,221,237.176,7.17647,0.289593,230.633,7.45701,0.384615,609,IJL Trott,61,16,45,100,152,2,24,0,8,11,19,84,111,195,201,201,6,1,10,3.3871,0.403226,43.7903,75.2494,62,4
South Africa,190,234.274,7.4,0.373684,232.363,7.33158,0.342105,611,F du Plessis,6,4,2,3,200,3,38,1,16,27,43,104,177,281,0,287,6,0,10,3.45122,0.292683,34.9268,83.135,82,4
South Africa,190,234.274,7.4,0.373684,232.363,7.33158,0.342105,611,HM Amla,123,52,71,111,200,3,38,1,16,27,43,104,177,281,0,287,6,0,10,5.20168,0.403361,48.7899,86.9292,119,4
South Africa,190,234.274,7.4,0.373684,232.363,7.33158,0.342105,612,M Morkel,1,0,1,3,185,6,17,2,4,3,7,76,133,209,0,211,2,0,10,0.6,0,5.28571,72.2656,35,1
South Africa,190,234.274,7.4,0.373684,232.363,7.33158,0.342105,612,RJ Peterson,22,4,18,34,185,6,17,2,4,3,7,76,133,209,0,211,2,0,10,1.62069,0.0344828,15.7931,83.5766,29,1
South Africa,190,234.274,7.4,0.373684,232.363,7.33158,0.342105,612,LL Tsotsobe,0,0,0,0,185,6,17,2,4,3,7,76,133,209,0,211,2,0,10,0.444444,0,3.16667,50.8929,18,3
England,221,237.176,7.17647,0.289593,230.633,7.45701,0.384615,612,IJL Trott,68,8,60,122,176,4,14,1,4,10,14,82,122,204,212,212,8,1,10,3.3871,0.403226,43.7903,75.2494,62,4
England,221,237.176,7.17647,0.289593,230.633,7.45701,0.384615,612,SR Patel,3,0,3,6,176,4,14,1,4,10,14,82,122,204,212,212,8,1,10,2.22727,0.0454545,21.9091,90.6015,22,0
England,221,237.176,7.17647,0.289593,230.633,7.45701,0.384615,612,JC Tredwell,0,0,0,0,176,4,14,1,4,10,14,82,122,204,212,212,8,1,10,0.52,0,6.52,65.9919,25,1
England,221,237.176,7.17647,0.289593,230.633,7.45701,0.384615,613,CR Woakes,32,12,20,43,156,7,16,2,0,1,1,76,97,173,0,182,9,1,10,1.09375,0,15.1562,76.8621,32,1
England,221,237.176,7.17647,0.289593,230.633,7.45701,0.384615,613,JW Dernbach,2,0,2,5,156,7,16,2,0,1,1,76,97,173,0,182,9,1,10,0.125,0,2.375,47.5,8,3
Pakistan,211,222.621,7.38389,0.393365,235.517,7.54976,0.336493,614,Sarfraz Ahmed,9,0,9,13,186,6,23,1,26,19,45,96,158,254,0,262,8,0,10,2.04878,0.097561,25.4878,83.9357,41,4
Pakistan,211,222.621,7.38389,0.393365,235.517,7.54976,0.336493,614,Umar Gul,12,4,8,13,186,6,23,1,26,19,45,96,158,254,0,262,8,0,10,0.77193,0,7.14035,68.2886,57,1
Pakistan,211,222.621,7.38389,0.393365,235.517,7.54976,0.336493,614,Saeed Ajmal,0,0,0,0,186,6,23,1,26,19,45,96,158,254,0,262,8,0,10,0.34375,0,4.60938,58.3004,64,3
Bangladesh,160,218.438,7.70625,0.4,211.106,7.05,0.325,614,Shakib Al Hasan,54,12,42,57,191,5,32,3,4,7,11,98,136,234,263,241,7,1,10,2.86992,0.252033,29.9106,79.0163,123,4
Bangladesh,160,218.438,7.70625,0.4,211.106,7.05,0.325,614,Shafiul Islam,0,0,0,0,191,5,32,3,4,7,11,98,136,234,263,241,7,1,10,0.535714,0,4.42857,57.6744,28,3
Bangladesh,160,218.438,7.70625,0.4,211.106,7.05,0.325,614,Shahadat Hossain,0,0,0,0,191,5,32,3,4,7,11,98,136,234,263,241,7,1,10,0.375,0,3.5625,50.4425,16,3
India,259,242.378,7.15058,0.339768,244.568,7.12741,0.30888,615,MS Dhoni,7,4,3,7,197,1,32,2,40,21,61,108,182,290,0,304,14,0,10,3.47872,0.292553,36.7713,84.1612,188,4
India,259,242.378,7.15058,0.339768,244.568,7.12741,0.30888,615,SK Raina,8,4,4,6,197,1,32,2,40,21,61,108,182,290,0,304,14,0,10,3.11111,0.216374,28.9064,91.8944,171,0
Sri Lanka,244,223.373,7.09016,0.344262,227.578,7.47541,0.385246,615,S Prasanna,8,4,4,12,222,7,24,2,0,0,0,110,136,246,305,254,8,0,10,1.25,0,9.5,78.8382,20,1
Sri Lanka,244,223.373,7.09016,0.344262,227.578,7.47541,0.385246,616,S Prasanna,4,0,4,17,164,6,14,3,0,1,1,62,117,179,0,188,9,0,10,1.25,0,9.5,78.8382,20,1
India,259,242.378,7.15058,0.339768,244.568,7.12741,0.30888,617,SR Tendulkar,111,54,57,148,188,2,40,0,16,27,43,118,153,271,0,289,18,0,10,5.89773,0.363636,45.6023,84.5376,88,4
India,259,242.378,7.15058,0.339768,244.568,7.12741,0.30888,617,SK Raina,40,24,16,35,188,2,40,0,16,27,43,118,153,271,0,289,18,0,10,3.11111,0.216374,28.9064,91.8944,171,0
India,259,242.378,7.15058,0.339768,244.568,7.12741,0.30888,617,RG Sharma,0,0,0,0,188,2,40,0,16,27,43,118,153,271,0,289,18,0,10,3.82836,0.268657,35.9179,83.083,134,4
India,259,242.378,7.15058,0.339768,244.568,7.12741,0.30888,617,MS Dhoni,0,0,0,0,188,2,40,0,16,27,43,118,153,271,0,289,18,0,10,3.47872,0.292553,36.7713,84.1612,188,4
India,259,242.378,7.15058,0.339768,244.568,7.12741,0.30888,617,RA Jadeja,0,0,0,0,188,2,40,0,16,27,43,118,153,271,0,289,18,0,10,2.12941,0.117647,21.7529,82.4342,85,4
Bangladesh,160,218.438,7.70625,0.4,211.106,7.05,0.325,617,Mushfiqur Rahim,10,4,6,10,201,3,33,1,30,17,47,132,149,281,290,293,12,1,10,2.61111,0.18254,27.7778,75.2526,126,4
Bangladesh,160,218.438,7.70625,0.4,211.106,7.05,0.325,617,Nasir Hossain,47,20,27,48,201,3,33,1,30,17,47,132,149,281,290,293,12,1,10,2.75,0.159091,27.0455,79.3863,44,4
Bangladesh,160,218.438,7.70625,0.4,211.106,7.05,0.325,617,Mahmudullah,0,0,0,0,201,3,33,1,30,17,47,132,149,281,290,293,12,1,10,2.26531,0.153061,24.4286,70.9544,98,4
Pakistan,211,222.621,7.38389,0.393365,235.517,7.54976,0.336493,618,Shahid Afridi,4,0,4,8,248,2,28,1,16,22,38,124,190,314,0,329,15,0,10,2.72917,0.0972222,21.4097,127.766,144,0
Pakistan,211,222.621,7.38389,0.393365,235.517,7.54976,0.336493,618,Younis Khan,27,8,19,23,248,2,28,1,16,22,38,124,190,314,0,329,15,0,10,2.64655,0.215517,28.5,73.2713,116,4
Pakistan,211,222.621,7.38389,0.393365,235.517,7.54976,0.336493,618,Hammad Azam,0,0,0,0,248,2,28,1,16,22,38,124,190,314,0,329,15,0,10,1.4,0,14.8,62.1849,5,1
Pakistan,211,222.621,7.38389,0.393365,235.517,7.54976,0.336493,618,Misbah-ul-Haq,0,0,0,0,248,2,28,1,16,22,38,124,190,314,0,329,15,0,10,2.95238,0.285714,34.9921,71.8195,126,4
Pakistan,211,222.621,7.38389,0.393365,235.517,7.54976,0.336493,618,Umar Gul,0,0,0,0,248,2,28,1,16,22,38,124,190,314,0,329,15,0,10,0.77193,0,7.14035,68.2886,57,1
India,259,242.378,7.15058,0.339768,244.568,7.12741,0.30888,618,V Kohli,171,92,79,142,238,2,53,0,22,6,28,166,153,319,330,330,11,0,10,4.66456,0.379747,44.9937,88.3325,158,4
India,259,242.378,7.15058,0.339768,244.568,7.12741,0.30888,618,RG Sharma,68,26,42,81,238,2,53,0,22,6,28,166,153,319,330,330,11,0,10,3.82836,0.268657,35.9179,83.083,134,4
India,259,242.378,7.15058,0.339768,244.568,7.12741,0.30888,618,SK Raina,0,0,0,0,238,2,53,0,22,6,28,166,153,319,330,330,11,0,10,3.11111,0.216374,28.9064,91.8944,171,0
India,259,242.378,7.15058,0.339768,244.568,7.12741,0.30888,618,MS Dhoni,0,0,0,0,238,2,53,0,22,6,28,166,153,319,330,330,11,0,10,3.47872,0.292553,36.7713,84.1612,188,4
Sri Lanka,244,223.373,7.09016,0.344262,227.578,7.47541,0.385246,619,WU Tharanga,47,26,21,45,164,5,29,2,16,12,28,82,139,221,0,232,11,0,10,3.93985,0.263158,32.9699,71.6035,133,4
Sri Lanka,244,223.373,7.09016,0.344262,227.578,7.47541,0.385246,619,SMSM Senanayake,2,0,2,9,164,5,29,2,16,12,28,82,139,221,0,232,11,0,10,1.0625,0,8.625,87.0662,32,1
Sri Lanka,244,223.373,7.09016,0.344262,227.578,7.47541,0.385246,619,SL Malinga,0,0,0,0,164,5,29,2,16,12,28,82,139,221,0,232,11,0,10,0.617284,0.0123457,4.97531,74.6296,81,1
Pakistan,211,222.621,7.38389,0.393365,235.517,7.54976,0.336493,620,Saeed Ajmal,2,0,2,2,157,6,30,2,12,19,31,94,124,218,0,236,18,0,10,0.34375,0,4.60938,58.3004,64,3
Pakistan,211,222.621,7.38389,0.393365,235.517,7.54976,0.336493,620,Sarfraz Ahmed,26,8,18,37,157,6,30,2,12,19,31,94,124,218,0,236,18,0,10,2.04878,0.097561,25.4878,83.9357,41,4
Pakistan,211,222.621,7.38389,0.393365,235.517,7.54976,0.336493,620,Aizaz Cheema,0,0,0,0,157,6,30,2,12,19,31,94,124,218,0,236,18,0,10,0.333333,0,4.33333,57.7778,6,3
Bangladesh,160,218.438,7.70625,0.4,211.106,7.05,0.325,620,Mushfiqur Rahim,10,4,6,7,148,3,37,2,12,26,38,86,137,223,237,234,11,1,10,2.61111,0.18254,27.7778,75.2526,126,4
Bangladesh,160,218.438,7.70625,0.4,211.106,7.05,0.325,620,Mahmudullah,3,0,3,3,148,3,37,2,12,26,38,86,137,223,237,234,11,1,10,2.26531,0.153061,24.4286,70.9544,98,4
Bangladesh,160,218.438,7.70625,0.4,211.106,7.05,0.325,620,Mashrafe Mortaza,0,0,0,0,148,3,37,2,12,26,38,86,137,223,237,234,11,1,10,1.27536,0,11.1594,76.9231,69,1
Bangladesh,160,218.438,7.70625,0.4,211.106,7.05,0.325,620,Abdur Razzak,0,0,0,0,148,3,37,2,12,26,38,86,137,223,237,234,11,1,10,0.849315,0.0136986,8.39726,73.8554,73,1
Bangladesh,160,218.438,7.70625,0.4,211.106,7.05,0.325,620,Shahadat Hossain,0,0,0,0,148,3,37,2,12,26,38,86,137,223,237,234,11,1,10,0.375,0,3.5625,50.4425,16,3
West Indies,176,217.33,7.15909,0.3125,225.278,7.57386,0.380682,621,AD Russell,12,8,4,11,159,6,17,2,10,15,25,90,111,201,0,211,10,0,10,3.38095,0.0952381,23.2857,129.536,42,0
West Indies,176,217.33,7.15909,0.3125,225.278,7.57386,0.380682,621,KAJ Roach,0,0,0,2,159,6,17,2,10,15,25,90,111,201,0,211,10,0,10,0.526316,0,5.68421,50.5855,38,3
India,259,242.378,7.15058,0.339768,244.568,7.12741,0.30888,621,RG Sharma,72,18,54,98,163,7,15,0,8,4,12,66,124,190,212,213,23,1,10,3.82836,0.268657,35.9179,83.083,134,4
India,259,242.378,7.15058,0.339768,244.568,7.12741,0.30888,621,VR Aaron,0,0,0,0,163,7,15,0,8,4,12,66,124,190,212,213,23,1,10,0.333333,0,2.66667,53.3333,3,3
India,259,242.378,7.15058,0.339768,244.568,7.12741,0.30888,621,R Vinay Kumar,18,4,14,50,163,7,15,0,8,4,12,66,124,190,212,213,23,1,10,0.636364,0,7.72727,57.047,11,3
India,259,242.378,7.15058,0.339768,244.568,7.12741,0.30888,621,UT Yadav,0,0,0,0,163,7,15,0,8,4,12,66,124,190,212,213,23,1,10,0.533333,0,3.46667,56.5217,15,3
West Indies,176,217.33,7.15909,0.3125,225.278,7.57386,0.380682,622,DJG Sammy,5,4,1,2,149,4,33,2,52,19,71,130,123,253,0,260,7,0,10,2.25,0.09,18.25,95.8005,100,0
West Indies,176,217.33,7.15909,0.3125,225.278,7.57386,0.380682,622,AD Russell,5,4,1,3,149,4,33,2,52,19,71,130,123,253,0,260,7,0,10,3.38095,0.0952381,23.2857,129.536,42,0
India,259,242.378,7.15058,0.339768,244.568,7.12741,0.30888,622,UT Yadav,5,4,1,5,189,7,30,2,12,4,16,126,109,235,261,244,9,1,10,0.533333,0,3.46667,56.5217,15,3
India,259,242.378,7.15058,0.339768,244.568,7.12741,0.30888,622,A Mithun,13,12,1,10,189,7,30,2,12,4,16,126,109,235,261,244,9,1,10,2,0,17,89.4737,3,0
India,259,242.378,7.15058,0.339768,244.568,7.12741,0.30888,623,RG Sharma,6,0,6,5,299,1,49,2,32,24,56,234,170,404,0,418,14,1,10,3.82836,0.268657,35.9179,83.083,134,4
India,259,242.378,7.15058,0.339768,244.568,7.12741,0.30888,623,V Sehwag,210,134,76,150,299,1,49,2,32,24,56,234,170,404,0,418,14,1,10,5.88636,0.238636,38.8295,108.649,88,0
India,259,242.378,7.15058,0.339768,244.568,7.12741,0.30888,623,V Kohli,0,0,0,0,299,1,49,2,32,24,56,234,170,404,0,418,14,1,10,4.66456,0.379747,44.9937,88.3325,158,4
India,259,242.378,7.15058,0.339768,244.568,7.12741,0.30888,623,PA Patel,0,0,0,0,299,1,49,2,32,24,56,234,170,404,0,418,14,1,10,2.65217,0.130435,22.1304,79.4072,23,4
West Indies,176,217.33,7.15909,0.3125,225.278,7.57386,0.380682,623,D Ramdin,82,40,42,84,207,9,30,0,16,8,24,166,95,261,419,265,4,0,10,1.7439,0.097561,19.1951,81.1759,82,1
West Indies,176,217.33,7.15909,0.3125,225.278,7.57386,0.380682,623,SP Narine,17,10,7,20,207,9,30,0,16,8,24,166,95,261,419,265,4,0,10,1.05882,0,8.55882,76.378,34,1
India,259,242.378,7.15058,0.339768,244.568,7.12741,0.30888,624,V Kohli,80,20,60,85,203,4,27,0,8,18,26,86,170,256,0,267,11,1,10,4.66456,0.379747,44.9937,88.3325,158,4
India,259,242.378,7.15058,0.339768,244.568,7.12741,0.30888,624,RG Sharma,15,4,11,19,203,4,27,0,8,18,26,86,170,256,0,267,11,1,10,3.82836,0.268657,35.9179,83.083,134,4
India,259,242.378,7.15058,0.339768,244.568,7.12741,0.30888,624,SK Raina,0,0,0,0,203,4,27,0,8,18,26,86,170,256,0,267,11,1,10,3.11111,0.216374,28.9064,91.8944,171,0
India,259,242.378,7.15058,0.339768,244.568,7.12741,0.30888,624,IK Pathan,0,0,0,0,203,4,27,0,8,18,26,86,170,256,0,267,11,1,10,1.875,0.025,16.85,78.2811,40,1
Pakistan,211,222.621,7.38389,0.393365,235.517,7.54976,0.336493,626,Shoaib Malik,17,8,9,20,174,4,30,1,12,24,36,102,138,240,0,262,22,0,10,2.77551,0.193878,28.7041,81.4418,98,4
Pakistan,211,222.621,7.38389,0.393365,235.517,7.54976,0.336493,626,Sarfraz Ahmed,0,0,0,0,174,4,30,1,12,24,36,102,138,240,0,262,22,0,10,2.04878,0.097561,25.4878,83.9357,41,4
Pakistan,211,222.621,7.38389,0.393365,235.517,7.54976,0.336493,626,Shahid Afridi,18,12,6,13,174,4,30,1,12,24,36,102,138,240,0,262,22,0,10,2.72917,0.0972222,21.4097,127.766,144,0
Bangladesh,160,218.438,7.70625,0.4,211.106,7.05,0.325,626,Mahmudullah,5,0,5,13,108,4,18,1,26,20,46,62,110,172,263,186,14,1,10,2.26531,0.153061,24.4286,70.9544,98,4
Bangladesh,160,218.438,7.70625,0.4,211.106,7.05,0.325,626,Nasir Hossain,69,32,37,119,108,4,18,1,26,20,46,62,110,172,263,186,14,1,10,2.75,0.159091,27.0455,79.3863,44,4
Bangladesh,160,218.438,7.70625,0.4,211.106,7.05,0.325,626,Abdur Razzak,0,0,0,0,108,4,18,1,26,20,46,62,110,172,263,186,14,1,10,0.849315,0.0136986,8.39726,73.8554,73,1
Pakistan,211,222.621,7.38389,0.393365,235.517,7.54976,0.336493,627,Abdur Rehman,3,0,3,8,132,5,26,4,0,3,3,70,91,161,0,177,16,0,10,0.52381,0,6.04762,55.7018,21,3
Pakistan,211,222.621,7.38389,0.393365,235.517,7.54976,0.336493,627,Saeed Ajmal,1,0,1,1,132,5,26,4,0,3,3,70,91,161,0,177,16,0,10,0.34375,0,4.60938,58.3004,64,3
Australia,228,239.627,7.69737,0.372807,232.079,7.23246,0.337719,628,GJ Bailey,36,12,24,56,135,4,23,2,16,16,32,76,114,190,0,204,14,0,10,3.34921,0.301587,36.3492,84.658,63,4
Australia,228,239.627,7.69737,0.372807,232.079,7.23246,0.337719,628,DT Christian,3,0,3,8,135,4,23,2,16,16,32,76,114,190,0,204,14,0,10,1.44444,0,15.1111,86.901,18,0
Australia,228,239.627,7.69737,0.372807,232.079,7.23246,0.337719,628,B Lee,0,0,0,0,135,4,23,2,16,16,32,76,114,190,0,204,14,0,10,1.09091,0.0227273,10.8182,81.5068,44,1
Australia,228,239.627,7.69737,0.372807,232.079,7.23246,0.337719,630,MEK Hussey,66,22,44,94,159,4,25,0,14,8,22,74,132,206,0,220,14,0,10,2.7563,0.260504,34.084,82.4893,119,4
Australia,228,239.627,7.69737,0.372807,232.079,7.23246,0.337719,630,DJ Hussey,10,4,6,15,159,4,25,0,14,8,22,74,132,206,0,220,14,0,10,2.54386,0.245614,29.2105,87.8628,57,4
Australia,228,239.627,7.69737,0.372807,232.079,7.23246,0.337719,630,DT Christian,0,0,0,0,159,4,25,0,14,8,22,74,132,206,0,220,14,0,10,1.44444,0,15.1111,86.901,18,0
Australia,228,239.627,7.69737,0.372807,232.079,7.23246,0.337719,630,B Lee,0,0,0,0,159,4,25,0,14,8,22,74,132,206,0,220,14,0,10,1.09091,0.0227273,10.8182,81.5068,44,1
Australia,228,239.627,7.69737,0.372807,232.079,7.23246,0.337719,630,CJ McKay,0,0,0,0,159,4,25,0,14,8,22,74,132,206,0,220,14,0,10,0.615385,0,6.88462,55.0769,26,3
Australia,228,239.627,7.69737,0.372807,232.079,7.23246,0.337719,630,XJ Doherty,0,0,0,0,159,4,25,0,14,8,22,74,132,206,0,220,14,0,10,0.190476,0,4.28571,52.0231,21,3
Australia,228,239.627,7.69737,0.372807,232.079,7.23246,0.337719,630,NM Lyon,0,0,0,0,159,4,25,0,14,8,22,74,132,206,0,220,14,0,10,0.666667,0,4,133.333,3,0
West Indies,176,217.33,7.15909,0.3125,225.278,7.57386,0.380682,630,DJG Sammy,2,0,2,6,155,6,25,2,16,11,27,112,95,207,221,220,13,1,10,2.25,0.09,18.25,95.8005,100,0
West Indies,176,217.33,7.15909,0.3125,225.278,7.57386,0.380682,630,SP Narine,0,0,0,0,155,6,25,2,16,11,27,112,95,207,221,220,13,1,10,1.05882,0,8.55882,76.378,34,1
West Indies,176,217.33,7.15909,0.3125,225.278,7.57386,0.380682,630,KAJ Roach,0,0,0,0,155,6,25,2,16,11,27,112,95,207,221,220,13,1,10,0.526316,0,5.68421,50.5855,38,3
Australia,228,239.627,7.69737,0.372807,232.079,7.23246,0.337719,631,MS Wade,2,0,2,2,209,4,27,2,20,15,35,128,143,271,0,281,10,0,10,1.86275,0.117647,20.3333,78.2642,51,1
Australia,228,239.627,7.69737,0.372807,232.079,7.23246,0.337719,631,MEK Hussey,15,4,11,18,209,4,27,2,20,15,35,128,143,271,0,281,10,0,10,2.7563,0.260504,34.084,82.4893,119,4
Australia,228,239.627,7.69737,0.372807,232.079,7.23246,0.337719,631,CJ McKay,0,0,0,0,209,4,27,2,20,15,35,128,143,271,0,281,10,0,10,0.615385,0,6.88462,55.0769,26,3
Australia,228,239.627,7.69737,0.372807,232.079,7.23246,0.337719,631,XJ Doherty,0,0,0,0,209,4,27,2,20,15,35,128,143,271,0,281,10,0,10,0.190476,0,4.28571,52.0231,21,3
Australia,228,239.627,7.69737,0.372807,232.079,7.23246,0.337719,631,BW Hilfenhaus,0,0,0,0,209,4,27,2,20,15,35,128,143,271,0,281,10,0,10,0.222222,0,3.22222,40.8451,9,3
West Indies,176,217.33,7.15909,0.3125,225.278,7.57386,0.380682,631,DJG Sammy,71,50,21,40,205,7,25,2,10,4,14,148,96,244,282,251,7,1,10,2.25,0.09,18.25,95.8005,100,0
West Indies,176,217.33,7.15909,0.3125,225.278,7.57386,0.380682,631,KAJ Roach,1,0,1,3,205,7,25,2,10,4,14,148,96,244,282,251,7,1,10,0.526316,0,5.68421,50.5855,38,3
New Zealand,184,233.745,7.39674,0.36413,227.951,7.30435,0.353261,637,BJ Watling,52,16,36,92,124,6,26,1,8,19,27,64,113,177,0,190,13,0,10,3,0.263158,27.7895,66.9202,19,4
New Zealand,184,233.745,7.39674,0.36413,227.951,7.30435,0.353261,637,KD Mills,0,0,0,4,124,6,26,1,8,19,27,64,113,177,0,190,13,0,10,1.52542,0.0338983,12.8644,90.7895,59,0
New Zealand,184,233.745,7.39674,0.36413,227.951,7.30435,0.353261,637,TG Southee,0,0,0,0,124,6,26,1,8,19,27,64,113,177,0,190,13,0,10,0.764706,0,7.03922,92.7649,51,0
New Zealand,184,233.745,7.39674,0.36413,227.951,7.30435,0.353261,637,TS Nethula,0,0,0,0,124,6,26,1,8,19,27,64,113,177,0,190,13,0,10,0.333333,0,4,109.091,3,0
West Indies,176,217.33,7.15909,0.3125,225.278,7.57386,0.380682,638,DJG Sammy,8,6,2,3,226,3,36,2,10,23,33,154,141,295,0,315,20,1,10,2.25,0.09,18.25,95.8005,100,0
West Indies,176,217.33,7.15909,0.3125,225.278,7.57386,0.380682,638,MN Samuels,91,34,57,92,226,3,36,2,10,23,33,154,141,295,0,315,20,1,10,3.74757,0.23301,31.6214,74.5821,103,4
New Zealand,184,233.745,7.39674,0.36413,227.951,7.30435,0.353261,638,BJ Watling,65,28,37,61,196,7,32,1,0,13,13,98,143,241,316,260,19,0,10,3,0.263158,27.7895,66.9202,19,4
New Zealand,184,233.745,7.39674,0.36413,227.951,7.30435,0.353261,638,KD Mills,3,0,3,3,196,7,32,1,0,13,13,98,143,241,316,260,19,0,10,1.52542,0.0338983,12.8644,90.7895,59,0
New Zealand,184,233.745,7.39674,0.36413,227.951,7.30435,0.353261,638,TS Nethula,0,0,0,0,196,7,32,1,0,13,13,98,143,241,316,260,19,0,10,0.333333,0,4,109.091,3,0
New Zealand,184,233.745,7.39674,0.36413,227.951,7.30435,0.353261,639,KD Mills,1,0,1,3,177,5,28,2,14,17,31,122,114,236,0,249,13,0,10,1.52542,0.0338983,12.8644,90.7895,59,0
New Zealand,184,233.745,7.39674,0.36413,227.951,7.30435,0.353261,639,NL McCullum,38,18,20,57,177,5,28,2,14,17,31,122,114,236,0,249,13,0,10,1.63934,0.0655738,17.377,85.622,61,0
New Zealand,184,233.745,7.39674,0.36413,227.951,7.30435,0.353261,639,TG Southee,0,0,0,0,177,5,28,2,14,17,31,122,114,236,0,249,13,0,10,0.764706,0,7.03922,92.7649,51,0
New Zealand,184,233.745,7.39674,0.36413,227.951,7.30435,0.353261,639,TA Boult,0,0,0,0,177,5,28,2,14,17,31,122,114,236,0,249,13,0,10,0.727273,0,5.27273,77.3333,11,1
West Indies,176,217.33,7.15909,0.3125,225.278,7.57386,0.380682,640,SP Narine,4,0,4,5,150,7,36,1,24,14,38,108,116,224,0,241,17,1,10,1.05882,0,8.55882,76.378,34,1
West Indies,176,217.33,7.15909,0.3125,225.278,7.57386,0.380682,640,AD Russell,28,18,10,22,150,7,36,1,24,14,38,108,116,224,0,241,17,1,10,3.38095,0.0952381,23.2857,129.536,42,0
West Indies,176,217.33,7.15909,0.3125,225.278,7.57386,0.380682,640,TL Best,0,0,0,0,150,7,36,1,24,14,38,108,116,224,0,241,17,1,10,0.375,0,4,42.6667,8,3
New Zealand,184,233.745,7.39674,0.36413,227.951,7.30435,0.353261,640,KS Williamson,68,26,42,84,165,6,35,0,0,14,14,94,120,214,242,221,7,0,10,4.31707,0.390244,43.0488,82.8833,82,4
New Zealand,184,233.745,7.39674,0.36413,227.951,7.30435,0.353261,640,AM Ellis,25,8,17,30,165,6,35,0,0,14,14,94,120,214,242,221,7,0,10,1,0,12.75,80.9524,12,1
New Zealand,184,233.745,7.39674,0.36413,227.951,7.30435,0.353261,640,KD Mills,0,0,0,0,165,6,35,0,0,14,14,94,120,214,242,221,7,0,10,1.52542,0.0338983,12.8644,90.7895,59,0
New Zealand,184,233.745,7.39674,0.36413,227.951,7.30435,0.353261,640,TG Southee,0,0,0,0,165,6,35,0,0,14,14,94,120,214,242,221,7,0,10,0.764706,0,7.03922,92.7649,51,0
New Zealand,184,233.745,7.39674,0.36413,227.951,7.30435,0.353261,640,TA Boult,0,0,0,0,165,6,35,0,0,14,14,94,120,214,242,221,7,0,10,0.727273,0,5.27273,77.3333,11,1
Sri Lanka,244,223.373,7.09016,0.344262,227.578,7.47541,0.385246,642,TM Dilshan,104,44,60,126,186,3,35,0,30,13,43,130,134,264,0,280,16,1,10,4.60199,0.273632,38.3632,86.0219,201,4
Sri Lanka,244,223.373,7.09016,0.344262,227.578,7.47541,0.385246,642,DPMD Jayawardene,49,28,21,44,186,3,35,0,30,13,43,130,134,264,0,280,16,1,10,3.20833,0.244792,31.6979,79.1109,192,4
Sri Lanka,244,223.373,7.09016,0.344262,227.578,7.47541,0.385246,642,NLTC Perera,0,0,0,0,186,3,35,0,30,13,43,130,134,264,0,280,16,1,10,1.65333,0.0666667,14.32,105.397,75,0
Pakistan,211,222.621,7.38389,0.393365,235.517,7.54976,0.336493,642,Sarfraz Ahmed,17,8,9,22,168,6,27,2,4,3,7,82,120,202,281,204,2,0,10,2.04878,0.097561,25.4878,83.9357,41,4
Pakistan,211,222.621,7.38389,0.393365,235.517,7.54976,0.336493,642,Saeed Ajmal,0,0,0,2,168,6,27,2,4,3,7,82,120,202,281,204,2,0,10,0.34375,0,4.60938,58.3004,64,3
Sri Lanka,244,223.373,7.09016,0.344262,227.578,7.47541,0.385246,643,NLTC Perera,2,0,2,3,158,3,28,2,14,17,31,96,121,217,0,243,26,1,10,1.65333,0.0666667,14.32,105.397,75,0
Sri Lanka,244,223.373,7.09016,0.344262,227.578,7.47541,0.385246,643,AD Mathews,1,0,1,2,158,3,28,2,14,17,31,96,121,217,0,243,26,1,10,2.64122,0.198473,28.6794,82.3362,131,4
Sri Lanka,244,223.373,7.09016,0.344262,227.578,7.47541,0.385246,643,HDRL Thirimanne,0,0,0,0,158,3,28,2,14,17,31,96,121,217,0,243,26,1,10,2.77778,0.246914,31.5802,71.4725,81,4
Sri Lanka,244,223.373,7.09016,0.344262,227.578,7.47541,0.385246,643,KMDN Kulasekara,0,0,0,0,158,3,28,2,14,17,31,96,121,217,0,243,26,1,10,1.21,0.04,11.8,80.9328,100,1
Sri Lanka,244,223.373,7.09016,0.344262,227.578,7.47541,0.385246,643,SL Malinga,0,0,0,0,158,3,28,2,14,17,31,96,121,217,0,243,26,1,10,0.617284,0.0123457,4.97531,74.6296,81,1
Pakistan,211,222.621,7.38389,0.393365,235.517,7.54976,0.336493,644,Umar Akmal,49,32,17,46,184,4,34,1,4,17,21,108,131,239,0,247,8,0,10,2.76842,0.2,27.5053,82.7947,95,4
Pakistan,211,222.621,7.38389,0.393365,235.517,7.54976,0.336493,644,Shahid Afridi,7,4,3,5,184,4,34,1,4,17,21,108,131,239,0,247,8,0,10,2.72917,0.0972222,21.4097,127.766,144,0
Pakistan,211,222.621,7.38389,0.393365,235.517,7.54976,0.336493,644,Sohail Tanvir,0,0,0,0,184,4,34,1,4,17,21,108,131,239,0,247,8,0,10,1.18919,0,9.08108,81.5534,37,1
Pakistan,211,222.621,7.38389,0.393365,235.517,7.54976,0.336493,644,Umar Gul,0,0,0,0,184,4,34,1,4,17,21,108,131,239,0,247,8,0,10,0.77193,0,7.14035,68.2886,57,1
Sri Lanka,244,223.373,7.09016,0.344262,227.578,7.47541,0.385246,644,AD Mathews,53,18,35,61,154,6,34,1,14,24,38,82,144,226,248,248,22,1,10,2.64122,0.198473,28.6794,82.3362,131,4
Sri Lanka,244,223.373,7.09016,0.344262,227.578,7.47541,0.385246,644,BMAJ Mendis,18,14,4,16,154,6,34,1,14,24,38,82,144,226,248,248,22,1,10,1.43243,0.027027,15.1622,82.8656,37,1
Sri Lanka,244,223.373,7.09016,0.344262,227.578,7.47541,0.385246,644,KMDN Kulasekara,0,0,0,0,154,6,34,1,14,24,38,82,144,226,248,248,22,1,10,1.21,0.04,11.8,80.9328,100,1
India,259,242.378,7.15058,0.339768,244.568,7.12741,0.30888,645,MS Dhoni,14,4,10,15,223,4,31,0,28,20,48,116,186,302,0,314,12,0,10,3.47872,0.292553,36.7713,84.1612,188,4
India,259,242.378,7.15058,0.339768,244.568,7.12741,0.30888,645,SK Raina,30,8,22,32,223,4,31,0,28,20,48,116,186,302,0,314,12,0,10,3.11111,0.216374,28.9064,91.8944,171,0
India,259,242.378,7.15058,0.339768,244.568,7.12741,0.30888,645,IK Pathan,0,0,0,0,223,4,31,0,28,20,48,116,186,302,0,314,12,0,10,1.875,0.025,16.85,78.2811,40,1
Sri Lanka,244,223.373,7.09016,0.344262,227.578,7.47541,0.385246,645,KC Sangakkara,125,44,81,149,183,6,51,0,24,12,36,102,168,270,315,293,23,1,10,4.33659,0.360976,41.9854,80.6276,205,4
Sri Lanka,244,223.373,7.09016,0.344262,227.578,7.47541,0.385246,645,NLTC Perera,36,14,22,20,183,6,51,0,24,12,36,102,168,270,315,293,23,1,10,1.65333,0.0666667,14.32,105.397,75,0
Sri Lanka,244,223.373,7.09016,0.344262,227.578,7.47541,0.385246,645,HMRKB Herath,0,0,0,0,183,6,51,0,24,12,36,102,168,270,315,293,23,1,10,0.444444,0,5.18519,61.674,27,1
Sri Lanka,244,223.373,7.09016,0.344262,227.578,7.47541,0.385246,645,SL Malinga,0,0,0,0,183,6,51,0,24,12,36,102,168,270,315,293,23,1,10,0.617284,0.0123457,4.97531,74.6296,81,1
Sri Lanka,244,223.373,7.09016,0.344262,227.578,7.47541,0.385246,645,KMDN Kulasekara,0,0,0,0,183,6,51,0,24,12,36,102,168,270,315,293,23,1,10,1.21,0.04,11.8,80.9328,100,1
Sri Lanka,244,223.373,7.09016,0.344262,227.578,7.47541,0.385246,647,BMAJ Mendis,29,14,15,28,173,5,43,0,22,28,50,88,178,266,0,286,20,1,10,1.43243,0.027027,15.1622,82.8656,37,1
Sri Lanka,244,223.373,7.09016,0.344262,227.578,7.47541,0.385246,647,AD Mathews,37,8,29,42,173,5,43,0,22,28,50,88,178,266,0,286,20,1,10,2.64122,0.198473,28.6794,82.3362,131,4
India,259,242.378,7.15058,0.339768,244.568,7.12741,0.30888,647,SK Raina,36,16,20,29,194,5,36,0,18,25,43,94,179,273,287,288,15,0,10,3.11111,0.216374,28.9064,91.8944,171,0
India,259,242.378,7.15058,0.339768,244.568,7.12741,0.30888,647,IK Pathan,20,8,12,19,194,5,36,0,18,25,43,94,179,273,287,288,15,0,10,1.875,0.025,16.85,78.2811,40,1
Sri Lanka,244,223.373,7.09016,0.344262,227.578,7.47541,0.385246,648,BMAJ Mendis,17,8,9,15,172,4,28,1,22,14,36,92,144,236,0,251,15,1,10,1.43243,0.027027,15.1622,82.8656,37,1
Sri Lanka,244,223.373,7.09016,0.344262,227.578,7.47541,0.385246,648,NLTC Perera,0,0,0,0,172,4,28,1,22,14,36,92,144,236,0,251,15,1,10,1.65333,0.0666667,14.32,105.397,75,0
Sri Lanka,244,223.373,7.09016,0.344262,227.578,7.47541,0.385246,648,HDRL Thirimanne,45,0,45,65,172,4,28,1,22,14,36,92,144,236,0,251,15,1,10,2.77778,0.246914,31.5802,71.4725,81,4
Sri Lanka,244,223.373,7.09016,0.344262,227.578,7.47541,0.385246,648,HMRKB Herath,0,0,0,0,172,4,28,1,22,14,36,92,144,236,0,251,15,1,10,0.444444,0,5.18519,61.674,27,1
Sri Lanka,244,223.373,7.09016,0.344262,227.578,7.47541,0.385246,648,SL Malinga,0,0,0,0,172,4,28,1,22,14,36,92,144,236,0,251,15,1,10,0.617284,0.0123457,4.97531,74.6296,81,1
England,221,237.176,7.17647,0.289593,230.633,7.45701,0.384615,649,SR Patel,2,0,2,3,224,2,27,2,46,16,62,188,125,313,0,325,12,0,10,2.22727,0.0454545,21.9091,90.6015,22,0
England,221,237.176,7.17647,0.289593,230.633,7.45701,0.384615,649,C Kieswetter,4,0,4,9,224,2,27,2,46,16,62,188,125,313,0,325,12,0,10,3.43243,0.135135,26.4324,88.0288,37,4
India,259,242.378,7.15058,0.339768,244.568,7.12741,0.30888,649,R Ashwin,1,0,1,1,225,4,40,3,20,22,42,166,141,307,326,316,9,1,10,1.16364,0.0181818,11.9455,84.7742,55,1
India,259,242.378,7.15058,0.339768,244.568,7.12741,0.30888,649,B Kumar,0,0,0,1,225,4,40,3,20,22,42,166,141,307,326,316,9,1,10,0.75,0,7.39286,72.1254,28,1
India,259,242.378,7.15058,0.339768,244.568,7.12741,0.30888,649,AB Dinda,0,0,0,0,225,4,40,3,20,22,42,166,141,307,326,316,9,1,10,0.2,0,4.2,55.2632,5,3
India,259,242.378,7.15058,0.339768,244.568,7.12741,0.30888,649,I Sharma,0,0,0,0,225,4,40,3,20,22,42,166,141,307,326,316,9,1,10,0.24,0,2.84,34.1346,25,3
India,259,242.378,7.15058,0.339768,244.568,7.12741,0.30888,650,MS Dhoni,38,14,24,48,163,5,40,0,52,15,67,138,132,270,0,285,15,1,10,3.47872,0.292553,36.7713,84.1612,188,4
India,259,242.378,7.15058,0.339768,244.568,7.12741,0.30888,650,RA Jadeja,29,18,11,26,163,5,40,0,52,15,67,138,132,270,0,285,15,1,10,2.12941,0.117647,21.7529,82.4342,85,4
India,259,242.378,7.15058,0.339768,244.568,7.12741,0.30888,650,R Ashwin,0,0,0,0,163,5,40,0,52,15,67,138,132,270,0,285,15,1,10,1.16364,0.0181818,11.9455,84.7742,55,1
England,221,237.176,7.17647,0.289593,230.633,7.45701,0.384615,652,JE Root,37,22,15,33,147,4,46,0,40,10,50,146,97,243,0,257,14,0,10,3.68852,0.327869,41.6721,83.3443,61,4
England,221,237.176,7.17647,0.289593,230.633,7.45701,0.384615,652,KP Pietersen,66,24,42,90,147,4,46,0,40,10,50,146,97,243,0,257,14,0,10,3.69892,0.236559,33.4946,82.2117,93,4
England,221,237.176,7.17647,0.289593,230.633,7.45701,0.384615,652,JC Buttler,0,0,0,0,147,4,46,0,40,10,50,146,97,243,0,257,14,0,10,3.47458,0.186441,29.9153,115.359,59,0
England,221,237.176,7.17647,0.289593,230.633,7.45701,0.384615,652,TT Bresnan,0,0,0,0,147,4,46,0,40,10,50,146,97,243,0,257,14,0,10,1.52381,0.015873,13.8095,88.4146,63,0
England,221,237.176,7.17647,0.289593,230.633,7.45701,0.384615,652,JC Tredwell,0,0,0,0,147,4,46,0,40,10,50,146,97,243,0,257,14,0,10,0.52,0,6.52,65.9919,25,1
India,259,242.378,7.15058,0.339768,244.568,7.12741,0.30888,652,RA Jadeja,15,8,7,19,209,5,31,0,0,11,11,128,123,251,258,258,7,1,10,2.12941,0.117647,21.7529,82.4342,85,4
India,259,242.378,7.15058,0.339768,244.568,7.12741,0.30888,652,SK Raina,84,42,42,75,209,5,31,0,0,11,11,128,123,251,258,258,7,1,10,3.11111,0.216374,28.9064,91.8944,171,0
India,259,242.378,7.15058,0.339768,244.568,7.12741,0.30888,653,R Ashwin,7,0,7,15,153,6,27,1,26,10,36,122,94,216,0,226,10,1,10,1.16364,0.0181818,11.9455,84.7742,55,1
India,259,242.378,7.15058,0.339768,244.568,7.12741,0.30888,653,B Kumar,8,4,4,14,153,6,27,1,26,10,36,122,94,216,0,226,10,1,10,0.75,0,7.39286,72.1254,28,1
England,221,237.176,7.17647,0.289593,230.633,7.45701,0.384615,653,IR Bell,102,50,52,139,153,3,32,0,20,7,27,116,96,212,227,227,15,0,10,3.63433,0.246269,35.3806,75.6623,134,4
England,221,237.176,7.17647,0.289593,230.633,7.45701,0.384615,653,EJG Morgan,24,6,18,35,153,3,32,0,20,7,27,116,96,212,227,227,15,0,10,3.19549,0.233083,30.0526,86.9291,133,4
England,221,237.176,7.17647,0.289593,230.633,7.45701,0.384615,654,TT Bresnan,8,0,8,15,161,6,25,1,16,14,30,88,128,216,0,227,11,1,10,1.52381,0.015873,13.8095,88.4146,63,0
England,221,237.176,7.17647,0.289593,230.633,7.45701,0.384615,654,GP Swann,7,4,3,6,161,6,25,1,16,14,30,88,128,216,0,227,11,1,10,1.08696,0,10.3043,90.631,46,0
England,221,237.176,7.17647,0.289593,230.633,7.45701,0.384615,654,JM Anderson,0,0,0,0,161,6,25,1,16,14,30,88,128,216,0,227,11,1,10,0.365385,0,3.92308,52.7132,52,3
New Zealand,184,233.745,7.39674,0.36413,227.951,7.30435,0.353261,654,MJ Guptill,98,52,46,121,171,4,29,1,4,1,5,108,97,205,228,231,26,0,10,4.8087,0.313043,38.1217,82.7482,115,4
New Zealand,184,233.745,7.39674,0.36413,227.951,7.30435,0.353261,654,JEC Franklin,16,8,8,17,171,4,29,1,4,1,5,108,97,205,228,231,26,0,10,1.67308,0.0769231,18.7115,77.5299,52,1
New Zealand,184,233.745,7.39674,0.36413,227.951,7.30435,0.353261,655,BB McCullum,11,4,7,8,216,2,51,1,52,27,79,148,198,346,0,359,13,0,10,3.98611,0.201389,29.9028,98.4004,144,0
New Zealand,184,233.745,7.39674,0.36413,227.951,7.30435,0.353261,655,MJ Guptill,139,56,83,140,216,2,51,1,52,27,79,148,198,346,0,359,13,0,10,4.8087,0.313043,38.1217,82.7482,115,4
England,221,237.176,7.17647,0.289593,230.633,7.45701,0.384615,656,EJG Morgan,24,8,16,29,172,4,29,0,60,15,75,118,158,276,0,287,11,1,10,3.19549,0.233083,30.0526,86.9291,133,4
England,221,237.176,7.17647,0.289593,230.633,7.45701,0.384615,656,RS Bopara,25,0,25,35,172,4,29,0,60,15,75,118,158,276,0,287,11,1,10,2.22115,0.144231,25.1538,75.9361,104,4
England,221,237.176,7.17647,0.289593,230.633,7.45701,0.384615,656,JC Buttler,0,0,0,0,172,4,29,0,60,15,75,118,158,276,0,287,11,1,10,3.47458,0.186441,29.9153,115.359,59,0
New Zealand,184,233.745,7.39674,0.36413,227.951,7.30435,0.353261,656,KD Mills,27,14,13,20,192,8,42,1,0,4,4,114,124,238,288,253,15,0,10,1.52542,0.0338983,12.8644,90.7895,59,0
New Zealand,184,233.745,7.39674,0.36413,227.951,7.30435,0.353261,656,MJ McClenaghan,1,0,1,7,192,8,42,1,0,4,4,114,124,238,288,253,15,0,10,0.928571,0,7.71429,75.5245,14,1
Ireland,55,219.527,7.65455,0.290909,202.727,7.56364,0.4,657,WTS Porterfield,112,62,50,142,161,5,38,0,20,18,38,122,115,237,0,269,32,1,10,2.6,0.142857,24.6857,56.2866,35,3
Ireland,55,219.527,7.65455,0.290909,202.727,7.56364,0.4,657,DT Johnston,0,0,0,0,161,5,38,0,20,18,38,122,115,237,0,269,32,1,10,1.27273,0,12.1818,74.2382,22,1
Ireland,55,219.527,7.65455,0.290909,202.727,7.56364,0.4,657,JF Mooney,25,8,17,38,161,5,38,0,20,18,38,122,115,237,0,269,32,1,10,1.47619,0,13.7619,72.796,21,1
Ireland,55,219.527,7.65455,0.290909,202.727,7.56364,0.4,657,MC Sorensen,0,0,0,0,161,5,38,0,20,18,38,122,115,237,0,269,32,1,10,2,0,15.75,84,4,1
Australia,228,239.627,7.69737,0.372807,232.079,7.23246,0.337719,658,GJ Bailey,87,38,49,90,188,5,23,3,4,5,9,98,122,220,0,227,7,0,10,3.34921,0.301587,36.3492,84.658,63,4
Australia,228,239.627,7.69737,0.372807,232.079,7.23246,0.337719,658,CJ McKay,0,0,0,0,188,5,23,3,4,5,9,98,122,220,0,227,7,0,10,0.615385,0,6.88462,55.0769,26,3
Australia,228,239.627,7.69737,0.372807,232.079,7.23246,0.337719,658,NM Coulter-Nile,0,0,0,0,188,5,23,3,4,5,9,98,122,220,0,227,7,0,10,0.571429,0,8.57143,69.7674,7,1
England,221,237.176,7.17647,0.289593,230.633,7.45701,0.384615,658,JC Buttler,41,16,25,34,151,6,37,0,20,11,31,104,115,219,228,231,12,1,10,3.47458,0.186441,29.9153,115.359,59,0
England,221,237.176,7.17647,0.289593,230.633,7.45701,0.384615,658,BA Stokes,19,8,11,20,151,6,37,0,20,11,31,104,115,219,228,231,12,1,10,2.23529,0.117647,20.1471,90.0131,34,0
England,221,237.176,7.17647,0.289593,230.633,7.45701,0.384615,658,JC Tredwell,0,0,0,0,151,6,37,0,20,11,31,104,115,219,228,231,12,1,10,0.52,0,6.52,65.9919,25,1
Australia,228,239.627,7.69737,0.372807,232.079,7.23246,0.337719,659,JP Faulkner,6,0,6,12,225,5,41,3,4,9,13,158,121,279,0,298,19,0,10,2.88235,0.147059,24.1471,109.613,34,0
Australia,228,239.627,7.69737,0.372807,232.079,7.23246,0.337719,659,CJ McKay,0,0,0,0,225,5,41,3,4,9,13,158,121,279,0,298,19,0,10,0.615385,0,6.88462,55.0769,26,3
Australia,228,239.627,7.69737,0.372807,232.079,7.23246,0.337719,659,Fawad Ahmed,0,0,0,0,225,5,41,3,4,9,13,158,121,279,0,298,19,0,10,1,0,4,200,1,2
England,221,237.176,7.17647,0.289593,230.633,7.45701,0.384615,659,CJ Jordan,12,4,8,23,187,7,33,0,4,11,15,86,149,235,299,249,14,1,10,0.833333,0,8.22222,84.0909,18,1
England,221,237.176,7.17647,0.289593,230.633,7.45701,0.384615,659,BA Stokes,23,14,9,18,187,7,33,0,4,11,15,86,149,235,299,249,14,1,10,2.23529,0.117647,20.1471,90.0131,34,0
England,221,237.176,7.17647,0.289593,230.633,7.45701,0.384615,659,JC Tredwell,0,0,0,0,187,7,33,0,4,11,15,86,149,235,299,249,14,1,10,0.52,0,6.52,65.9919,25,1
England,221,237.176,7.17647,0.289593,230.633,7.45701,0.384615,659,WB Rankin,0,0,0,0,187,7,33,0,4,11,15,86,149,235,299,249,14,1,10,0.0833333,0,3.08333,35.9223,12,3
Sri Lanka,244,223.373,7.09016,0.344262,227.578,7.47541,0.385246,661,BMAJ Mendis,14,4,10,23,117,4,25,0,4,22,26,50,118,168,0,181,13,0,10,1.43243,0.027027,15.1622,82.8656,37,1
Sri Lanka,244,223.373,7.09016,0.344262,227.578,7.47541,0.385246,661,AD Mathews,50,10,40,91,117,4,25,0,4,22,26,50,118,168,0,181,13,0,10,2.64122,0.198473,28.6794,82.3362,131,4
Sri Lanka,244,223.373,7.09016,0.344262,227.578,7.47541,0.385246,661,NLTC Perera,0,0,0,0,117,4,25,0,4,22,26,50,118,168,0,181,13,0,10,1.65333,0.0666667,14.32,105.397,75,0
Sri Lanka,244,223.373,7.09016,0.344262,227.578,7.47541,0.385246,661,KMDN Kulasekara,0,0,0,0,117,4,25,0,4,22,26,50,118,168,0,181,13,0,10,1.21,0.04,11.8,80.9328,100,1
Sri Lanka,244,223.373,7.09016,0.344262,227.578,7.47541,0.385246,661,TM Dilshan,12,8,4,14,117,4,25,0,4,22,26,50,118,168,0,181,13,0,10,4.60199,0.273632,38.3632,86.0219,201,4
Sri Lanka,244,223.373,7.09016,0.344262,227.578,7.47541,0.385246,661,SL Malinga,0,0,0,0,117,4,25,0,4,22,26,50,118,168,0,181,13,0,10,0.617284,0.0123457,4.97531,74.6296,81,1
South Africa,190,234.274,7.4,0.373684,232.363,7.33158,0.342105,663,RK Kleinveldt,7,4,3,14,160,5,11,4,18,1,19,72,118,190,0,208,18,1,10,2,0,15,81.3953,7,1
South Africa,190,234.274,7.4,0.373684,232.363,7.33158,0.342105,663,LL Tsotsobe,0,0,0,3,160,5,11,4,18,1,19,72,118,190,0,208,18,1,10,0.444444,0,3.16667,50.8929,18,3
New Zealand,184,233.745,7.39674,0.36413,227.951,7.30435,0.353261,663,JEC Franklin,39,12,27,60,149,8,21,1,8,0,8,88,90,178,209,209,31,0,10,1.67308,0.0769231,18.7115,77.5299,52,1
New Zealand,184,233.745,7.39674,0.36413,227.951,7.30435,0.353261,664,NL McCullum,10,0,10,14,198,6,24,1,28,20,48,138,132,270,0,279,9,0,10,1.63934,0.0655738,17.377,85.622,61,0
New Zealand,184,233.745,7.39674,0.36413,227.951,7.30435,0.353261,664,KS Williamson,121,60,61,125,198,6,24,1,28,20,48,138,132,270,0,279,9,0,10,4.31707,0.390244,43.0488,82.8833,82,4
New Zealand,184,233.745,7.39674,0.36413,227.951,7.30435,0.353261,664,KD Mills,0,0,0,0,198,6,24,1,28,20,48,138,132,270,0,279,9,0,10,1.52542,0.0338983,12.8644,90.7895,59,0
South Africa,190,234.274,7.4,0.373684,232.363,7.33158,0.342105,664,F Behardien,24,4,20,38,197,4,15,3,22,13,35,114,133,247,280,252,5,1,10,2.0303,0.0909091,21.2424,91.395,33,0
South Africa,190,234.274,7.4,0.373684,232.363,7.33158,0.342105,664,M Morkel,0,0,0,0,197,4,15,3,22,13,35,114,133,247,280,252,5,1,10,0.6,0,5.28571,72.2656,35,1
South Africa,190,234.274,7.4,0.373684,232.363,7.33158,0.342105,664,RJ Peterson,0,0,0,3,197,4,15,3,22,13,35,114,133,247,280,252,5,1,10,1.62069,0.0344828,15.7931,83.5766,29,1
South Africa,190,234.274,7.4,0.373684,232.363,7.33158,0.342105,664,LL Tsotsobe,0,0,0,0,197,4,15,3,22,13,35,114,133,247,280,252,5,1,10,0.444444,0,3.16667,50.8929,18,3
New Zealand,184,233.745,7.39674,0.36413,227.951,7.30435,0.353261,665,JEC Franklin,30,4,26,34,163,5,37,2,18,14,32,116,116,232,0,260,28,0,10,1.67308,0.0769231,18.7115,77.5299,52,1
New Zealand,184,233.745,7.39674,0.36413,227.951,7.30435,0.353261,665,JDS Neesham,13,12,1,7,163,5,37,2,18,14,32,116,116,232,0,260,28,0,10,1.75,0,14.875,93.7008,16,0
New Zealand,184,233.745,7.39674,0.36413,227.951,7.30435,0.353261,665,KD Mills,0,0,0,0,163,5,37,2,18,14,32,116,116,232,0,260,28,0,10,1.52542,0.0338983,12.8644,90.7895,59,0
New Zealand,184,233.745,7.39674,0.36413,227.951,7.30435,0.353261,665,MJ McClenaghan,0,0,0,0,163,5,37,2,18,14,32,116,116,232,0,260,28,0,10,0.928571,0,7.71429,75.5245,14,1
South Africa,190,234.274,7.4,0.373684,232.363,7.33158,0.342105,665,R McLaren,10,4,6,13,185,4,35,1,14,20,34,118,136,254,261,264,10,1,10,1.2,0.025,11.975,69.8251,40,1
South Africa,190,234.274,7.4,0.373684,232.363,7.33158,0.342105,665,GC Smith,116,56,60,131,185,4,35,1,14,20,34,118,136,254,261,264,10,1,10,3.97,0.29,33.57,79.6819,100,4
South Africa,190,234.274,7.4,0.373684,232.363,7.33158,0.342105,665,RK Kleinveldt,0,0,0,0,185,4,35,1,14,20,34,118,136,254,261,264,10,1,10,2,0,15,81.3953,7,1
South Africa,190,234.274,7.4,0.373684,232.363,7.33158,0.342105,665,AM Phangiso,0,0,0,0,185,4,35,1,14,20,34,118,136,254,261,264,10,1,10,0.555556,0,7.33333,62.2642,9,1
South Africa,190,234.274,7.4,0.373684,232.363,7.33158,0.342105,665,DW Steyn,0,0,0,0,185,4,35,1,14,20,34,118,136,254,261,264,10,1,10,0.75,0,6.52273,61.588,44,1
South Africa,190,234.274,7.4,0.373684,232.363,7.33158,0.342105,666,CA Ingram,82,24,58,91,220,3,25,0,40,18,58,136,167,303,0,315,12,1,10,3,0.178571,27.1786,81.3904,28,4
South Africa,190,234.274,7.4,0.373684,232.363,7.33158,0.342105,666,F du Plessis,25,16,9,27,220,3,25,0,40,18,58,136,167,303,0,315,12,1,10,3.45122,0.292683,34.9268,83.135,82,4
South Africa,190,234.274,7.4,0.373684,232.363,7.33158,0.342105,666,F Behardien,0,0,0,0,220,3,25,0,40,18,58,136,167,303,0,315,12,1,10,2.0303,0.0909091,21.2424,91.395,33,0
South Africa,190,234.274,7.4,0.373684,232.363,7.33158,0.342105,667,AB de Villiers,119,62,57,106,224,2,45,1,34,18,52,150,171,321,0,343,22,1,10,5.04969,0.403727,47.2174,98.8428,161,4
South Africa,190,234.274,7.4,0.373684,232.363,7.33158,0.342105,667,F du Plessis,8,4,4,3,224,2,45,1,34,18,52,150,171,321,0,343,22,1,10,3.45122,0.292683,34.9268,83.135,82,4
South Africa,190,234.274,7.4,0.373684,232.363,7.33158,0.342105,667,F Behardien,0,0,0,0,224,2,45,1,34,18,52,150,171,321,0,343,22,1,10,2.0303,0.0909091,21.2424,91.395,33,0
South Africa,190,234.274,7.4,0.373684,232.363,7.33158,0.342105,667,R McLaren,0,0,0,0,224,2,45,1,34,18,52,150,171,321,0,343,22,1,10,1.2,0.025,11.975,69.8251,40,1
Pakistan,211,222.621,7.38389,0.393365,235.517,7.54976,0.336493,667,Junaid Khan,4,0,4,5,259,7,27,1,8,4,12,184,114,298,344,309,11,0,10,0.210526,0,2.84211,47.7876,19,3
Pakistan,211,222.621,7.38389,0.393365,235.517,7.54976,0.336493,667,Wahab Riaz,38,22,16,42,259,7,27,1,8,4,12,184,114,298,344,309,11,0,10,1.29167,0.0416667,10.9792,79.1291,48,1
Pakistan,211,222.621,7.38389,0.393365,235.517,7.54976,0.336493,667,Mohammad Irfan,0,0,0,0,259,7,27,1,8,4,12,184,114,298,344,309,11,0,10,0.233333,0,1.56667,30.9211,30,3
South Africa,190,234.274,7.4,0.373684,232.363,7.33158,0.342105,668,RJ Peterson,10,0,10,24,168,7,17,0,24,14,38,82,141,223,0,234,11,1,10,1.62069,0.0344828,15.7931,83.5766,29,1
South Africa,190,234.274,7.4,0.373684,232.363,7.33158,0.342105,668,RK Kleinveldt,9,4,5,15,168,7,17,0,24,14,38,82,141,223,0,234,11,1,10,2,0,15,81.3953,7,1
South Africa,190,234.274,7.4,0.373684,232.363,7.33158,0.342105,668,DW Steyn,0,0,0,0,168,7,17,0,24,14,38,82,141,223,0,234,11,1,10,0.75,0,6.52273,61.588,44,1
South Africa,190,234.274,7.4,0.373684,232.363,7.33158,0.342105,668,LL Tsotsobe,0,0,0,0,168,7,17,0,24,14,38,82,141,223,0,234,11,1,10,0.444444,0,3.16667,50.8929,18,3
Pakistan,211,222.621,7.38389,0.393365,235.517,7.54976,0.336493,668,Imran Farhat,84,32,52,142,167,3,29,2,14,8,22,106,112,218,235,236,18,0,10,3.03333,0.266667,27.0333,62.9658,30,4
Pakistan,211,222.621,7.38389,0.393365,235.517,7.54976,0.336493,668,Shoaib Malik,11,8,3,13,167,3,29,2,14,8,22,106,112,218,235,236,18,0,10,2.77551,0.193878,28.7041,81.4418,98,4
Pakistan,211,222.621,7.38389,0.393365,235.517,7.54976,0.336493,668,Wahab Riaz,0,0,0,0,167,3,29,2,14,8,22,106,112,218,235,236,18,0,10,1.29167,0.0416667,10.9792,79.1291,48,1
Pakistan,211,222.621,7.38389,0.393365,235.517,7.54976,0.336493,668,Saeed Ajmal,0,0,0,0,167,3,29,2,14,8,22,106,112,218,235,236,18,0,10,0.34375,0,4.60938,58.3004,64,3
Pakistan,211,222.621,7.38389,0.393365,235.517,7.54976,0.336493,669,Wahab Riaz,10,0,10,24,154,8,17,0,10,8,18,82,107,189,0,205,16,0,10,1.29167,0.0416667,10.9792,79.1291,48,1
Pakistan,211,222.621,7.38389,0.393365,235.517,7.54976,0.336493,669,Junaid Khan,13,8,5,16,154,8,17,0,10,8,18,82,107,189,0,205,16,0,10,0.210526,0,2.84211,47.7876,19,3
Pakistan,211,222.621,7.38389,0.393365,235.517,7.54976,0.336493,669,Mohammad Irfan,0,0,0,0,154,8,17,0,10,8,18,82,107,189,0,205,16,0,10,0.233333,0,1.56667,30.9211,30,3
England,221,237.176,7.17647,0.289593,230.633,7.45701,0.384615,670,CR Woakes,1,0,1,5,184,3,31,3,24,9,33,116,132,248,0,258,10,0,10,1.09375,0,15.1562,76.8621,32,1
England,221,237.176,7.17647,0.289593,230.633,7.45701,0.384615,670,SCJ Broad,0,0,0,2,184,3,31,3,24,9,33,116,132,248,0,258,10,0,10,0.725806,0,8.04839,74.0356,62,1
England,221,237.176,7.17647,0.289593,230.633,7.45701,0.384615,670,GP Swann,0,0,0,0,184,3,31,3,24,9,33,116,132,248,0,258,10,0,10,1.08696,0,10.3043,90.631,46,0
England,221,237.176,7.17647,0.289593,230.633,7.45701,0.384615,670,ST Finn,0,0,0,0,184,3,31,3,24,9,33,116,132,248,0,258,10,0,10,0.583333,0,5.41667,59.633,24,3
England,221,237.176,7.17647,0.289593,230.633,7.45701,0.384615,670,JM Anderson,0,0,0,0,184,3,31,3,24,9,33,116,132,248,0,258,10,0,10,0.365385,0,3.92308,52.7132,52,3
New Zealand,184,233.745,7.39674,0.36413,227.951,7.30435,0.353261,670,AM Ellis,11,4,7,11,168,5,35,1,32,11,43,122,124,246,259,259,13,1,10,1,0,12.75,80.9524,12,1
New Zealand,184,233.745,7.39674,0.36413,227.951,7.30435,0.353261,670,BB McCullum,52,32,20,51,168,5,35,1,32,11,43,122,124,246,259,259,13,1,10,3.98611,0.201389,29.9028,98.4004,144,0
New Zealand,184,233.745,7.39674,0.36413,227.951,7.30435,0.353261,670,MJ Guptill,3,0,3,17,168,5,35,1,32,11,43,122,124,246,259,259,13,1,10,4.8087,0.313043,38.1217,82.7482,115,4
New Zealand,184,233.745,7.39674,0.36413,227.951,7.30435,0.353261,671,JEC Franklin,0,0,0,0,163,4,74,1,14,11,25,128,134,262,0,269,7,1,10,1.67308,0.0769231,18.7115,77.5299,52,1
New Zealand,184,233.745,7.39674,0.36413,227.951,7.30435,0.353261,671,LRPL Taylor,89,34,55,112,163,4,74,1,14,11,25,128,134,262,0,269,7,1,10,3.68382,0.301471,36.7206,79.3959,136,4
New Zealand,184,233.745,7.39674,0.36413,227.951,7.30435,0.353261,671,NL McCullum,0,0,0,0,163,4,74,1,14,11,25,128,134,262,0,269,7,1,10,1.63934,0.0655738,17.377,85.622,61,0
New Zealand,184,233.745,7.39674,0.36413,227.951,7.30435,0.353261,671,TG Southee,0,0,0,0,163,4,74,1,14,11,25,128,134,262,0,269,7,1,10,0.764706,0,7.03922,92.7649,51,0
New Zealand,184,233.745,7.39674,0.36413,227.951,7.30435,0.353261,671,KD Mills,0,0,0,0,163,4,74,1,14,11,25,128,134,262,0,269,7,1,10,1.52542,0.0338983,12.8644,90.7895,59,0
New Zealand,184,233.745,7.39674,0.36413,227.951,7.30435,0.353261,671,TA Boult,0,0,0,0,163,4,74,1,14,11,25,128,134,262,0,269,7,1,10,0.727273,0,5.27273,77.3333,11,1
England,221,237.176,7.17647,0.289593,230.633,7.45701,0.384615,671,IJL Trott,56,4,52,71,198,2,40,0,22,6,28,106,160,266,270,270,4,0,10,3.3871,0.403226,43.7903,75.2494,62,4
England,221,237.176,7.17647,0.289593,230.633,7.45701,0.384615,671,JE Root,60,26,34,44,198,2,40,0,22,6,28,106,160,266,270,270,4,0,10,3.68852,0.327869,41.6721,83.3443,61,4
Pakistan,211,222.621,7.38389,0.393365,235.517,7.54976,0.336493,673,Saeed Ajmal,8,4,4,13,166,7,15,2,0,0,0,64,117,181,0,198,17,0,10,0.34375,0,4.60938,58.3004,64,3
Australia,228,239.627,7.69737,0.372807,232.079,7.23246,0.337719,673,GJ Bailey,45,4,41,79,137,5,31,0,10,9,19,48,139,187,199,199,12,0,10,3.34921,0.301587,36.3492,84.658,63,4
Australia,228,239.627,7.69737,0.372807,232.079,7.23246,0.337719,673,GJ Maxwell,34,10,24,37,137,5,31,0,10,9,19,48,139,187,199,199,12,0,10,3.79245,0.226415,28.2264,119.68,53,0
Australia,228,239.627,7.69737,0.372807,232.079,7.23246,0.337719,673,DT Christian,0,0,0,0,137,5,31,0,10,9,19,48,139,187,199,199,12,0,10,1.44444,0,15.1111,86.901,18,0
Australia,228,239.627,7.69737,0.372807,232.079,7.23246,0.337719,674,MEK Hussey,61,16,45,71,165,5,31,0,16,17,33,80,149,229,0,248,19,0,10,2.7563,0.260504,34.084,82.4893,119,4
Australia,228,239.627,7.69737,0.372807,232.079,7.23246,0.337719,674,DT Christian,0,0,0,0,165,5,31,0,16,17,33,80,149,229,0,248,19,0,10,1.44444,0,15.1111,86.901,18,0
Australia,228,239.627,7.69737,0.372807,232.079,7.23246,0.337719,674,GJ Maxwell,28,12,16,26,165,5,31,0,16,17,33,80,149,229,0,248,19,0,10,3.79245,0.226415,28.2264,119.68,53,0
Australia,228,239.627,7.69737,0.372807,232.079,7.23246,0.337719,674,MG Johnson,0,0,0,0,165,5,31,0,16,17,33,80,149,229,0,248,19,0,10,1.18519,0.0246914,10.7901,94.181,81,0
Australia,228,239.627,7.69737,0.372807,232.079,7.23246,0.337719,674,JL Pattinson,0,0,0,0,165,5,31,0,16,17,33,80,149,229,0,248,19,0,10,0.285714,0,5.85714,51.25,7,3
Australia,228,239.627,7.69737,0.372807,232.079,7.23246,0.337719,674,MA Starc,0,0,0,0,165,5,31,0,16,17,33,80,149,229,0,248,19,0,10,0.692308,0,8.46154,70.0637,13,1
Pakistan,211,222.621,7.38389,0.393365,235.517,7.54976,0.336493,675,Misbah-ul-Haq,22,0,22,34,176,5,24,0,4,22,26,72,154,226,0,244,18,0,10,2.95238,0.285714,34.9921,71.8195,126,4
Pakistan,211,222.621,7.38389,0.393365,235.517,7.54976,0.336493,675,Azhar Ali,18,8,10,21,176,5,24,0,4,22,26,72,154,226,0,244,18,0,10,3.83333,0.3,38.5333,73.6775,30,4
Pakistan,211,222.621,7.38389,0.393365,235.517,7.54976,0.336493,675,Kamran Akmal,0,0,0,0,176,5,24,0,4,22,26,72,154,226,0,244,18,0,10,3.01124,0.11236,23.0787,81.4433,89,4
Pakistan,211,222.621,7.38389,0.393365,235.517,7.54976,0.336493,675,Abdur Rehman,0,0,0,0,176,5,24,0,4,22,26,72,154,226,0,244,18,0,10,0.52381,0,6.04762,55.7018,21,3
Australia,228,239.627,7.69737,0.372807,232.079,7.23246,0.337719,675,DT Christian,1,0,1,3,186,5,34,1,20,3,23,124,119,243,245,250,7,0,10,1.44444,0,15.1111,86.901,18,0
Australia,228,239.627,7.69737,0.372807,232.079,7.23246,0.337719,675,GJ Maxwell,35,14,21,31,186,5,34,1,20,3,23,124,119,243,245,250,7,0,10,3.79245,0.226415,28.2264,119.68,53,0
Australia,228,239.627,7.69737,0.372807,232.079,7.23246,0.337719,675,MG Johnson,0,0,0,0,186,5,34,1,20,3,23,124,119,243,245,250,7,0,10,1.18519,0.0246914,10.7901,94.181,81,0
Australia,228,239.627,7.69737,0.372807,232.079,7.23246,0.337719,676,DJ Hussey,21,8,13,15,211,3,36,2,22,26,48,128,167,295,0,305,10,1,10,2.54386,0.245614,29.2105,87.8628,57,4
Australia,228,239.627,7.69737,0.372807,232.079,7.23246,0.337719,676,BJ Haddin,1,0,1,3,211,3,36,2,22,26,48,128,167,295,0,305,10,1,10,3.14737,0.147368,26.7789,81.382,95,4
Australia,228,239.627,7.69737,0.372807,232.079,7.23246,0.337719,677,BJ Haddin,43,18,25,61,134,8,19,1,4,7,11,68,96,164,0,170,6,1,10,3.14737,0.147368,26.7789,81.382,95,4
Australia,228,239.627,7.69737,0.372807,232.079,7.23246,0.337719,677,XJ Doherty,1,0,1,7,134,8,19,1,4,7,11,68,96,164,0,170,6,1,10,0.190476,0,4.28571,52.0231,21,3
Australia,228,239.627,7.69737,0.372807,232.079,7.23246,0.337719,679,PJ Hughes,108,40,68,141,167,3,28,1,22,23,45,90,150,240,0,247,7,1,10,4.52381,0.285714,38.7619,74.7475,21,4
Australia,228,239.627,7.69737,0.372807,232.079,7.23246,0.337719,679,GJ Maxwell,3,0,3,2,167,3,28,1,22,23,45,90,150,240,0,247,7,1,10,3.79245,0.226415,28.2264,119.68,53,0
Sri Lanka,244,223.373,7.09016,0.344262,227.578,7.47541,0.385246,679,NLTC Perera,7,4,3,5,138,5,41,2,8,9,17,86,110,196,248,215,19,0,10,1.65333,0.0666667,14.32,105.397,75,0
Sri Lanka,244,223.373,7.09016,0.344262,227.578,7.47541,0.385246,679,HMRKB Herath,0,0,0,0,138,5,41,2,8,9,17,86,110,196,248,215,19,0,10,0.444444,0,5.18519,61.674,27,1
Sri Lanka,244,223.373,7.09016,0.344262,227.578,7.47541,0.385246,679,KMDN Kulasekara,1,0,1,1,138,5,41,2,8,9,17,86,110,196,248,215,19,0,10,1.21,0.04,11.8,80.9328,100,1
Sri Lanka,244,223.373,7.09016,0.344262,227.578,7.47541,0.385246,679,SL Malinga,0,0,0,0,138,5,41,2,8,9,17,86,110,196,248,215,19,0,10,0.617284,0.0123457,4.97531,74.6296,81,1
Australia,228,239.627,7.69737,0.372807,232.079,7.23246,0.337719,681,GJ Bailey,78,28,50,96,159,6,27,1,40,21,61,122,125,247,0,266,19,1,10,3.34921,0.301587,36.3492,84.658,63,4
Australia,228,239.627,7.69737,0.372807,232.079,7.23246,0.337719,681,MG Johnson,2,0,2,4,159,6,27,1,40,21,61,122,125,247,0,266,19,1,10,1.18519,0.0246914,10.7901,94.181,81,0
Australia,228,239.627,7.69737,0.372807,232.079,7.23246,0.337719,682,PJ Hughes,85,46,39,93,235,2,38,1,30,20,50,164,159,323,0,329,6,1,10,4.52381,0.285714,38.7619,74.7475,21,4
Australia,228,239.627,7.69737,0.372807,232.079,7.23246,0.337719,682,GJ Bailey,13,4,9,10,235,2,38,1,30,20,50,164,159,323,0,329,6,1,10,3.34921,0.301587,36.3492,84.658,63,4
Australia,228,239.627,7.69737,0.372807,232.079,7.23246,0.337719,682,GJ Maxwell,0,0,0,0,235,2,38,1,30,20,50,164,159,323,0,329,6,1,10,3.79245,0.226415,28.2264,119.68,53,0
Australia,228,239.627,7.69737,0.372807,232.079,7.23246,0.337719,682,MS Wade,0,0,0,0,235,2,38,1,30,20,50,164,159,323,0,329,6,1,10,1.86275,0.117647,20.3333,78.2642,51,1
Australia,228,239.627,7.69737,0.372807,232.079,7.23246,0.337719,682,JP Faulkner,0,0,0,0,235,2,38,1,30,20,50,164,159,323,0,329,6,1,10,2.88235,0.147059,24.1471,109.613,34,0
Australia,228,239.627,7.69737,0.372807,232.079,7.23246,0.337719,682,MG Johnson,0,0,0,0,235,2,38,1,30,20,50,164,159,323,0,329,6,1,10,1.18519,0.0246914,10.7901,94.181,81,0
West Indies,176,217.33,7.15909,0.3125,225.278,7.57386,0.380682,682,DJG Sammy,1,0,1,1,225,5,35,2,14,5,19,138,141,279,330,290,11,0,10,2.25,0.09,18.25,95.8005,100,0
West Indies,176,217.33,7.15909,0.3125,225.278,7.57386,0.380682,682,AD Russell,33,22,11,27,225,5,35,2,14,5,19,138,141,279,330,290,11,0,10,3.38095,0.0952381,23.2857,129.536,42,0
West Indies,176,217.33,7.15909,0.3125,225.278,7.57386,0.380682,682,SP Narine,0,0,0,0,225,5,35,2,14,5,19,138,141,279,330,290,11,0,10,1.05882,0,8.55882,76.378,34,1
West Indies,176,217.33,7.15909,0.3125,225.278,7.57386,0.380682,682,KAJ Roach,0,0,0,0,225,5,35,2,14,5,19,138,141,279,330,290,11,0,10,0.526316,0,5.68421,50.5855,38,3
West Indies,176,217.33,7.15909,0.3125,225.278,7.57386,0.380682,683,KA Pollard,78,36,42,114,138,8,34,0,24,13,37,102,107,209,0,220,11,0,10,2.70513,0.115385,24.5,88.0645,78,4
West Indies,176,217.33,7.15909,0.3125,225.278,7.57386,0.380682,683,SP Narine,18,8,10,20,138,8,34,0,24,13,37,102,107,209,0,220,11,0,10,1.05882,0,8.55882,76.378,34,1
West Indies,176,217.33,7.15909,0.3125,225.278,7.57386,0.380682,683,TL Best,0,0,0,0,138,8,34,0,24,13,37,102,107,209,0,220,11,0,10,0.375,0,4,42.6667,8,3
Australia,228,239.627,7.69737,0.372807,232.079,7.23246,0.337719,684,AC Voges,87,38,49,92,164,4,47,1,18,27,45,112,144,256,0,274,18,1,10,2.29167,0.125,29.625,84.142,24,4
Australia,228,239.627,7.69737,0.372807,232.079,7.23246,0.337719,684,JP Faulkner,11,4,7,11,164,4,47,1,18,27,45,112,144,256,0,274,18,1,10,2.88235,0.147059,24.1471,109.613,34,0
West Indies,176,217.33,7.15909,0.3125,225.278,7.57386,0.380682,684,DJG Sammy,1,0,1,2,179,5,36,1,14,12,26,98,143,241,275,257,16,0,10,2.25,0.09,18.25,95.8005,100,0
West Indies,176,217.33,7.15909,0.3125,225.278,7.57386,0.380682,684,KA Pollard,43,14,29,61,179,5,36,1,14,12,26,98,143,241,275,257,16,0,10,2.70513,0.115385,24.5,88.0645,78,4
West Indies,176,217.33,7.15909,0.3125,225.278,7.57386,0.380682,684,SP Narine,0,0,0,0,179,5,36,1,14,12,26,98,143,241,275,257,16,0,10,1.05882,0,8.55882,76.378,34,1
West Indies,176,217.33,7.15909,0.3125,225.278,7.57386,0.380682,684,KAJ Roach,0,0,0,0,179,5,36,1,14,12,26,98,143,241,275,257,16,0,10,0.526316,0,5.68421,50.5855,38,3
West Indies,176,217.33,7.15909,0.3125,225.278,7.57386,0.380682,684,TL Best,0,0,0,0,179,5,36,1,14,12,26,98,143,241,275,257,16,0,10,0.375,0,4,42.6667,8,3
Pakistan,211,222.621,7.38389,0.393365,235.517,7.54976,0.336493,685,Misbah-ul-Haq,86,32,54,117,132,8,21,1,6,5,11,62,102,164,0,170,6,0,10,2.95238,0.285714,34.9921,71.8195,126,4
Pakistan,211,222.621,7.38389,0.393365,235.517,7.54976,0.336493,685,Mohammad Irfan,1,0,1,7,132,8,21,1,6,5,11,62,102,164,0,170,6,0,10,0.233333,0,1.56667,30.9211,30,3
England,221,237.176,7.17647,0.289593,230.633,7.45701,0.384615,686,RS Bopara,16,4,12,20,183,4,19,2,22,26,48,74,176,250,0,269,19,1,10,2.22115,0.144231,25.1538,75.9361,104,4
England,221,237.176,7.17647,0.289593,230.633,7.45701,0.384615,686,TT Bresnan,1,0,1,7,183,4,19,2,22,26,48,74,176,250,0,269,19,1,10,1.52381,0.015873,13.8095,88.4146,63,0
Australia,228,239.627,7.69737,0.372807,232.079,7.23246,0.337719,686,CJ McKay,1,0,1,1,149,7,36,2,12,16,28,62,151,213,270,221,8,0,10,0.615385,0,6.88462,55.0769,26,3
Australia,228,239.627,7.69737,0.372807,232.079,7.23246,0.337719,686,JP Faulkner,32,14,18,27,149,7,36,2,12,16,28,62,151,213,270,221,8,0,10,2.88235,0.147059,24.1471,109.613,34,0
South Africa,190,234.274,7.4,0.373684,232.363,7.33158,0.342105,688,DA Miller,6,0,6,13,176,3,18,2,16,14,30,82,142,224,0,234,10,0,10,2.57353,0.132353,24.9412,97.2477,68,0
South Africa,190,234.274,7.4,0.373684,232.363,7.33158,0.342105,688,R McLaren,4,0,4,7,176,3,18,2,16,14,30,82,142,224,0,234,10,0,10,1.2,0.025,11.975,69.8251,40,1
South Africa,190,234.274,7.4,0.373684,232.363,7.33158,0.342105,688,RJ Peterson,0,0,0,0,176,3,18,2,16,14,30,82,142,224,0,234,10,0,10,1.62069,0.0344828,15.7931,83.5766,29,1
South Africa,190,234.274,7.4,0.373684,232.363,7.33158,0.342105,688,CH Morris,0,0,0,0,176,3,18,2,16,14,30,82,142,224,0,234,10,0,10,1.83333,0.166667,16,101.053,6,0
West Indies,176,217.33,7.15909,0.3125,225.278,7.57386,0.380682,689,R Rampaul,2,0,2,4,162,6,12,2,44,7,51,136,89,225,0,233,8,0,10,1.30303,0.030303,9.90909,77.4882,33,1
West Indies,176,217.33,7.15909,0.3125,225.278,7.57386,0.380682,689,KAJ Roach,0,0,0,0,162,6,12,2,44,7,51,136,89,225,0,233,8,0,10,0.526316,0,5.68421,50.5855,38,3
West Indies,176,217.33,7.15909,0.3125,225.278,7.57386,0.380682,689,DJG Sammy,5,0,5,16,162,6,12,2,44,7,51,136,89,225,0,233,8,0,10,2.25,0.09,18.25,95.8005,100,0
England,221,237.176,7.17647,0.289593,230.633,7.45701,0.384615,690,EJG Morgan,8,0,8,7,188,2,43,1,34,15,49,98,182,280,0,293,13,1,10,3.19549,0.233083,30.0526,86.9291,133,4
England,221,237.176,7.17647,0.289593,230.633,7.45701,0.384615,690,JE Root,68,20,48,54,188,2,43,1,34,15,49,98,182,280,0,293,13,1,10,3.68852,0.327869,41.6721,83.3443,61,4
England,221,237.176,7.17647,0.289593,230.633,7.45701,0.384615,690,RS Bopara,0,0,0,0,188,2,43,1,34,15,49,98,182,280,0,293,13,1,10,2.22115,0.144231,25.1538,75.9361,104,4
England,221,237.176,7.17647,0.289593,230.633,7.45701,0.384615,690,JC Buttler,0,0,0,0,188,2,43,1,34,15,49,98,182,280,0,293,13,1,10,3.47458,0.186441,29.9153,115.359,59,0
England,221,237.176,7.17647,0.289593,230.633,7.45701,0.384615,690,TT Bresnan,0,0,0,0,188,2,43,1,34,15,49,98,182,280,0,293,13,1,10,1.52381,0.015873,13.8095,88.4146,63,0
England,221,237.176,7.17647,0.289593,230.633,7.45701,0.384615,690,SCJ Broad,0,0,0,0,188,2,43,1,34,15,49,98,182,280,0,293,13,1,10,0.725806,0,8.04839,74.0356,62,1
Sri Lanka,244,223.373,7.09016,0.344262,227.578,7.47541,0.385246,690,KMDN Kulasekara,53,38,15,37,210,3,53,0,8,13,21,126,158,284,294,297,13,0,10,1.21,0.04,11.8,80.9328,100,1
Sri Lanka,244,223.373,7.09016,0.344262,227.578,7.47541,0.385246,690,KC Sangakkara,118,40,78,129,210,3,53,0,8,13,21,126,158,284,294,297,13,0,10,4.33659,0.360976,41.9854,80.6276,205,4
New Zealand,184,233.745,7.39674,0.36413,227.951,7.30435,0.353261,694,LRPL Taylor,70,40,30,61,151,3,49,0,8,22,30,90,140,230,0,250,20,0,10,3.68382,0.301471,36.7206,79.3959,136,4
New Zealand,184,233.745,7.39674,0.36413,227.951,7.30435,0.353261,694,NL McCullum,0,0,0,0,151,3,49,0,8,22,30,90,140,230,0,250,20,0,10,1.63934,0.0655738,17.377,85.622,61,0
New Zealand,184,233.745,7.39674,0.36413,227.951,7.30435,0.353261,694,JEC Franklin,27,6,21,34,151,3,49,0,8,22,30,90,140,230,0,250,20,0,10,1.67308,0.0769231,18.7115,77.5299,52,1
New Zealand,184,233.745,7.39674,0.36413,227.951,7.30435,0.353261,694,AM Ellis,0,0,0,0,151,3,49,0,8,22,30,90,140,230,0,250,20,0,10,1,0,12.75,80.9524,12,1
West Indies,176,217.33,7.15909,0.3125,225.278,7.57386,0.380682,697,SP Narine,33,12,21,39,168,8,15,1,0,5,5,104,84,188,0,199,11,0,10,1.05882,0,8.55882,76.378,34,1
West Indies,176,217.33,7.15909,0.3125,225.278,7.57386,0.380682,697,KAJ Roach,1,0,1,4,168,8,15,1,0,5,5,104,84,188,0,199,11,0,10,0.526316,0,5.68421,50.5855,38,3
Bangladesh,160,218.438,7.70625,0.4,211.106,7.05,0.325,698,Mominul Haque,15,4,11,19,189,4,18,0,42,17,59,140,126,266,0,292,26,1,10,2.57143,0.0952381,23.3333,73.4633,21,4
Bangladesh,160,218.438,7.70625,0.4,211.106,7.05,0.325,698,Anamul Haque,98,48,50,136,189,4,18,0,42,17,59,140,126,266,0,292,26,1,10,4.12,0.24,36.8,69.6442,25,4
Bangladesh,160,218.438,7.70625,0.4,211.106,7.05,0.325,698,Mashrafe Mortaza,0,0,0,0,189,4,18,0,42,17,59,140,126,266,0,292,26,1,10,1.27536,0,11.1594,76.9231,69,1
Bangladesh,160,218.438,7.70625,0.4,211.106,7.05,0.325,698,Mahmudullah,0,0,0,0,189,4,18,0,42,17,59,140,126,266,0,292,26,1,10,2.26531,0.153061,24.4286,70.9544,98,4
Bangladesh,160,218.438,7.70625,0.4,211.106,7.05,0.325,699,Sohag Gazi,13,8,5,22,156,7,23,0,12,10,22,92,109,201,0,227,26,1,10,1.46667,0,12.1333,87.9227,15,0
Bangladesh,160,218.438,7.70625,0.4,211.106,7.05,0.325,699,Mahmudullah,51,18,33,72,156,7,23,0,12,10,22,92,109,201,0,227,26,1,10,2.26531,0.153061,24.4286,70.9544,98,4
Bangladesh,160,218.438,7.70625,0.4,211.106,7.05,0.325,699,Abdur Razzak,0,0,0,0,156,7,23,0,12,10,22,92,109,201,0,227,26,1,10,0.849315,0.0136986,8.39726,73.8554,73,1
Bangladesh,160,218.438,7.70625,0.4,211.106,7.05,0.325,699,Rubel Hossain,0,0,0,0,156,7,23,0,12,10,22,92,109,201,0,227,26,1,10,0.32,0,2.68,52.3438,25,3
West Indies,176,217.33,7.15909,0.3125,225.278,7.57386,0.380682,699,DC Thomas,5,0,5,15,162,5,36,0,4,6,10,118,90,208,228,228,20,0,10,1.11111,0,12.4444,61.3699,18,1
West Indies,176,217.33,7.15909,0.3125,225.278,7.57386,0.380682,699,MN Samuels,124,80,44,151,162,5,36,0,4,6,10,118,90,208,228,228,20,0,10,3.74757,0.23301,31.6214,74.5821,103,4
West Indies,176,217.33,7.15909,0.3125,225.278,7.57386,0.380682,699,DJG Sammy,0,0,0,0,162,5,36,0,4,6,10,118,90,208,228,228,20,0,10,2.25,0.09,18.25,95.8005,100,0
West Indies,176,217.33,7.15909,0.3125,225.278,7.57386,0.380682,700,DJG Sammy,30,14,16,45,119,6,33,2,22,18,40,94,98,192,0,211,19,0,10,2.25,0.09,18.25,95.8005,100,0
West Indies,176,217.33,7.15909,0.3125,225.278,7.57386,0.380682,700,SP Narine,6,4,2,3,119,6,33,2,22,18,40,94,98,192,0,211,19,0,10,1.05882,0,8.55882,76.378,34,1
West Indies,176,217.33,7.15909,0.3125,225.278,7.57386,0.380682,700,KAJ Roach,0,0,0,0,119,6,33,2,22,18,40,94,98,192,0,211,19,0,10,0.526316,0,5.68421,50.5855,38,3
West Indies,176,217.33,7.15909,0.3125,225.278,7.57386,0.380682,701,SP Narine,0,0,0,0,166,5,15,3,0,13,13,106,88,194,0,217,23,0,10,1.05882,0,8.55882,76.378,34,1
West Indies,176,217.33,7.15909,0.3125,225.278,7.57386,0.380682,701,DC Thomas,19,8,11,24,166,5,15,3,0,13,13,106,88,194,0,217,23,0,10,1.11111,0,12.4444,61.3699,18,1
West Indies,176,217.33,7.15909,0.3125,225.278,7.57386,0.380682,701,KAJ Roach,0,0,0,0,166,5,15,3,0,13,13,106,88,194,0,217,23,0,10,0.526316,0,5.68421,50.5855,38,3
India,259,242.378,7.15058,0.339768,244.568,7.12741,0.30888,702,MS Dhoni,69,18,51,107,125,6,29,0,32,19,51,70,135,205,0,227,22,1,10,3.47872,0.292553,36.7713,84.1612,188,4
India,259,242.378,7.15058,0.339768,244.568,7.12741,0.30888,702,R Ashwin,24,4,20,30,125,6,29,0,32,19,51,70,135,205,0,227,22,1,10,1.16364,0.0181818,11.9455,84.7742,55,1
Pakistan,211,222.621,7.38389,0.393365,235.517,7.54976,0.336493,702,Nasir Jamshed,96,26,70,123,167,4,35,0,4,12,16,60,158,218,228,228,10,0,10,3.63043,0.23913,30.2174,73.8184,46,4
Pakistan,211,222.621,7.38389,0.393365,235.517,7.54976,0.336493,702,Shoaib Malik,23,8,15,27,167,4,35,0,4,12,16,60,158,218,228,228,10,0,10,2.77551,0.193878,28.7041,81.4418,98,4
Pakistan,211,222.621,7.38389,0.393365,235.517,7.54976,0.336493,703,Umar Gul,11,8,3,21,113,6,18,0,8,3,11,72,70,142,168,157,15,0,10,0.77193,0,7.14035,68.2886,57,1
Pakistan,211,222.621,7.38389,0.393365,235.517,7.54976,0.336493,703,Mohammad Hafeez,11,0,11,22,113,6,18,0,8,3,11,72,70,142,168,157,15,0,10,4.04511,0.255639,34.3534,78.0625,133,4
Pakistan,211,222.621,7.38389,0.393365,235.517,7.54976,0.336493,703,Saeed Ajmal,0,0,0,0,113,6,18,0,8,3,11,72,70,142,168,157,15,0,10,0.34375,0,4.60938,58.3004,64,3
Pakistan,211,222.621,7.38389,0.393365,235.517,7.54976,0.336493,703,Junaid Khan,0,0,0,0,113,6,18,0,8,3,11,72,70,142,168,157,15,0,10,0.210526,0,2.84211,47.7876,19,3
Pakistan,211,222.621,7.38389,0.393365,235.517,7.54976,0.336493,703,Mohammad Irfan,0,0,0,0,113,6,18,0,8,3,11,72,70,142,168,157,15,0,10,0.233333,0,1.56667,30.9211,30,3
West Indies,176,217.33,7.15909,0.3125,225.278,7.57386,0.380682,705,DJ Bravo,5,0,5,11,254,2,24,1,30,21,51,176,153,329,0,337,8,1,10,2.35514,0.11215,23.1589,80.9011,107,4
West Indies,176,217.33,7.15909,0.3125,225.278,7.57386,0.380682,705,DM Bravo,60,34,26,52,254,2,24,1,30,21,51,176,153,329,0,337,8,1,10,3,0.226667,28.52,67.4551,75,4
West Indies,176,217.33,7.15909,0.3125,225.278,7.57386,0.380682,705,RR Sarwan,0,0,0,0,254,2,24,1,30,21,51,176,153,329,0,337,8,1,10,2.8254,0.222222,29.1429,69.1005,63,4
Zimbabwe,142,212.077,7.5,0.380282,227.704,6.97887,0.316901,705,P Utseya,14,0,14,51,133,6,14,2,6,6,12,76,83,159,338,181,22,0,10,0.842105,0.0263158,11.8289,55.8385,76,3
Zimbabwe,142,212.077,7.5,0.380282,227.704,6.97887,0.316901,705,N Mushangwe,6,6,0,7,133,6,14,2,6,6,12,76,83,159,338,181,22,0,10,1.25,0,9.5,86.3636,4,1
Zimbabwe,142,212.077,7.5,0.380282,227.704,6.97887,0.316901,706,KM Jarvis,5,0,5,15,151,6,15,2,20,12,32,88,110,198,0,211,13,0,10,0.333333,0,3.75,36.2903,12,3
Zimbabwe,142,212.077,7.5,0.380282,227.704,6.97887,0.316901,706,CJ Chibhabha,20,4,16,46,151,6,15,2,20,12,32,88,110,198,0,211,13,0,10,2.56716,0.149254,23.5373,64.7373,67,1
West Indies,176,217.33,7.15909,0.3125,225.278,7.57386,0.380682,706,D Ramdin,15,0,15,21,164,5,28,0,8,3,11,70,133,203,212,215,12,1,10,1.7439,0.097561,19.1951,81.1759,82,1
West Indies,176,217.33,7.15909,0.3125,225.278,7.57386,0.380682,706,DM Bravo,70,20,50,102,164,5,28,0,8,3,11,70,133,203,212,215,12,1,10,3,0.226667,28.52,67.4551,75,4
Sri Lanka,244,223.373,7.09016,0.344262,227.578,7.47541,0.385246,707,AD Mathews,49,20,29,67,163,6,18,2,6,10,16,84,113,197,0,208,11,0,10,2.64122,0.198473,28.6794,82.3362,131,4
Sri Lanka,244,223.373,7.09016,0.344262,227.578,7.47541,0.385246,707,SL Malinga,0,0,0,4,163,6,18,2,6,10,16,84,113,197,0,208,11,0,10,0.617284,0.0123457,4.97531,74.6296,81,1
Sri Lanka,244,223.373,7.09016,0.344262,227.578,7.47541,0.385246,707,BAW Mendis,0,0,0,0,163,6,18,2,6,10,16,84,113,197,0,208,11,0,10,0.447368,0,4.47368,66.4062,38,1
India,259,242.378,7.15058,0.339768,244.568,7.12741,0.30888,708,MS Dhoni,22,0,22,31,149,4,28,1,18,12,30,86,121,207,0,229,22,0,10,3.47872,0.292553,36.7713,84.1612,188,4
India,259,242.378,7.15058,0.339768,244.568,7.12741,0.30888,708,RA Jadeja,6,4,2,10,149,4,28,1,18,12,30,86,121,207,0,229,22,0,10,2.12941,0.117647,21.7529,82.4342,85,4
India,259,242.378,7.15058,0.339768,244.568,7.12741,0.30888,708,R Ashwin,0,0,0,0,149,4,28,1,18,12,30,86,121,207,0,229,22,0,10,1.16364,0.0181818,11.9455,84.7742,55,1
India,259,242.378,7.15058,0.339768,244.568,7.12741,0.30888,708,B Kumar,0,0,0,0,149,4,28,1,18,12,30,86,121,207,0,229,22,0,10,0.75,0,7.39286,72.1254,28,1
West Indies,176,217.33,7.15909,0.3125,225.278,7.57386,0.380682,708,KAJ Roach,9,0,9,19,204,7,12,2,0,7,7,120,103,223,230,230,7,1,10,0.526316,0,5.68421,50.5855,38,3
West Indies,176,217.33,7.15909,0.3125,225.278,7.57386,0.380682,708,TL Best,1,0,1,7,204,7,12,2,0,7,7,120,103,223,230,230,7,1,10,0.375,0,4,42.6667,8,3
Sri Lanka,244,223.373,7.09016,0.344262,227.578,7.47541,0.385246,709,AD Mathews,24,10,14,20,210,1,55,0,36,24,60,164,161,325,0,348,23,0,10,2.64122,0.198473,28.6794,82.3362,131,4
Sri Lanka,244,223.373,7.09016,0.344262,227.578,7.47541,0.385246,709,WU Tharanga,134,70,64,145,210,1,55,0,36,24,60,164,161,325,0,348,23,0,10,3.93985,0.263158,32.9699,71.6035,133,4
India,259,242.378,7.15058,0.339768,244.568,7.12741,0.30888,710,R Ashwin,5,0,5,10,193,5,40,1,36,18,54,170,117,287,0,311,24,0,10,1.16364,0.0181818,11.9455,84.7742,55,1
India,259,242.378,7.15058,0.339768,244.568,7.12741,0.30888,710,V Kohli,68,40,28,67,193,5,40,1,36,18,54,170,117,287,0,311,24,0,10,4.66456,0.379747,44.9937,88.3325,158,4
Sri Lanka,244,223.373,7.09016,0.344262,227.578,7.47541,0.385246,712,AD Mathews,10,0,10,23,155,5,16,1,0,7,7,68,110,178,0,201,23,0,10,2.64122,0.198473,28.6794,82.3362,131,4
Sri Lanka,244,223.373,7.09016,0.344262,227.578,7.47541,0.385246,712,RMS Eranga,0,0,0,0,155,5,16,1,0,7,7,68,110,178,0,201,23,0,10,0.444444,0,3.77778,51.5152,9,3
Sri Lanka,244,223.373,7.09016,0.344262,227.578,7.47541,0.385246,712,HMRKB Herath,4,0,4,8,155,5,16,1,0,7,7,68,110,178,0,201,23,0,10,0.444444,0,5.18519,61.674,27,1
Sri Lanka,244,223.373,7.09016,0.344262,227.578,7.47541,0.385246,712,SL Malinga,0,0,0,0,155,5,16,1,0,7,7,68,110,178,0,201,23,0,10,0.617284,0.0123457,4.97531,74.6296,81,1
India,259,242.378,7.15058,0.339768,244.568,7.12741,0.30888,712,MS Dhoni,25,16,9,37,153,7,11,1,16,8,24,88,100,188,202,203,15,0,10,3.47872,0.292553,36.7713,84.1612,188,4
India,259,242.378,7.15058,0.339768,244.568,7.12741,0.30888,712,R Vinay Kumar,3,0,3,10,153,7,11,1,16,8,24,88,100,188,202,203,15,0,10,0.636364,0,7.72727,57.047,11,3
India,259,242.378,7.15058,0.339768,244.568,7.12741,0.30888,712,I Sharma,0,0,0,0,153,7,11,1,16,8,24,88,100,188,202,203,15,0,10,0.24,0,2.84,34.1346,25,3
Pakistan,211,222.621,7.38389,0.393365,235.517,7.54976,0.336493,714,Mohammad Hafeez,104,46,58,108,185,1,36,3,22,6,28,114,135,249,0,266,17,0,10,4.04511,0.255639,34.3534,78.0625,133,4
Pakistan,211,222.621,7.38389,0.393365,235.517,7.54976,0.336493,714,Kamran Akmal,4,4,0,1,185,1,36,3,22,6,28,114,135,249,0,266,17,0,10,3.01124,0.11236,23.0787,81.4433,89,4
Pakistan,211,222.621,7.38389,0.393365,235.517,7.54976,0.336493,714,Shoaib Malik,0,0,0,0,185,1,36,3,22,6,28,114,135,249,0,266,17,0,10,2.77551,0.193878,28.7041,81.4418,98,4
Ireland,55,219.527,7.65455,0.290909,202.727,7.56364,0.4,714,KJ O'Brien,69,46,23,40,205,3,35,2,14,6,20,136,124,260,267,275,15,1,10,2.64706,0.0588235,22.3824,79.4363,34,4
Ireland,55,219.527,7.65455,0.290909,202.727,7.56364,0.4,714,DT Johnston,2,0,2,5,205,3,35,2,14,6,20,136,124,260,267,275,15,1,10,1.27273,0,12.1818,74.2382,22,1
Ireland,55,219.527,7.65455,0.290909,202.727,7.56364,0.4,715,EC Joyce,89,36,53,119,152,4,13,4,22,16,38,86,117,203,0,229,26,1,10,3.08571,0.2,28.3429,68.6505,35,4
Ireland,55,219.527,7.65455,0.290909,202.727,7.56364,0.4,715,TJ Murtagh,0,0,0,0,152,4,13,4,22,16,38,86,117,203,0,229,26,1,10,1,0,8.2,93.1818,5,0
Ireland,55,219.527,7.65455,0.290909,202.727,7.56364,0.4,715,GH Dockrell,0,0,0,0,152,4,13,4,22,16,38,86,117,203,0,229,26,1,10,0.875,0,9.0625,69.7115,16,1
Pakistan,211,222.621,7.38389,0.393365,235.517,7.54976,0.336493,715,Wahab Riaz,20,18,2,24,127,7,47,0,34,7,41,140,75,215,230,230,15,0,10,1.29167,0.0416667,10.9792,79.1291,48,1
Pakistan,211,222.621,7.38389,0.393365,235.517,7.54976,0.336493,715,Kamran Akmal,69,44,25,81,127,7,47,0,34,7,41,140,75,215,230,230,15,0,10,3.01124,0.11236,23.0787,81.4433,89,4
Pakistan,211,222.621,7.38389,0.393365,235.517,7.54976,0.336493,715,Junaid Khan,0,0,0,0,127,7,47,0,34,7,41,140,75,215,230,230,15,0,10,0.210526,0,2.84211,47.7876,19,3
Bangladesh,160,218.438,7.70625,0.4,211.106,7.05,0.325,716,Nasir Hossain,36,16,20,41,157,4,42,3,26,20,46,112,133,245,0,259,14,0,10,2.75,0.159091,27.0455,79.3863,44,4
Bangladesh,160,218.438,7.70625,0.4,211.106,7.05,0.325,716,Abdur Razzak,0,0,0,0,157,4,42,3,26,20,46,112,133,245,0,259,14,0,10,0.849315,0.0136986,8.39726,73.8554,73,1
Sri Lanka,244,223.373,7.09016,0.344262,227.578,7.47541,0.385246,717,TM Dilshan,115,40,75,125,212,3,24,3,34,15,49,124,161,285,0,302,17,1,10,4.60199,0.273632,38.3632,86.0219,201,4
Sri Lanka,244,223.373,7.09016,0.344262,227.578,7.47541,0.385246,717,HDRL Thirimanne,2,0,2,5,212,3,24,3,34,15,49,124,161,285,0,302,17,1,10,2.77778,0.246914,31.5802,71.4725,81,4
Sri Lanka,244,223.373,7.09016,0.344262,227.578,7.47541,0.385246,717,KMDN Kulasekara,0,0,0,0,212,3,24,3,34,15,49,124,161,285,0,302,17,1,10,1.21,0.04,11.8,80.9328,100,1
Sri Lanka,244,223.373,7.09016,0.344262,227.578,7.47541,0.385246,717,SMSM Senanayake,0,0,0,0,212,3,24,3,34,15,49,124,161,285,0,302,17,1,10,1.0625,0,8.625,87.0662,32,1
Sri Lanka,244,223.373,7.09016,0.344262,227.578,7.47541,0.385246,717,SL Malinga,0,0,0,0,212,3,24,3,34,15,49,124,161,285,0,302,17,1,10,0.617284,0.0123457,4.97531,74.6296,81,1
Bangladesh,160,218.438,7.70625,0.4,211.106,7.05,0.325,718,Mahmudullah,20,8,12,28,163,5,35,1,8,27,35,98,135,233,0,269,36,0,10,2.26531,0.153061,24.4286,70.9544,98,4
Bangladesh,160,218.438,7.70625,0.4,211.106,7.05,0.325,718,Ziaur Rahman,10,8,2,7,163,5,35,1,8,27,35,98,135,233,0,269,36,0,10,1.2,0,8.3,91.2088,10,0
Bangladesh,160,218.438,7.70625,0.4,211.106,7.05,0.325,718,Abdur Razzak,0,0,0,0,163,5,35,1,8,27,35,98,135,233,0,269,36,0,10,0.849315,0.0136986,8.39726,73.8554,73,1
Bangladesh,160,218.438,7.70625,0.4,211.106,7.05,0.325,718,Shafiul Islam,0,0,0,0,163,5,35,1,8,27,35,98,135,233,0,269,36,0,10,0.535714,0,4.42857,57.6744,28,3
Bangladesh,160,218.438,7.70625,0.4,211.106,7.05,0.325,719,Mahmudullah,24,0,24,45,156,6,21,1,44,13,57,100,134,234,0,252,18,0,10,2.26531,0.153061,24.4286,70.9544,98,4
Bangladesh,160,218.438,7.70625,0.4,211.106,7.05,0.325,719,Abdur Razzak,7,6,1,4,156,6,21,1,44,13,57,100,134,234,0,252,18,0,10,0.849315,0.0136986,8.39726,73.8554,73,1
Bangladesh,160,218.438,7.70625,0.4,211.106,7.05,0.325,719,Shafiul Islam,0,0,0,0,156,6,21,1,44,13,57,100,134,234,0,252,18,0,10,0.535714,0,4.42857,57.6744,28,3
Zimbabwe,142,212.077,7.5,0.380282,227.704,6.97887,0.316901,719,SC Williams,65,22,43,67,187,4,35,0,8,11,19,110,131,241,253,253,12,1,10,2.56923,0.276923,28.5385,80.7927,65,4
Zimbabwe,142,212.077,7.5,0.380282,227.704,6.97887,0.316901,719,MN Waller,33,16,17,42,187,4,35,0,8,11,19,110,131,241,253,253,12,1,10,2.07895,0.0789474,19.3684,68.9784,38,1
Bangladesh,160,218.438,7.70625,0.4,211.106,7.05,0.325,720,Abdur Razzak,1,0,1,2,156,5,34,2,24,21,45,92,143,235,0,247,12,0,10,0.849315,0.0136986,8.39726,73.8554,73,1
Bangladesh,160,218.438,7.70625,0.4,211.106,7.05,0.325,720,Mahmudullah,34,8,26,51,156,5,34,2,24,21,45,92,143,235,0,247,12,0,10,2.26531,0.153061,24.4286,70.9544,98,4
Bangladesh,160,218.438,7.70625,0.4,211.106,7.05,0.325,720,Shafiul Islam,0,0,0,0,156,5,34,2,24,21,45,92,143,235,0,247,12,0,10,0.535714,0,4.42857,57.6744,28,3
Zimbabwe,142,212.077,7.5,0.380282,227.704,6.97887,0.316901,720,SC Williams,43,22,21,37,184,3,35,0,12,7,19,124,114,238,248,251,13,1,10,2.56923,0.276923,28.5385,80.7927,65,4
Zimbabwe,142,212.077,7.5,0.380282,227.704,6.97887,0.316901,720,V Sibanda,96,44,52,133,184,3,35,0,12,7,19,124,114,238,248,251,13,1,10,2.9697,0.181818,23.5152,63.5545,66,1
Sri Lanka,244,223.373,7.09016,0.344262,227.578,7.47541,0.385246,721,HDRL Thirimanne,14,0,14,28,200,3,42,0,40,16,56,170,128,298,0,320,22,1,10,2.77778,0.246914,31.5802,71.4725,81,4
Sri Lanka,244,223.373,7.09016,0.344262,227.578,7.47541,0.385246,721,KC Sangakkara,133,82,51,123,200,3,42,0,40,16,56,170,128,298,0,320,22,1,10,4.33659,0.360976,41.9854,80.6276,205,4
Sri Lanka,244,223.373,7.09016,0.344262,227.578,7.47541,0.385246,721,NLTC Perera,0,0,0,0,200,3,42,0,40,16,56,170,128,298,0,320,22,1,10,1.65333,0.0666667,14.32,105.397,75,0
Sri Lanka,244,223.373,7.09016,0.344262,227.578,7.47541,0.385246,721,LD Chandimal,0,0,0,0,200,3,42,0,40,16,56,170,128,298,0,320,22,1,10,2.18478,0.184783,25.7391,73.8615,92,4
Sri Lanka,244,223.373,7.09016,0.344262,227.578,7.47541,0.385246,722,HMRKB Herath,2,0,2,3,147,5,27,2,4,17,21,60,135,195,0,223,28,1,10,0.444444,0,5.18519,61.674,27,1
Sri Lanka,244,223.373,7.09016,0.344262,227.578,7.47541,0.385246,722,LD Chandimal,40,16,24,46,147,5,27,2,4,17,21,60,135,195,0,223,28,1,10,2.18478,0.184783,25.7391,73.8615,92,4
Sri Lanka,244,223.373,7.09016,0.344262,227.578,7.47541,0.385246,722,RMS Eranga,0,0,0,0,147,5,27,2,4,17,21,60,135,195,0,223,28,1,10,0.444444,0,3.77778,51.5152,9,3
Sri Lanka,244,223.373,7.09016,0.344262,227.578,7.47541,0.385246,722,SL Malinga,0,0,0,0,147,5,27,2,4,17,21,60,135,195,0,223,28,1,10,0.617284,0.0123457,4.97531,74.6296,81,1
South Africa,190,234.274,7.4,0.373684,232.363,7.33158,0.342105,723,DA Miller,40,8,32,55,147,6,18,1,38,15,53,90,128,218,0,223,5,0,10,2.57353,0.132353,24.9412,97.2477,68,0
South Africa,190,234.274,7.4,0.373684,232.363,7.33158,0.342105,723,R McLaren,6,0,6,7,147,6,18,1,38,15,53,90,128,218,0,223,5,0,10,1.2,0.025,11.975,69.8251,40,1
South Africa,190,234.274,7.4,0.373684,232.363,7.33158,0.342105,724,JP Duminy,67,16,51,103,178,6,25,3,24,7,31,94,140,234,0,238,4,0,10,2.3252,0.186992,29.9675,80.2351,123,4
South Africa,190,234.274,7.4,0.373684,232.363,7.33158,0.342105,724,LL Tsotsobe,2,0,2,3,178,6,25,3,24,7,31,94,140,234,0,238,4,0,10,0.444444,0,3.16667,50.8929,18,3
Sri Lanka,244,223.373,7.09016,0.344262,227.578,7.47541,0.385246,725,AD Mathews,21,10,11,20,208,3,34,0,28,21,49,156,135,291,0,307,16,1,10,2.64122,0.198473,28.6794,82.3362,131,4
Sri Lanka,244,223.373,7.09016,0.344262,227.578,7.47541,0.385246,725,NLTC Perera,0,0,0,0,208,3,34,0,28,21,49,156,135,291,0,307,16,1,10,1.65333,0.0666667,14.32,105.397,75,0
Sri Lanka,244,223.373,7.09016,0.344262,227.578,7.47541,0.385246,725,KC Sangakkara,45,28,17,31,208,3,34,0,28,21,49,156,135,291,0,307,16,1,10,4.33659,0.360976,41.9854,80.6276,205,4
England,221,237.176,7.17647,0.289593,230.633,7.45701,0.384615,726,GS Ballance,74,20,54,93,179,5,39,1,20,27,47,100,165,265,0,269,4,0,10,1.69231,0.153846,22,66.3573,13,1
England,221,237.176,7.17647,0.289593,230.633,7.45701,0.384615,726,JC Buttler,8,4,4,6,179,5,39,1,20,27,47,100,165,265,0,269,4,0,10,3.47458,0.186441,29.9153,115.359,59,0
England,221,237.176,7.17647,0.289593,230.633,7.45701,0.384615,726,TT Bresnan,0,0,0,0,179,5,39,1,20,27,47,100,165,265,0,269,4,0,10,1.52381,0.015873,13.8095,88.4146,63,0
Australia,228,239.627,7.69737,0.372807,232.079,7.23246,0.337719,726,GJ Maxwell,5,0,5,10,228,3,22,1,0,4,4,102,152,254,270,270,16,1,10,3.79245,0.226415,28.2264,119.68,53,0
Australia,228,239.627,7.69737,0.372807,232.079,7.23246,0.337719,726,GJ Bailey,16,4,12,17,228,3,22,1,0,4,4,102,152,254,270,270,16,1,10,3.34921,0.301587,36.3492,84.658,63,4
England,221,237.176,7.17647,0.289593,230.633,7.45701,0.384615,727,JC Buttler,28,4,24,24,185,5,52,0,30,16,46,112,171,283,0,300,17,0,10,3.47458,0.186441,29.9153,115.359,59,0
England,221,237.176,7.17647,0.289593,230.633,7.45701,0.384615,727,EJG Morgan,84,36,48,89,185,5,52,0,30,16,46,112,171,283,0,300,17,0,10,3.19549,0.233083,30.0526,86.9291,133,4
England,221,237.176,7.17647,0.289593,230.633,7.45701,0.384615,727,BA Stokes,0,0,0,0,185,5,52,0,30,16,46,112,171,283,0,300,17,0,10,2.23529,0.117647,20.1471,90.0131,34,0
England,221,237.176,7.17647,0.289593,230.633,7.45701,0.384615,727,TT Bresnan,0,0,0,0,185,5,52,0,30,16,46,112,171,283,0,300,17,0,10,1.52381,0.015873,13.8095,88.4146,63,0
England,221,237.176,7.17647,0.289593,230.633,7.45701,0.384615,727,CJ Jordan,0,0,0,0,185,5,52,0,30,16,46,112,171,283,0,300,17,0,10,0.833333,0,8.22222,84.0909,18,1
Australia,228,239.627,7.69737,0.372807,232.079,7.23246,0.337719,727,JP Faulkner,27,12,15,28,217,7,21,2,30,14,44,132,150,282,301,301,19,1,10,2.88235,0.147059,24.1471,109.613,34,0
Australia,228,239.627,7.69737,0.372807,232.079,7.23246,0.337719,727,CJ McKay,0,0,0,3,217,7,21,2,30,14,44,132,150,282,301,301,19,1,10,0.615385,0,6.88462,55.0769,26,3
England,221,237.176,7.17647,0.289593,230.633,7.45701,0.384615,728,CJ Jordan,1,0,1,1,174,5,25,3,20,19,39,106,132,238,0,243,5,0,10,0.833333,0,8.22222,84.0909,18,1
England,221,237.176,7.17647,0.289593,230.633,7.45701,0.384615,728,TT Bresnan,13,8,5,12,174,5,25,3,20,19,39,106,132,238,0,243,5,0,10,1.52381,0.015873,13.8095,88.4146,63,0
England,221,237.176,7.17647,0.289593,230.633,7.45701,0.384615,728,JC Tredwell,0,0,0,0,174,5,25,3,20,19,39,106,132,238,0,243,5,0,10,0.52,0,6.52,65.9919,25,1
England,221,237.176,7.17647,0.289593,230.633,7.45701,0.384615,729,JC Buttler,28,12,16,26,211,5,31,0,46,12,58,172,128,300,0,316,16,0,10,3.47458,0.186441,29.9153,115.359,59,0
England,221,237.176,7.17647,0.289593,230.633,7.45701,0.384615,729,EJG Morgan,24,12,12,29,211,5,31,0,46,12,58,172,128,300,0,316,16,0,10,3.19549,0.233083,30.0526,86.9291,133,4
England,221,237.176,7.17647,0.289593,230.633,7.45701,0.384615,729,TT Bresnan,0,0,0,0,211,5,31,0,46,12,58,172,128,300,0,316,16,0,10,1.52381,0.015873,13.8095,88.4146,63,0
England,221,237.176,7.17647,0.289593,230.633,7.45701,0.384615,729,SCJ Broad,0,0,0,0,211,5,31,0,46,12,58,172,128,300,0,316,16,0,10,0.725806,0,8.04839,74.0356,62,1
Australia,228,239.627,7.69737,0.372807,232.079,7.23246,0.337719,729,JL Pattinson,0,0,0,0,213,6,22,3,0,10,10,108,137,245,317,259,14,1,10,0.285714,0,5.85714,51.25,7,3
Australia,228,239.627,7.69737,0.372807,232.079,7.23246,0.337719,729,NM Coulter-Nile,2,0,2,5,213,6,22,3,0,10,10,108,137,245,317,259,14,1,10,0.571429,0,8.57143,69.7674,7,1
West Indies,176,217.33,7.15909,0.3125,225.278,7.57386,0.380682,730,DJG Sammy,15,10,5,23,144,5,28,0,60,22,82,128,126,254,0,269,15,1,10,2.25,0.09,18.25,95.8005,100,0
West Indies,176,217.33,7.15909,0.3125,225.278,7.57386,0.380682,730,DJ Bravo,51,12,39,79,144,5,28,0,60,22,82,128,126,254,0,269,15,1,10,2.35514,0.11215,23.1589,80.9011,107,4
England,221,237.176,7.17647,0.289593,230.633,7.45701,0.384615,730,TT Bresnan,4,0,4,5,187,4,26,2,4,25,29,68,174,242,270,254,12,0,10,1.52381,0.015873,13.8095,88.4146,63,0
England,221,237.176,7.17647,0.289593,230.633,7.45701,0.384615,730,RS Bopara,4,0,4,9,187,4,26,2,4,25,29,68,174,242,270,254,12,0,10,2.22115,0.144231,25.1538,75.9361,104,4
England,221,237.176,7.17647,0.289593,230.633,7.45701,0.384615,732,JC Buttler,67,30,37,69,200,4,43,0,26,19,45,116,172,288,0,303,15,0,10,3.47458,0.186441,29.9153,115.359,59,0
England,221,237.176,7.17647,0.289593,230.633,7.45701,0.384615,732,JE Root,100,28,72,115,200,4,43,0,26,19,45,116,172,288,0,303,15,0,10,3.68852,0.327869,41.6721,83.3443,61,4
England,221,237.176,7.17647,0.289593,230.633,7.45701,0.384615,732,RS Bopara,0,0,0,0,200,4,43,0,26,19,45,116,172,288,0,303,15,0,10,2.22115,0.144231,25.1538,75.9361,104,4
England,221,237.176,7.17647,0.289593,230.633,7.45701,0.384615,732,TT Bresnan,0,0,0,0,200,4,43,0,26,19,45,116,172,288,0,303,15,0,10,1.52381,0.015873,13.8095,88.4146,63,0
West Indies,176,217.33,7.15909,0.3125,225.278,7.57386,0.380682,732,NO Miller,10,4,6,16,188,7,44,0,24,8,32,158,106,264,304,278,14,1,10,1,0.0416667,10.3333,79.2332,24,1
West Indies,176,217.33,7.15909,0.3125,225.278,7.57386,0.380682,732,D Ramdin,106,60,46,101,188,7,44,0,24,8,32,158,106,264,304,278,14,1,10,1.7439,0.097561,19.1951,81.1759,82,1
West Indies,176,217.33,7.15909,0.3125,225.278,7.57386,0.380682,732,SP Narine,0,0,0,0,188,7,44,0,24,8,32,158,106,264,304,278,14,1,10,1.05882,0,8.55882,76.378,34,1
Zimbabwe,142,212.077,7.5,0.380282,227.704,6.97887,0.316901,733,E Chigumbura,22,16,6,19,155,4,25,2,20,15,35,104,111,215,0,228,13,1,10,2.28947,0.114035,22.7895,77.7844,114,4
Zimbabwe,142,212.077,7.5,0.380282,227.704,6.97887,0.316901,733,TC Mutombodzi,2,0,2,4,155,4,25,2,20,15,35,104,111,215,0,228,13,1,10,1,0,8.33333,96.1538,3,0
Zimbabwe,142,212.077,7.5,0.380282,227.704,6.97887,0.316901,733,P Utseya,0,0,0,0,155,4,25,2,20,15,35,104,111,215,0,228,13,1,10,0.842105,0.0263158,11.8289,55.8385,76,3
India,259,242.378,7.15058,0.339768,244.568,7.12741,0.30888,734,RA Jadeja,4,0,4,9,185,4,35,2,30,16,46,126,140,266,0,294,28,0,10,2.12941,0.117647,21.7529,82.4342,85,4
India,259,242.378,7.15058,0.339768,244.568,7.12741,0.30888,734,A Mishra,7,4,3,5,185,4,35,2,30,16,46,126,140,266,0,294,28,0,10,0.375,0,3.5,42.4242,8,3
India,259,242.378,7.15058,0.339768,244.568,7.12741,0.30888,734,R Vinay Kumar,0,0,0,0,185,4,35,2,30,16,46,126,140,266,0,294,28,0,10,0.636364,0,7.72727,57.047,11,3
India,259,242.378,7.15058,0.339768,244.568,7.12741,0.30888,734,Mohammed Shami,0,0,0,0,185,4,35,2,30,16,46,126,140,266,0,294,28,0,10,0.684211,0,5.68421,88.5246,19,0
Zimbabwe,142,212.077,7.5,0.380282,227.704,6.97887,0.316901,734,E Chigumbura,36,18,18,50,161,6,13,0,20,22,42,100,116,216,295,236,20,1,10,2.28947,0.114035,22.7895,77.7844,114,4
Zimbabwe,142,212.077,7.5,0.380282,227.704,6.97887,0.316901,734,P Utseya,22,4,18,48,161,6,13,0,20,22,42,100,116,216,295,236,20,1,10,0.842105,0.0263158,11.8289,55.8385,76,3
Zimbabwe,142,212.077,7.5,0.380282,227.704,6.97887,0.316901,734,KM Jarvis,0,0,0,0,161,6,13,0,20,22,42,100,116,216,295,236,20,1,10,0.333333,0,3.75,36.2903,12,3
Zimbabwe,142,212.077,7.5,0.380282,227.704,6.97887,0.316901,734,BV Vitori,0,0,0,0,161,6,13,0,20,22,42,100,116,216,295,236,20,1,10,0.9,0,6.3,86.3014,10,1
Zimbabwe,142,212.077,7.5,0.380282,227.704,6.97887,0.316901,734,TL Chatara,0,0,0,0,161,6,13,0,20,22,42,100,116,216,295,236,20,1,10,0.705882,0,5.82353,57.2254,17,3
Zimbabwe,142,212.077,7.5,0.380282,227.704,6.97887,0.316901,735,TL Chatara,23,18,5,36,144,8,22,1,0,0,0,86,80,166,0,183,17,1,10,0.705882,0,5.82353,57.2254,17,3
Pakistan,211,222.621,7.38389,0.393365,235.517,7.54976,0.336493,738,Misbah-ul-Haq,44,4,40,121,144,6,14,1,14,24,38,86,110,196,0,224,28,0,10,2.95238,0.285714,34.9921,71.8195,126,4
Pakistan,211,222.621,7.38389,0.393365,235.517,7.54976,0.336493,738,Saeed Ajmal,0,0,0,3,144,6,14,1,14,24,38,86,110,196,0,224,28,0,10,0.34375,0,4.60938,58.3004,64,3
Pakistan,211,222.621,7.38389,0.393365,235.517,7.54976,0.336493,738,Asad Ali,0,0,0,0,144,6,14,1,14,24,38,86,110,196,0,224,28,0,10,0.5,0,5,62.5,2,1
Pakistan,211,222.621,7.38389,0.393365,235.517,7.54976,0.336493,738,Mohammad Irfan,0,0,0,0,144,6,14,1,14,24,38,86,110,196,0,224,28,0,10,0.233333,0,1.56667,30.9211,30,3
Pakistan,211,222.621,7.38389,0.393365,235.517,7.54976,0.336493,739,Umar Akmal,10,4,6,14,138,3,25,2,32,17,49,84,128,212,0,229,17,0,10,2.76842,0.2,27.5053,82.7947,95,4
Pakistan,211,222.621,7.38389,0.393365,235.517,7.54976,0.336493,739,Shahid Afridi,1,0,1,2,138,3,25,2,32,17,49,84,128,212,0,229,17,0,10,2.72917,0.0972222,21.4097,127.766,144,0
Pakistan,211,222.621,7.38389,0.393365,235.517,7.54976,0.336493,739,Wahab Riaz,0,0,0,0,138,3,25,2,32,17,49,84,128,212,0,229,17,0,10,1.29167,0.0416667,10.9792,79.1291,48,1
West Indies,176,217.33,7.15909,0.3125,225.278,7.57386,0.380682,739,LMP Simmons,75,40,35,88,134,4,31,0,34,15,49,110,104,214,230,229,15,1,10,3.3125,0.28125,30.5938,71.4338,64,4
West Indies,176,217.33,7.15909,0.3125,225.278,7.57386,0.380682,739,DJ Bravo,13,4,9,22,134,4,31,0,34,15,49,110,104,214,230,229,15,1,10,2.35514,0.11215,23.1589,80.9011,107,4
West Indies,176,217.33,7.15909,0.3125,225.278,7.57386,0.380682,739,DJG Sammy,0,0,0,0,134,4,31,0,34,15,49,110,104,214,230,229,15,1,10,2.25,0.09,18.25,95.8005,100,0
West Indies,176,217.33,7.15909,0.3125,225.278,7.57386,0.380682,739,KA Pollard,0,0,0,0,134,4,31,0,34,15,49,110,104,214,230,229,15,1,10,2.70513,0.115385,24.5,88.0645,78,4
West Indies,176,217.33,7.15909,0.3125,225.278,7.57386,0.380682,739,KAJ Roach,0,0,0,0,134,4,31,0,34,15,49,110,104,214,230,229,15,1,10,0.526316,0,5.68421,50.5855,38,3
West Indies,176,217.33,7.15909,0.3125,225.278,7.57386,0.380682,739,SP Narine,0,0,0,0,134,4,31,0,34,15,49,110,104,214,230,229,15,1,10,1.05882,0,8.55882,76.378,34,1
West Indies,176,217.33,7.15909,0.3125,225.278,7.57386,0.380682,739,JO Holder,0,0,0,0,134,4,31,0,34,15,49,110,104,214,230,229,15,1,10,2.13636,0.0909091,16.9091,97.8947,22,0
West Indies,176,217.33,7.15909,0.3125,225.278,7.57386,0.380682,740,MN Samuels,79,42,37,91,165,4,46,1,22,11,33,142,102,244,0,261,17,1,10,3.74757,0.23301,31.6214,74.5821,103,4
West Indies,176,217.33,7.15909,0.3125,225.278,7.57386,0.380682,740,DJG Sammy,7,6,1,5,165,4,46,1,22,11,33,142,102,244,0,261,17,1,10,2.25,0.09,18.25,95.8005,100,0
West Indies,176,217.33,7.15909,0.3125,225.278,7.57386,0.380682,740,DJ Bravo,0,0,0,0,165,4,46,1,22,11,33,142,102,244,0,261,17,1,10,2.35514,0.11215,23.1589,80.9011,107,4
West Indies,176,217.33,7.15909,0.3125,225.278,7.57386,0.380682,741,DJ Bravo,13,8,5,14,139,4,24,2,44,20,64,122,105,227,0,242,15,1,10,2.35514,0.11215,23.1589,80.9011,107,4
West Indies,176,217.33,7.15909,0.3125,225.278,7.57386,0.380682,741,DJG Sammy,0,0,0,2,139,4,24,2,44,20,64,122,105,227,0,242,15,1,10,2.25,0.09,18.25,95.8005,100,0
Pakistan,211,222.621,7.38389,0.393365,235.517,7.54976,0.336493,741,Umar Akmal,19,12,7,18,156,4,32,0,24,17,41,120,109,229,243,243,14,0,10,2.76842,0.2,27.5053,82.7947,95,4
Pakistan,211,222.621,7.38389,0.393365,235.517,7.54976,0.336493,741,Misbah-ul-Haq,54,26,28,90,156,4,32,0,24,17,41,120,109,229,243,243,14,0,10,2.95238,0.285714,34.9921,71.8195,126,4
Pakistan,211,222.621,7.38389,0.393365,235.517,7.54976,0.336493,741,Shahid Afridi,0,0,0,0,156,4,32,0,24,17,41,120,109,229,243,243,14,0,10,2.72917,0.0972222,21.4097,127.766,144,0
Pakistan,211,222.621,7.38389,0.393365,235.517,7.54976,0.336493,741,Saeed Ajmal,0,0,0,0,156,4,32,0,24,17,41,120,109,229,243,243,14,0,10,0.34375,0,4.60938,58.3004,64,3
Australia,228,239.627,7.69737,0.372807,232.079,7.23246,0.337719,742,GJ Bailey,75,32,43,77,221,5,27,1,38,15,53,170,131,301,0,304,3,0,10,3.34921,0.301587,36.3492,84.658,63,4
Australia,228,239.627,7.69737,0.372807,232.079,7.23246,0.337719,742,JP Faulkner,4,0,4,7,221,5,27,1,38,15,53,170,131,301,0,304,3,0,10,2.88235,0.147059,24.1471,109.613,34,0
Australia,228,239.627,7.69737,0.372807,232.079,7.23246,0.337719,742,MG Johnson,0,0,0,0,221,5,27,1,38,15,53,170,131,301,0,304,3,0,10,1.18519,0.0246914,10.7901,94.181,81,0
Australia,228,239.627,7.69737,0.372807,232.079,7.23246,0.337719,742,CJ McKay,0,0,0,0,221,5,27,1,38,15,53,170,131,301,0,304,3,0,10,0.615385,0,6.88462,55.0769,26,3
India,259,242.378,7.15058,0.339768,244.568,7.12741,0.30888,742,B Kumar,8,4,4,14,186,6,16,2,4,15,19,92,129,221,305,232,11,1,10,0.75,0,7.39286,72.1254,28,1
India,259,242.378,7.15058,0.339768,244.568,7.12741,0.30888,742,R Vinay Kumar,3,0,3,8,186,6,16,2,4,15,19,92,129,221,305,232,11,1,10,0.636364,0,7.72727,57.047,11,3
India,259,242.378,7.15058,0.339768,244.568,7.12741,0.30888,742,I Sharma,0,0,0,0,186,6,16,2,4,15,19,92,129,221,305,232,11,1,10,0.24,0,2.84,34.1346,25,3
Australia,228,239.627,7.69737,0.372807,232.079,7.23246,0.337719,743,GJ Maxwell,49,34,15,31,234,3,59,0,34,22,56,216,133,349,0,359,10,0,10,3.79245,0.226415,28.2264,119.68,53,0
Australia,228,239.627,7.69737,0.372807,232.079,7.23246,0.337719,743,GJ Bailey,52,34,18,32,234,3,59,0,34,22,56,216,133,349,0,359,10,0,10,3.34921,0.301587,36.3492,84.658,63,4
Australia,228,239.627,7.69737,0.372807,232.079,7.23246,0.337719,743,AC Voges,0,0,0,0,234,3,59,0,34,22,56,216,133,349,0,359,10,0,10,2.29167,0.125,29.625,84.142,24,4
Australia,228,239.627,7.69737,0.372807,232.079,7.23246,0.337719,743,BJ Haddin,0,0,0,0,234,3,59,0,34,22,56,216,133,349,0,359,10,0,10,3.14737,0.147368,26.7789,81.382,95,4
India,259,242.378,7.15058,0.339768,244.568,7.12741,0.30888,744,MS Dhoni,91,40,51,100,186,6,43,1,42,12,54,154,129,283,0,303,20,1,10,3.47872,0.292553,36.7713,84.1612,188,4
India,259,242.378,7.15058,0.339768,244.568,7.12741,0.30888,744,B Kumar,4,0,4,10,186,6,43,1,42,12,54,154,129,283,0,303,20,1,10,0.75,0,7.39286,72.1254,28,1
India,259,242.378,7.15058,0.339768,244.568,7.12741,0.30888,744,R Vinay Kumar,0,0,0,0,186,6,43,1,42,12,54,154,129,283,0,303,20,1,10,0.636364,0,7.72727,57.047,11,3
Australia,228,239.627,7.69737,0.372807,232.079,7.23246,0.337719,744,JP Faulkner,14,6,8,13,190,5,27,1,46,18,64,152,129,281,304,304,23,0,10,2.88235,0.147059,24.1471,109.613,34,0
Australia,228,239.627,7.69737,0.372807,232.079,7.23246,0.337719,744,AC Voges,62,20,42,79,190,5,27,1,46,18,64,152,129,281,304,304,23,0,10,2.29167,0.125,29.625,84.142,24,4
Australia,228,239.627,7.69737,0.372807,232.079,7.23246,0.337719,745,GJ Bailey,125,68,57,98,247,4,45,0,28,24,52,210,134,344,0,350,6,0,10,3.34921,0.301587,36.3492,84.658,63,4
Australia,228,239.627,7.69737,0.372807,232.079,7.23246,0.337719,745,AC Voges,23,12,11,24,247,4,45,0,28,24,52,210,134,344,0,350,6,0,10,2.29167,0.125,29.625,84.142,24,4
Australia,228,239.627,7.69737,0.372807,232.079,7.23246,0.337719,745,MG Johnson,0,0,0,0,247,4,45,0,28,24,52,210,134,344,0,350,6,0,10,1.18519,0.0246914,10.7901,94.181,81,0
India,259,242.378,7.15058,0.339768,244.568,7.12741,0.30888,745,MS Dhoni,7,0,7,10,251,2,36,2,32,16,48,184,151,335,351,351,16,1,10,3.47872,0.292553,36.7713,84.1612,188,4
India,259,242.378,7.15058,0.339768,244.568,7.12741,0.30888,745,V Kohli,85,54,31,52,251,2,36,2,32,16,48,184,151,335,351,351,16,1,10,4.66456,0.379747,44.9937,88.3325,158,4
India,259,242.378,7.15058,0.339768,244.568,7.12741,0.30888,746,MS Dhoni,29,12,17,28,220,4,51,0,90,10,100,234,137,371,0,383,12,1,10,3.47872,0.292553,36.7713,84.1612,188,4
India,259,242.378,7.15058,0.339768,244.568,7.12741,0.30888,746,RG Sharma,142,82,60,140,220,4,51,0,90,10,100,234,137,371,0,383,12,1,10,3.82836,0.268657,35.9179,83.083,134,4
Australia,228,239.627,7.69737,0.372807,232.079,7.23246,0.337719,746,JP Faulkner,116,80,36,74,299,8,23,1,0,0,0,230,92,322,384,326,4,0,10,2.88235,0.147059,24.1471,109.613,34,0
South Africa,190,234.274,7.4,0.373684,232.363,7.33158,0.342105,747,AB de Villiers,37,16,21,33,216,2,51,1,64,20,84,214,137,351,0,358,7,1,10,5.04969,0.403727,47.2174,98.8428,161,4
South Africa,190,234.274,7.4,0.373684,232.363,7.33158,0.342105,747,JP Duminy,20,10,10,15,216,2,51,1,64,20,84,214,137,351,0,358,7,1,10,2.3252,0.186992,29.9675,80.2351,123,4
South Africa,190,234.274,7.4,0.373684,232.363,7.33158,0.342105,747,DA Miller,0,0,0,0,216,2,51,1,64,20,84,214,137,351,0,358,7,1,10,2.57353,0.132353,24.9412,97.2477,68,0
South Africa,190,234.274,7.4,0.373684,232.363,7.33158,0.342105,748,WD Parnell,46,26,20,55,136,8,27,0,4,11,15,82,96,178,0,183,5,0,10,1.47826,0.0434783,15.8261,74.7433,23,1
South Africa,190,234.274,7.4,0.373684,232.363,7.33158,0.342105,748,LL Tsotsobe,12,10,2,32,136,8,27,0,4,11,15,82,96,178,0,183,5,0,10,0.444444,0,3.16667,50.8929,18,3
South Africa,190,234.274,7.4,0.373684,232.363,7.33158,0.342105,748,Imran Tahir,0,0,0,0,136,8,27,0,4,11,15,82,96,178,0,183,5,0,10,0.625,0,5.0625,65.8537,16,1
Pakistan,211,222.621,7.38389,0.393365,235.517,7.54976,0.336493,748,Mohammad Irfan,0,0,0,1,150,4,16,5,0,3,3,66,103,169,184,182,13,0,10,0.233333,0,1.56667,30.9211,30,3
Pakistan,211,222.621,7.38389,0.393365,235.517,7.54976,0.336493,748,Saeed Ajmal,0,0,0,6,150,4,16,5,0,3,3,66,103,169,184,182,13,0,10,0.34375,0,4.60938,58.3004,64,3
Pakistan,211,222.621,7.38389,0.393365,235.517,7.54976,0.336493,749,Wahab Riaz,1,0,1,6,149,6,21,1,20,5,25,86,109,195,0,209,14,0,10,1.29167,0.0416667,10.9792,79.1291,48,1
Pakistan,211,222.621,7.38389,0.393365,235.517,7.54976,0.336493,749,Shahid Afridi,18,8,10,16,149,6,21,1,20,5,25,86,109,195,0,209,14,0,10,2.72917,0.0972222,21.4097,127.766,144,0
Pakistan,211,222.621,7.38389,0.393365,235.517,7.54976,0.336493,749,Saeed Ajmal,0,0,0,0,149,6,21,1,20,5,25,86,109,195,0,209,14,0,10,0.34375,0,4.60938,58.3004,64,3
Pakistan,211,222.621,7.38389,0.393365,235.517,7.54976,0.336493,749,Mohammad Irfan,0,0,0,0,149,6,21,1,20,5,25,86,109,195,0,209,14,0,10,0.233333,0,1.56667,30.9211,30,3
South Africa,190,234.274,7.4,0.373684,232.363,7.33158,0.342105,750,DA Miller,23,12,11,24,190,4,29,0,14,19,33,102,150,252,0,259,7,0,10,2.57353,0.132353,24.9412,97.2477,68,0
South Africa,190,234.274,7.4,0.373684,232.363,7.33158,0.342105,750,JP Duminy,57,12,45,80,190,4,29,0,14,19,33,102,150,252,0,259,7,0,10,2.3252,0.186992,29.9675,80.2351,123,4
South Africa,190,234.274,7.4,0.373684,232.363,7.33158,0.342105,750,R McLaren,0,0,0,0,190,4,29,0,14,19,33,102,150,252,0,259,7,0,10,1.2,0.025,11.975,69.8251,40,1
South Africa,190,234.274,7.4,0.373684,232.363,7.33158,0.342105,750,DW Steyn,0,0,0,0,190,4,29,0,14,19,33,102,150,252,0,259,7,0,10,0.75,0,6.52273,61.588,44,1
South Africa,190,234.274,7.4,0.373684,232.363,7.33158,0.342105,750,LL Tsotsobe,0,0,0,0,190,4,29,0,14,19,33,102,150,252,0,259,7,0,10,0.444444,0,3.16667,50.8929,18,3
South Africa,190,234.274,7.4,0.373684,232.363,7.33158,0.342105,751,JP Duminy,3,0,3,6,191,2,21,3,24,20,44,106,150,256,0,266,10,0,10,2.3252,0.186992,29.9675,80.2351,123,4
South Africa,190,234.274,7.4,0.373684,232.363,7.33158,0.342105,751,R McLaren,6,4,2,6,191,2,21,3,24,20,44,106,150,256,0,266,10,0,10,1.2,0.025,11.975,69.8251,40,1
Pakistan,211,222.621,7.38389,0.393365,235.517,7.54976,0.336493,751,Misbah-ul-Haq,63,22,41,75,187,5,31,0,0,12,12,108,122,230,267,238,8,0,10,2.95238,0.285714,34.9921,71.8195,126,4
Pakistan,211,222.621,7.38389,0.393365,235.517,7.54976,0.336493,751,Umar Akmal,21,8,13,17,187,5,31,0,0,12,12,108,122,230,267,238,8,0,10,2.76842,0.2,27.5053,82.7947,95,4
Pakistan,211,222.621,7.38389,0.393365,235.517,7.54976,0.336493,751,Shahid Afridi,0,0,0,0,187,5,31,0,0,12,12,108,122,230,267,238,8,0,10,2.72917,0.0972222,21.4097,127.766,144,0
Pakistan,211,222.621,7.38389,0.393365,235.517,7.54976,0.336493,751,Saeed Ajmal,0,0,0,0,187,5,31,0,0,12,12,108,122,230,267,238,8,0,10,0.34375,0,4.60938,58.3004,64,3
Pakistan,211,222.621,7.38389,0.393365,235.517,7.54976,0.336493,751,Mohammad Irfan,0,0,0,0,187,5,31,0,0,12,12,108,122,230,267,238,8,0,10,0.233333,0,1.56667,30.9211,30,3
Pakistan,211,222.621,7.38389,0.393365,235.517,7.54976,0.336493,751,Junaid Khan,0,0,0,0,187,5,31,0,0,12,12,108,122,230,267,238,8,0,10,0.210526,0,2.84211,47.7876,19,3
South Africa,190,234.274,7.4,0.373684,232.363,7.33158,0.342105,752,AB de Villiers,75,24,51,88,146,5,41,0,50,15,65,114,138,252,0,268,16,0,10,5.04969,0.403727,47.2174,98.8428,161,4
South Africa,190,234.274,7.4,0.373684,232.363,7.33158,0.342105,752,R McLaren,12,8,4,15,146,5,41,0,50,15,65,114,138,252,0,268,16,0,10,1.2,0.025,11.975,69.8251,40,1
South Africa,190,234.274,7.4,0.373684,232.363,7.33158,0.342105,752,RJ Peterson,0,0,0,0,146,5,41,0,50,15,65,114,138,252,0,268,16,0,10,1.62069,0.0344828,15.7931,83.5766,29,1
South Africa,190,234.274,7.4,0.373684,232.363,7.33158,0.342105,752,WD Parnell,0,0,0,0,146,5,41,0,50,15,65,114,138,252,0,268,16,0,10,1.47826,0.0434783,15.8261,74.7433,23,1
New Zealand,184,233.745,7.39674,0.36413,227.951,7.30435,0.353261,753,CJ Anderson,35,18,17,31,218,4,40,1,34,26,60,160,158,318,0,331,13,1,10,3.90909,0.151515,30.2424,112.514,33,0
New Zealand,184,233.745,7.39674,0.36413,227.951,7.30435,0.353261,753,L Ronchi,9,8,1,5,218,4,40,1,34,26,60,160,158,318,0,331,13,1,10,2.92157,0.0784314,22.1961,115.392,51,0
Sri Lanka,244,223.373,7.09016,0.344262,227.578,7.47541,0.385246,753,HMRKB Herath,12,8,4,19,202,7,16,2,0,4,4,96,126,222,332,233,11,0,10,0.444444,0,5.18519,61.674,27,1
Australia,228,239.627,7.69737,0.372807,232.079,7.23246,0.337719,754,MR Marsh,23,12,11,19,233,5,43,0,44,17,61,170,167,337,0,342,5,1,10,3.61538,0.269231,32.2308,95.3356,26,0
Australia,228,239.627,7.69737,0.372807,232.079,7.23246,0.337719,754,GJ Maxwell,36,20,16,26,233,5,43,0,44,17,61,170,167,337,0,342,5,1,10,3.79245,0.226415,28.2264,119.68,53,0
Australia,228,239.627,7.69737,0.372807,232.079,7.23246,0.337719,754,BJ Haddin,0,0,0,0,233,5,43,0,44,17,61,170,167,337,0,342,5,1,10,3.14737,0.147368,26.7789,81.382,95,4
Australia,228,239.627,7.69737,0.372807,232.079,7.23246,0.337719,754,MG Johnson,0,0,0,0,233,5,43,0,44,17,61,170,167,337,0,342,5,1,10,1.18519,0.0246914,10.7901,94.181,81,0
South Africa,190,234.274,7.4,0.373684,232.363,7.33158,0.342105,755,DA Miller,86,36,50,79,181,4,48,0,76,15,91,160,160,320,0,339,19,0,10,2.57353,0.132353,24.9412,97.2477,68,0
South Africa,190,234.274,7.4,0.373684,232.363,7.33158,0.342105,755,JP Duminy,76,24,52,87,181,4,48,0,76,15,91,160,160,320,0,339,19,0,10,2.3252,0.186992,29.9675,80.2351,123,4
Zimbabwe,142,212.077,7.5,0.380282,227.704,6.97887,0.316901,755,TL Chatara,0,0,0,0,215,5,26,3,10,4,14,154,101,255,340,277,22,0,10,0.705882,0,5.82353,57.2254,17,3
Zimbabwe,142,212.077,7.5,0.380282,227.704,6.97887,0.316901,755,SF Mire,19,14,5,16,215,5,26,3,10,4,14,154,101,255,340,277,22,0,10,2.11111,0.222222,21,65.625,9,1
India,259,242.378,7.15058,0.339768,244.568,7.12741,0.30888,756,V Kohli,107,32,75,125,212,2,55,0,10,17,27,122,172,294,0,300,6,0,10,4.66456,0.379747,44.9937,88.3325,158,4
India,259,242.378,7.15058,0.339768,244.568,7.12741,0.30888,756,MS Dhoni,0,0,0,0,212,2,55,0,10,17,27,122,172,294,0,300,6,0,10,3.47872,0.292553,36.7713,84.1612,188,4
India,259,242.378,7.15058,0.339768,244.568,7.12741,0.30888,756,SK Raina,72,38,34,52,212,2,55,0,10,17,27,122,172,294,0,300,6,0,10,3.11111,0.216374,28.9064,91.8944,171,0
India,259,242.378,7.15058,0.339768,244.568,7.12741,0.30888,756,RA Jadeja,0,0,0,0,212,2,55,0,10,17,27,122,172,294,0,300,6,0,10,2.12941,0.117647,21.7529,82.4342,85,4
India,259,242.378,7.15058,0.339768,244.568,7.12741,0.30888,756,AM Rahane,0,0,0,0,212,2,55,0,10,17,27,122,172,294,0,300,6,0,10,3.55738,0.262295,32.2295,78.0159,61,4
India,259,242.378,7.15058,0.339768,244.568,7.12741,0.30888,756,Mohammed Shami,0,0,0,0,212,2,55,0,10,17,27,122,172,294,0,300,6,0,10,0.684211,0,5.68421,88.5246,19,0
India,259,242.378,7.15058,0.339768,244.568,7.12741,0.30888,756,R Ashwin,0,0,0,0,212,2,55,0,10,17,27,122,172,294,0,300,6,0,10,1.16364,0.0181818,11.9455,84.7742,55,1
Pakistan,211,222.621,7.38389,0.393365,235.517,7.54976,0.336493,756,Misbah-ul-Haq,76,42,34,82,184,7,24,1,0,4,4,100,112,212,301,224,12,0,10,2.95238,0.285714,34.9921,71.8195,126,4
Pakistan,211,222.621,7.38389,0.393365,235.517,7.54976,0.336493,756,Mohammad Irfan,0,0,0,0,184,7,24,1,0,4,4,100,112,212,301,224,12,0,10,0.233333,0,1.56667,30.9211,30,3
Pakistan,211,222.621,7.38389,0.393365,235.517,7.54976,0.336493,756,Sohail Khan,4,4,0,8,184,7,24,1,0,4,4,100,112,212,301,224,12,0,10,0.333333,0,4.16667,48.0769,6,3
West Indies,176,217.33,7.15909,0.3125,225.278,7.57386,0.380682,761,LMP Simmons,44,28,16,41,185,5,34,0,50,18,68,154,133,287,0,310,23,0,10,3.3125,0.28125,30.5938,71.4338,64,4
West Indies,176,217.33,7.15909,0.3125,225.278,7.57386,0.380682,761,DJG Sammy,10,4,6,16,185,5,34,0,50,18,68,154,133,287,0,310,23,0,10,2.25,0.09,18.25,95.8005,100,0
West Indies,176,217.33,7.15909,0.3125,225.278,7.57386,0.380682,761,AD Russell,0,0,0,0,185,5,34,0,50,18,68,154,133,287,0,310,23,0,10,3.38095,0.0952381,23.2857,129.536,42,0
India,259,242.378,7.15058,0.339768,244.568,7.12741,0.30888,763,MS Dhoni,0,0,0,0,221,2,41,2,22,13,35,154,143,297,0,307,10,0,10,3.47872,0.292553,36.7713,84.1612,188,4
India,259,242.378,7.15058,0.339768,244.568,7.12741,0.30888,763,AM Rahane,73,40,33,57,221,2,41,2,22,13,35,154,143,297,0,307,10,0,10,3.55738,0.262295,32.2295,78.0159,61,4
India,259,242.378,7.15058,0.339768,244.568,7.12741,0.30888,763,RA Jadeja,0,0,0,0,221,2,41,2,22,13,35,154,143,297,0,307,10,0,10,2.12941,0.117647,21.7529,82.4342,85,4
India,259,242.378,7.15058,0.339768,244.568,7.12741,0.30888,763,R Ashwin,0,0,0,0,221,2,41,2,22,13,35,154,143,297,0,307,10,0,10,1.16364,0.0181818,11.9455,84.7742,55,1
India,259,242.378,7.15058,0.339768,244.568,7.12741,0.30888,763,Mohammed Shami,0,0,0,0,221,2,41,2,22,13,35,154,143,297,0,307,10,0,10,0.684211,0,5.68421,88.5246,19,0
West Indies,176,217.33,7.15909,0.3125,225.278,7.57386,0.380682,765,MN Samuels,91,32,59,144,206,1,75,0,44,23,67,198,150,348,0,372,24,0,10,3.74757,0.23301,31.6214,74.5821,103,4
West Indies,176,217.33,7.15909,0.3125,225.278,7.57386,0.380682,765,CH Gayle,190,122,68,139,206,1,75,0,44,23,67,198,150,348,0,372,24,0,10,4.58621,0.206897,31.1293,89.4255,116,4
Sri Lanka,244,223.373,7.09016,0.344262,227.578,7.47541,0.385246,767,KC Sangakkara,83,46,37,61,206,1,56,0,40,16,56,158,160,318,0,332,14,0,10,4.33659,0.360976,41.9854,80.6276,205,4
Sri Lanka,244,223.373,7.09016,0.344262,227.578,7.47541,0.385246,767,TM Dilshan,127,60,67,133,206,1,56,0,40,16,56,158,160,318,0,332,14,0,10,4.60199,0.273632,38.3632,86.0219,201,4
Bangladesh,160,218.438,7.70625,0.4,211.106,7.05,0.325,767,Sabbir Rahman,46,24,22,56,190,6,28,2,4,3,7,110,115,225,333,240,15,0,10,3.23529,0.117647,25.6471,98.1982,17,0
Bangladesh,160,218.438,7.70625,0.4,211.106,7.05,0.325,767,Rubel Hossain,0,0,0,1,190,6,28,2,4,3,7,110,115,225,333,240,15,0,10,0.32,0,2.68,52.3438,25,3
South Africa,190,234.274,7.4,0.373684,232.363,7.33158,0.342105,768,DA Miller,10,0,10,10,246,3,53,1,70,23,93,186,206,392,0,408,16,0,10,2.57353,0.132353,24.9412,97.2477,68,0
South Africa,190,234.274,7.4,0.373684,232.363,7.33158,0.342105,768,AB de Villiers,89,52,37,47,246,3,53,1,70,23,93,186,206,392,0,408,16,0,10,5.04969,0.403727,47.2174,98.8428,161,4
South Africa,190,234.274,7.4,0.373684,232.363,7.33158,0.342105,768,F Behardien,0,0,0,0,246,3,53,1,70,23,93,186,206,392,0,408,16,0,10,2.0303,0.0909091,21.2424,91.395,33,0
England,221,237.176,7.17647,0.289593,230.633,7.45701,0.384615,771,JWA Taylor,24,10,14,25,187,4,54,0,34,16,50,170,121,291,0,309,18,0,10,3.375,0.333333,35.9167,79.8888,24,4
England,221,237.176,7.17647,0.289593,230.633,7.45701,0.384615,771,JE Root,120,68,52,106,187,4,54,0,34,16,50,170,121,291,0,309,18,0,10,3.68852,0.327869,41.6721,83.3443,61,4
England,221,237.176,7.17647,0.289593,230.633,7.45701,0.384615,771,JC Buttler,0,0,0,0,187,4,54,0,34,16,50,170,121,291,0,309,18,0,10,3.47458,0.186441,29.9153,115.359,59,0
England,221,237.176,7.17647,0.289593,230.633,7.45701,0.384615,771,CR Woakes,0,0,0,0,187,4,54,0,34,16,50,170,121,291,0,309,18,0,10,1.09375,0,15.1562,76.8621,32,1
Sri Lanka,244,223.373,7.09016,0.344262,227.578,7.47541,0.385246,771,KC Sangakkara,113,56,57,82,241,1,38,0,14,7,21,148,152,300,310,312,12,0,10,4.33659,0.360976,41.9854,80.6276,205,4
Sri Lanka,244,223.373,7.09016,0.344262,227.578,7.47541,0.385246,771,HDRL Thirimanne,122,50,72,135,241,1,38,0,14,7,21,148,152,300,310,312,12,0,10,2.77778,0.246914,31.5802,71.4725,81,4
Pakistan,211,222.621,7.38389,0.393365,235.517,7.54976,0.336493,772,Wahab Riaz,21,8,13,29,149,6,26,0,22,18,40,74,141,215,0,235,20,0,10,1.29167,0.0416667,10.9792,79.1291,48,1
Pakistan,211,222.621,7.38389,0.393365,235.517,7.54976,0.336493,772,Misbah-ul-Haq,72,12,60,123,149,6,26,0,22,18,40,74,141,215,0,235,20,0,10,2.95238,0.285714,34.9921,71.8195,126,4
Pakistan,211,222.621,7.38389,0.393365,235.517,7.54976,0.336493,772,Sohail Khan,0,0,0,0,149,6,26,0,22,18,40,74,141,215,0,235,20,0,10,0.333333,0,4.16667,48.0769,6,3
Zimbabwe,142,212.077,7.5,0.380282,227.704,6.97887,0.316901,772,T Panyangara,6,0,6,13,153,8,24,0,8,11,19,80,116,196,236,215,19,0,10,0.6,0,4.84,51.2712,25,3
Zimbabwe,142,212.077,7.5,0.380282,227.704,6.97887,0.316901,772,E Chigumbura,20,8,12,23,153,8,24,0,8,11,19,80,116,196,236,215,19,0,10,2.28947,0.114035,22.7895,77.7844,114,4
South Africa,190,234.274,7.4,0.373684,232.363,7.33158,0.342105,773,RR Rossouw,24,12,12,13,272,2,66,2,48,14,62,220,180,400,0,411,11,0,10,3.80769,0.230769,31.3846,93.1507,26,0
South Africa,190,234.274,7.4,0.373684,232.363,7.33158,0.342105,773,DA Miller,21,10,11,9,272,2,66,2,48,14,62,220,180,400,0,411,11,0,10,2.57353,0.132353,24.9412,97.2477,68,0
Pakistan,211,222.621,7.38389,0.393365,235.517,7.54976,0.336493,777,Sohail Khan,2,0,2,5,186,5,20,3,0,2,2,114,94,208,0,222,14,0,10,0.333333,0,4.16667,48.0769,6,3
Pakistan,211,222.621,7.38389,0.393365,235.517,7.54976,0.336493,777,Mohammad Irfan,0,0,0,0,186,5,20,3,0,2,2,114,94,208,0,222,14,0,10,0.233333,0,1.56667,30.9211,30,3
Ireland,55,219.527,7.65455,0.290909,202.727,7.56364,0.4,778,GC Wilson,2,0,2,2,216,3,53,1,26,21,47,160,156,316,0,331,15,0,10,2.22727,0.227273,22,78.1906,22,4
Ireland,55,219.527,7.65455,0.290909,202.727,7.56364,0.4,778,A Balbirnie,92,52,40,75,216,3,53,1,26,21,47,160,156,316,0,331,15,0,10,3,0.222222,28.7778,81.1912,9,4
Ireland,55,219.527,7.65455,0.290909,202.727,7.56364,0.4,778,JF Mooney,0,0,0,0,216,3,53,1,26,21,47,160,156,316,0,331,15,0,10,1.47619,0,13.7619,72.796,21,1
Ireland,55,219.527,7.65455,0.290909,202.727,7.56364,0.4,778,NJ O'Brien,0,0,0,0,216,3,53,1,26,21,47,160,156,316,0,331,15,0,10,2.55882,0.176471,25.5882,69.378,34,4
Ireland,55,219.527,7.65455,0.290909,202.727,7.56364,0.4,778,GH Dockrell,0,0,0,0,216,3,53,1,26,21,47,160,156,316,0,331,15,0,10,0.875,0,9.0625,69.7115,16,1
Ireland,55,219.527,7.65455,0.290909,202.727,7.56364,0.4,778,AR Cusack,0,0,0,0,216,3,53,1,26,21,47,160,156,316,0,331,15,0,10,1.2,0,12.0667,65.1079,15,1
Zimbabwe,142,212.077,7.5,0.380282,227.704,6.97887,0.316901,778,SC Williams,88,40,48,76,235,5,40,1,18,22,40,154,161,315,332,326,11,0,10,2.56923,0.276923,28.5385,80.7927,65,4
Zimbabwe,142,212.077,7.5,0.380282,227.704,6.97887,0.316901,778,RW Chakabva,9,0,9,9,235,5,40,1,18,22,40,154,161,315,332,326,11,0,10,0.846154,0,13.2692,51.3393,26,3
Zimbabwe,142,212.077,7.5,0.380282,227.704,6.97887,0.316901,778,T Panyangara,0,0,0,0,235,5,40,1,18,22,40,154,161,315,332,326,11,0,10,0.6,0,4.84,51.2712,25,3
Zimbabwe,142,212.077,7.5,0.380282,227.704,6.97887,0.316901,778,T Mupariwa,0,0,0,0,235,5,40,1,18,22,40,154,161,315,332,326,11,0,10,0.416667,0,3.58333,39.0909,12,3
Zimbabwe,142,212.077,7.5,0.380282,227.704,6.97887,0.316901,778,TL Chatara,0,0,0,0,235,5,40,1,18,22,40,154,161,315,332,326,11,0,10,0.705882,0,5.82353,57.2254,17,3
Australia,228,239.627,7.69737,0.372807,232.079,7.23246,0.337719,780,SR Watson,44,24,20,29,251,4,65,0,38,16,54,200,170,370,0,376,6,1,10,4.71318,0.286822,37.7907,90.0943,129,4
Australia,228,239.627,7.69737,0.372807,232.079,7.23246,0.337719,780,GJ Maxwell,99,64,35,51,251,4,65,0,38,16,54,200,170,370,0,376,6,1,10,3.79245,0.226415,28.2264,119.68,53,0
Australia,228,239.627,7.69737,0.372807,232.079,7.23246,0.337719,780,JP Faulkner,0,0,0,0,251,4,65,0,38,16,54,200,170,370,0,376,6,1,10,2.88235,0.147059,24.1471,109.613,34,0
Australia,228,239.627,7.69737,0.372807,232.079,7.23246,0.337719,780,BJ Haddin,0,0,0,0,251,4,65,0,38,16,54,200,170,370,0,376,6,1,10,3.14737,0.147368,26.7789,81.382,95,4
Australia,228,239.627,7.69737,0.372807,232.079,7.23246,0.337719,780,MG Johnson,0,0,0,0,251,4,65,0,38,16,54,200,170,370,0,376,6,1,10,1.18519,0.0246914,10.7901,94.181,81,0
Australia,228,239.627,7.69737,0.372807,232.079,7.23246,0.337719,780,XJ Doherty,0,0,0,0,251,4,65,0,38,16,54,200,170,370,0,376,6,1,10,0.190476,0,4.28571,52.0231,21,3
Sri Lanka,244,223.373,7.09016,0.344262,227.578,7.47541,0.385246,780,SMSM Senanayake,1,0,1,3,262,4,33,4,4,2,6,148,153,301,377,312,11,0,10,1.0625,0,8.625,87.0662,32,1
Sri Lanka,244,223.373,7.09016,0.344262,227.578,7.47541,0.385246,780,WU Tharanga,4,0,4,4,262,4,33,4,4,2,6,148,153,301,377,312,11,0,10,3.93985,0.263158,32.9699,71.6035,133,4
Sri Lanka,244,223.373,7.09016,0.344262,227.578,7.47541,0.385246,780,SL Malinga,0,0,0,0,262,4,33,4,4,2,6,148,153,301,377,312,11,0,10,0.617284,0.0123457,4.97531,74.6296,81,1
Bangladesh,160,218.438,7.70625,0.4,211.106,7.05,0.325,781,Mahmudullah,102,40,62,138,190,4,37,0,14,20,34,114,147,261,0,275,14,0,10,2.26531,0.153061,24.4286,70.9544,98,4
Bangladesh,160,218.438,7.70625,0.4,211.106,7.05,0.325,781,Mushfiqur Rahim,79,34,45,68,190,4,37,0,14,20,34,114,147,261,0,275,14,0,10,2.61111,0.18254,27.7778,75.2526,126,4
Bangladesh,160,218.438,7.70625,0.4,211.106,7.05,0.325,781,Sabbir Rahman,0,0,0,0,190,4,37,0,14,20,34,114,147,261,0,275,14,0,10,3.23529,0.117647,25.6471,98.1982,17,0
Bangladesh,160,218.438,7.70625,0.4,211.106,7.05,0.325,781,Mashrafe Mortaza,0,0,0,0,190,4,37,0,14,20,34,114,147,261,0,275,14,0,10,1.27536,0,11.1594,76.9231,69,1
Bangladesh,160,218.438,7.70625,0.4,211.106,7.05,0.325,781,Arafat Sunny,0,0,0,0,190,4,37,0,14,20,34,114,147,261,0,275,14,0,10,0.5,0,4.7,50,10,3
England,221,237.176,7.17647,0.289593,230.633,7.45701,0.384615,781,CR Woakes,25,4,21,29,179,6,48,0,14,14,28,112,143,255,276,260,5,0,10,1.09375,0,15.1562,76.8621,32,1
England,221,237.176,7.17647,0.289593,230.633,7.45701,0.384615,781,JC Buttler,63,30,33,50,179,6,48,0,14,14,28,112,143,255,276,260,5,0,10,3.47458,0.186441,29.9153,115.359,59,0
England,221,237.176,7.17647,0.289593,230.633,7.45701,0.384615,781,CJ Jordan,0,0,0,0,179,6,48,0,14,14,28,112,143,255,276,260,5,0,10,0.833333,0,8.22222,84.0909,18,1
England,221,237.176,7.17647,0.289593,230.633,7.45701,0.384615,781,SCJ Broad,0,0,0,0,179,6,48,0,14,14,28,112,143,255,276,260,5,0,10,0.725806,0,8.04839,74.0356,62,1
England,221,237.176,7.17647,0.289593,230.633,7.45701,0.384615,781,JM Anderson,0,0,0,0,179,6,48,0,14,14,28,112,143,255,276,260,5,0,10,0.365385,0,3.92308,52.7132,52,3
Ireland,55,219.527,7.65455,0.290909,202.727,7.56364,0.4,782,JF Mooney,1,0,1,7,205,5,21,3,8,14,22,130,118,248,0,259,11,0,10,1.47619,0,13.7619,72.796,21,1
Ireland,55,219.527,7.65455,0.290909,202.727,7.56364,0.4,782,GH Dockrell,6,6,0,11,205,5,21,3,8,14,22,130,118,248,0,259,11,0,10,0.875,0,9.0625,69.7115,16,1
Ireland,55,219.527,7.65455,0.290909,202.727,7.56364,0.4,782,AR Cusack,0,0,0,0,205,5,21,3,8,14,22,130,118,248,0,259,11,0,10,1.2,0,12.0667,65.1079,15,1
Bangladesh,160,218.438,7.70625,0.4,211.106,7.05,0.325,784,Sabbir Rahman,27,22,5,17,180,5,46,0,38,19,57,160,123,283,0,288,5,0,10,3.23529,0.117647,25.6471,98.1982,17,0
Bangladesh,160,218.438,7.70625,0.4,211.106,7.05,0.325,784,Mahmudullah,95,44,51,106,180,5,46,0,38,19,57,160,123,283,0,288,5,0,10,2.26531,0.153061,24.4286,70.9544,98,4
Bangladesh,160,218.438,7.70625,0.4,211.106,7.05,0.325,784,Nasir Hossain,0,0,0,0,180,5,46,0,38,19,57,160,123,283,0,288,5,0,10,2.75,0.159091,27.0455,79.3863,44,4
New Zealand,184,233.745,7.39674,0.36413,227.951,7.30435,0.353261,784,CJ Anderson,25,20,5,20,208,4,36,2,30,11,41,164,121,285,289,290,5,1,10,3.90909,0.151515,30.2424,112.514,33,0
New Zealand,184,233.745,7.39674,0.36413,227.951,7.30435,0.353261,784,DL Vettori,1,0,1,1,208,4,36,2,30,11,41,164,121,285,289,290,5,1,10,1.43662,0.028169,15.7606,86.0108,71,0
New Zealand,184,233.745,7.39674,0.36413,227.951,7.30435,0.353261,784,TG Southee,0,0,0,0,208,4,36,2,30,11,41,164,121,285,289,290,5,1,10,0.764706,0,7.03922,92.7649,51,0
Zimbabwe,142,212.077,7.5,0.380282,227.704,6.97887,0.316901,786,RW Chakabva,7,0,7,6,200,4,52,2,20,6,26,164,114,278,0,287,9,0,10,0.846154,0,13.2692,51.3393,26,3
Zimbabwe,142,212.077,7.5,0.380282,227.704,6.97887,0.316901,786,Sikandar Raza,12,6,6,10,200,4,52,2,20,6,26,164,114,278,0,287,9,0,10,3,0.131579,26.1842,81.1582,38,4
Zimbabwe,142,212.077,7.5,0.380282,227.704,6.97887,0.316901,786,T Panyangara,0,0,0,0,200,4,52,2,20,6,26,164,114,278,0,287,9,0,10,0.6,0,4.84,51.2712,25,3
Zimbabwe,142,212.077,7.5,0.380282,227.704,6.97887,0.316901,786,T Mupariwa,0,0,0,0,200,4,52,2,20,6,26,164,114,278,0,287,9,0,10,0.416667,0,3.58333,39.0909,12,3
Zimbabwe,142,212.077,7.5,0.380282,227.704,6.97887,0.316901,786,TL Chatara,0,0,0,0,200,4,52,2,20,6,26,164,114,278,0,287,9,0,10,0.705882,0,5.82353,57.2254,17,3
India,259,242.378,7.15058,0.339768,244.568,7.12741,0.30888,786,MS Dhoni,57,28,29,63,187,4,48,0,20,17,37,144,128,272,288,288,16,0,10,3.47872,0.292553,36.7713,84.1612,188,4
India,259,242.378,7.15058,0.339768,244.568,7.12741,0.30888,786,SK Raina,101,56,45,100,187,4,48,0,20,17,37,144,128,272,288,288,16,0,10,3.11111,0.216374,28.9064,91.8944,171,0
Ireland,55,219.527,7.65455,0.290909,202.727,7.56364,0.4,789,JF Mooney,2,0,2,5,180,5,17,2,14,14,28,88,137,225,0,237,12,0,10,1.47619,0,13.7619,72.796,21,1
Ireland,55,219.527,7.65455,0.290909,202.727,7.56364,0.4,789,KJ O'Brien,3,0,3,10,180,5,17,2,14,14,28,88,137,225,0,237,12,0,10,2.64706,0.0588235,22.3824,79.4363,34,4
Ireland,55,219.527,7.65455,0.290909,202.727,7.56364,0.4,789,GH Dockrell,0,0,0,0,180,5,17,2,14,14,28,88,137,225,0,237,12,0,10,0.875,0,9.0625,69.7115,16,1
Ireland,55,219.527,7.65455,0.290909,202.727,7.56364,0.4,789,AR Cusack,0,0,0,0,180,5,17,2,14,14,28,88,137,225,0,237,12,0,10,1.2,0,12.0667,65.1079,15,1
Pakistan,211,222.621,7.38389,0.393365,235.517,7.54976,0.336493,789,Sarfraz Ahmed,97,20,77,125,198,3,20,0,8,0,8,92,134,226,238,241,15,0,10,2.04878,0.097561,25.4878,83.9357,41,4
Pakistan,211,222.621,7.38389,0.393365,235.517,7.54976,0.336493,789,Umar Akmal,16,12,4,29,198,3,20,0,8,0,8,92,134,226,238,241,15,0,10,2.76842,0.2,27.5053,82.7947,95,4
India,259,242.378,7.15058,0.339768,244.568,7.12741,0.30888,791,RG Sharma,112,50,62,117,191,3,39,1,40,16,56,140,146,286,0,302,16,0,10,3.82836,0.268657,35.9179,83.083,134,4
India,259,242.378,7.15058,0.339768,244.568,7.12741,0.30888,791,MS Dhoni,1,0,1,4,191,3,39,1,40,16,56,140,146,286,0,302,16,0,10,3.47872,0.292553,36.7713,84.1612,188,4
India,259,242.378,7.15058,0.339768,244.568,7.12741,0.30888,791,RA Jadeja,0,0,0,0,191,3,39,1,40,16,56,140,146,286,0,302,16,0,10,2.12941,0.117647,21.7529,82.4342,85,4
India,259,242.378,7.15058,0.339768,244.568,7.12741,0.30888,791,R Ashwin,0,0,0,0,191,3,39,1,40,16,56,140,146,286,0,302,16,0,10,1.16364,0.0181818,11.9455,84.7742,55,1
Pakistan,211,222.621,7.38389,0.393365,235.517,7.54976,0.336493,792,Ehsan Adil,3,0,3,9,172,6,14,3,4,13,17,78,125,203,0,213,10,0,10,0.666667,0,7.33333,66.6667,3,1
Australia,228,239.627,7.69737,0.372807,232.079,7.23246,0.337719,794,JP Faulkner,10,8,2,8,226,4,31,1,44,13,57,180,134,314,0,328,14,1,10,2.88235,0.147059,24.1471,109.613,34,0
Australia,228,239.627,7.69737,0.372807,232.079,7.23246,0.337719,794,SR Watson,16,6,10,21,226,4,31,1,44,13,57,180,134,314,0,328,14,1,10,4.71318,0.286822,37.7907,90.0943,129,4
Australia,228,239.627,7.69737,0.372807,232.079,7.23246,0.337719,794,BJ Haddin,0,0,0,0,226,4,31,1,44,13,57,180,134,314,0,328,14,1,10,3.14737,0.147368,26.7789,81.382,95,4
Australia,228,239.627,7.69737,0.372807,232.079,7.23246,0.337719,794,MG Johnson,0,0,0,0,226,4,31,1,44,13,57,180,134,314,0,328,14,1,10,1.18519,0.0246914,10.7901,94.181,81,0
India,259,242.378,7.15058,0.339768,244.568,7.12741,0.30888,794,R Ashwin,5,0,5,9,182,5,35,2,0,1,1,90,128,218,329,233,15,0,10,1.16364,0.0181818,11.9455,84.7742,55,1
India,259,242.378,7.15058,0.339768,244.568,7.12741,0.30888,794,MM Sharma,0,0,0,0,182,5,35,2,0,1,1,90,128,218,329,233,15,0,10,0.625,0,3.75,56.6038,8,3
India,259,242.378,7.15058,0.339768,244.568,7.12741,0.30888,794,UT Yadav,0,0,0,0,182,5,35,2,0,1,1,90,128,218,329,233,15,0,10,0.533333,0,3.46667,56.5217,15,3
India,259,242.378,7.15058,0.339768,244.568,7.12741,0.30888,794,Mohammed Shami,0,0,0,0,182,5,35,2,0,1,1,90,128,218,329,233,15,0,10,0.684211,0,5.68421,88.5246,19,0
Pakistan,211,222.621,7.38389,0.393365,235.517,7.54976,0.336493,796,Mohammad Hafeez,105,46,59,118,209,2,48,1,32,22,54,160,151,311,0,322,11,0,10,4.04511,0.255639,34.3534,78.0625,133,4
Pakistan,211,222.621,7.38389,0.393365,235.517,7.54976,0.336493,796,Shahid Afridi,7,4,3,3,209,2,48,1,32,22,54,160,151,311,0,322,11,0,10,2.72917,0.0972222,21.4097,127.766,144,0
Pakistan,211,222.621,7.38389,0.393365,235.517,7.54976,0.336493,796,Umar Akmal,0,0,0,0,209,2,48,1,32,22,54,160,151,311,0,322,11,0,10,2.76842,0.2,27.5053,82.7947,95,4
Pakistan,211,222.621,7.38389,0.393365,235.517,7.54976,0.336493,796,Bilawal Bhatti,0,0,0,0,209,2,48,1,32,22,54,160,151,311,0,322,11,0,10,1.71429,0,12.5714,114.286,7,0
Sri Lanka,244,223.373,7.09016,0.344262,227.578,7.47541,0.385246,796,S Prasanna,14,10,4,10,204,5,44,2,38,9,47,150,145,295,323,311,16,0,10,1.25,0,9.5,78.8382,20,1
Sri Lanka,244,223.373,7.09016,0.344262,227.578,7.47541,0.385246,796,SMSM Senanayake,24,20,4,12,204,5,44,2,38,9,47,150,145,295,323,311,16,0,10,1.0625,0,8.625,87.0662,32,1
Pakistan,211,222.621,7.38389,0.393365,235.517,7.54976,0.336493,797,Ahmed Shehzad,124,32,92,142,183,3,39,0,20,28,48,84,186,270,0,284,14,0,10,3.67143,0.242857,33.2714,70.8118,70,4
Pakistan,211,222.621,7.38389,0.393365,235.517,7.54976,0.336493,797,Shahid Afridi,0,0,0,0,183,3,39,0,20,28,48,84,186,270,0,284,14,0,10,2.72917,0.0972222,21.4097,127.766,144,0
Pakistan,211,222.621,7.38389,0.393365,235.517,7.54976,0.336493,797,Misbah-ul-Haq,41,10,31,48,183,3,39,0,20,28,48,84,186,270,0,284,14,0,10,2.95238,0.285714,34.9921,71.8195,126,4
Sri Lanka,244,223.373,7.09016,0.344262,227.578,7.47541,0.385246,797,AD Mathews,25,4,21,28,189,5,39,2,12,30,42,104,166,270,285,287,17,0,10,2.64122,0.198473,28.6794,82.3362,131,4
Sri Lanka,244,223.373,7.09016,0.344262,227.578,7.47541,0.385246,797,FDM Karunaratne,2,0,2,2,189,5,39,2,12,30,42,104,166,270,285,287,17,0,10,0.8,0,10.7,64.8485,10,1
Sri Lanka,244,223.373,7.09016,0.344262,227.578,7.47541,0.385246,797,SMSM Senanayake,0,0,0,0,189,5,39,2,12,30,42,104,166,270,285,287,17,0,10,1.0625,0,8.625,87.0662,32,1
Pakistan,211,222.621,7.38389,0.393365,235.517,7.54976,0.336493,798,Mohammad Hafeez,114,44,70,124,205,3,53,0,34,17,51,154,155,309,0,326,17,0,10,4.04511,0.255639,34.3534,78.0625,133,4
Pakistan,211,222.621,7.38389,0.393365,235.517,7.54976,0.336493,798,Misbah-ul-Haq,40,24,16,26,205,3,53,0,34,17,51,154,155,309,0,326,17,0,10,2.95238,0.285714,34.9921,71.8195,126,4
Pakistan,211,222.621,7.38389,0.393365,235.517,7.54976,0.336493,798,Shahid Afridi,0,0,0,0,205,3,53,0,34,17,51,154,155,309,0,326,17,0,10,2.72917,0.0972222,21.4097,127.766,144,0
Pakistan,211,222.621,7.38389,0.393365,235.517,7.54976,0.336493,798,Umar Akmal,0,0,0,0,205,3,53,0,34,17,51,154,155,309,0,326,17,0,10,2.76842,0.2,27.5053,82.7947,95,4
Sri Lanka,244,223.373,7.09016,0.344262,227.578,7.47541,0.385246,799,KDK Vithanage,15,8,7,16,180,6,20,2,8,6,14,94,120,214,0,225,11,0,10,1.83333,0,12.3333,80.4348,6,1
Sri Lanka,244,223.373,7.09016,0.344262,227.578,7.47541,0.385246,799,SL Malinga,0,0,0,0,180,6,20,2,8,6,14,94,120,214,0,225,11,0,10,0.617284,0.0123457,4.97531,74.6296,81,1
Pakistan,211,222.621,7.38389,0.393365,235.517,7.54976,0.336493,800,Anwar Ali,15,0,15,22,158,6,19,1,18,17,35,78,134,212,0,232,20,0,10,2.14286,0,18.5714,82.2785,14,1
Pakistan,211,222.621,7.38389,0.393365,235.517,7.54976,0.336493,800,Umar Gul,7,4,3,11,158,6,19,1,18,17,35,78,134,212,0,232,20,0,10,0.77193,0,7.14035,68.2886,57,1
Pakistan,211,222.621,7.38389,0.393365,235.517,7.54976,0.336493,800,Saeed Ajmal,0,0,0,0,158,6,19,1,18,17,35,78,134,212,0,232,20,0,10,0.34375,0,4.60938,58.3004,64,3
Pakistan,211,222.621,7.38389,0.393365,235.517,7.54976,0.336493,800,Junaid Khan,0,0,0,0,158,6,19,1,18,17,35,78,134,212,0,232,20,0,10,0.210526,0,2.84211,47.7876,19,3
Sri Lanka,244,223.373,7.09016,0.344262,227.578,7.47541,0.385246,800,LD Chandimal,43,0,43,57,157,4,26,3,24,16,40,84,139,223,233,235,12,0,10,2.18478,0.184783,25.7391,73.8615,92,4
Sri Lanka,244,223.373,7.09016,0.344262,227.578,7.47541,0.385246,800,SL Malinga,0,0,0,0,157,4,26,3,24,16,40,84,139,223,233,235,12,0,10,0.617284,0.0123457,4.97531,74.6296,81,1
Sri Lanka,244,223.373,7.09016,0.344262,227.578,7.47541,0.385246,800,BAW Mendis,0,0,0,0,157,4,26,3,24,16,40,84,139,223,233,235,12,0,10,0.447368,0,4.47368,66.4062,38,1
Pakistan,211,222.621,7.38389,0.393365,235.517,7.54976,0.336493,801,Misbah-ul-Haq,56,8,48,69,176,4,17,2,16,19,35,90,138,228,0,244,16,0,10,2.95238,0.285714,34.9921,71.8195,126,4
Pakistan,211,222.621,7.38389,0.393365,235.517,7.54976,0.336493,801,Sarfraz Ahmed,2,0,2,7,176,4,17,2,16,19,35,90,138,228,0,244,16,0,10,2.04878,0.097561,25.4878,83.9357,41,4
Pakistan,211,222.621,7.38389,0.393365,235.517,7.54976,0.336493,801,Saeed Ajmal,0,0,0,0,176,4,17,2,16,19,35,90,138,228,0,244,16,0,10,0.34375,0,4.60938,58.3004,64,3
Zimbabwe,142,212.077,7.5,0.380282,227.704,6.97887,0.316901,801,SC Williams,12,4,8,8,174,2,34,1,18,13,31,114,125,239,245,246,7,1,10,2.56923,0.276923,28.5385,80.7927,65,4
Zimbabwe,142,212.077,7.5,0.380282,227.704,6.97887,0.316901,801,BRM Taylor,39,16,23,54,174,2,34,1,18,13,31,114,125,239,245,246,7,1,10,3.3,0.26,33.56,76.3421,100,4
Pakistan,211,222.621,7.38389,0.393365,235.517,7.54976,0.336493,802,Sarfraz Ahmed,1,0,1,1,157,2,39,2,24,27,51,90,157,247,0,260,13,0,10,2.04878,0.097561,25.4878,83.9357,41,4
Pakistan,211,222.621,7.38389,0.393365,235.517,7.54976,0.336493,802,Misbah-ul-Haq,51,16,35,75,157,2,39,2,24,27,51,90,157,247,0,260,13,0,10,2.95238,0.285714,34.9921,71.8195,126,4
Pakistan,211,222.621,7.38389,0.393365,235.517,7.54976,0.336493,802,Mohammad Hafeez,12,4,8,27,157,2,39,2,24,27,51,90,157,247,0,260,13,0,10,4.04511,0.255639,34.3534,78.0625,133,4
Pakistan,211,222.621,7.38389,0.393365,235.517,7.54976,0.336493,802,Abdur Rehman,0,0,0,0,157,2,39,2,24,27,51,90,157,247,0,260,13,0,10,0.52381,0,6.04762,55.7018,21,3
New Zealand,184,233.745,7.39674,0.36413,227.951,7.30435,0.353261,807,LRPL Taylor,38,16,22,39,189,2,39,2,24,21,45,118,155,273,0,285,12,1,10,3.68382,0.301471,36.7206,79.3959,136,4
New Zealand,184,233.745,7.39674,0.36413,227.951,7.30435,0.353261,807,CJ Anderson,1,0,1,2,189,2,39,2,24,21,45,118,155,273,0,285,12,1,10,3.90909,0.151515,30.2424,112.514,33,0
New Zealand,184,233.745,7.39674,0.36413,227.951,7.30435,0.353261,807,L Ronchi,0,0,0,0,189,2,39,2,24,21,45,118,155,273,0,285,12,1,10,2.92157,0.0784314,22.1961,115.392,51,0
New Zealand,184,233.745,7.39674,0.36413,227.951,7.30435,0.353261,807,NL McCullum,0,0,0,0,189,2,39,2,24,21,45,118,155,273,0,285,12,1,10,1.63934,0.0655738,17.377,85.622,61,0
West Indies,176,217.33,7.15909,0.3125,225.278,7.57386,0.380682,808,KA Edwards,114,72,42,100,233,3,75,0,14,26,40,218,130,348,0,363,15,0,10,1.875,0.0625,20.6875,64.902,16,1
West Indies,176,217.33,7.15909,0.3125,225.278,7.57386,0.380682,808,DJ Bravo,81,56,25,70,233,3,75,0,14,26,40,218,130,348,0,363,15,0,10,2.35514,0.11215,23.1589,80.9011,107,4
West Indies,176,217.33,7.15909,0.3125,225.278,7.57386,0.380682,808,AD Russell,0,0,0,0,233,3,75,0,14,26,40,218,130,348,0,363,15,0,10,3.38095,0.0952381,23.2857,129.536,42,0
New Zealand,184,233.745,7.39674,0.36413,227.951,7.30435,0.353261,809,CJ Anderson,42,30,12,23,196,4,54,1,6,29,35,126,159,285,0,292,7,1,10,3.90909,0.151515,30.2424,112.514,33,0
New Zealand,184,233.745,7.39674,0.36413,227.951,7.30435,0.353261,809,L Ronchi,26,20,6,13,196,4,54,1,6,29,35,126,159,285,0,292,7,1,10,2.92157,0.0784314,22.1961,115.392,51,0
New Zealand,184,233.745,7.39674,0.36413,227.951,7.30435,0.353261,809,NL McCullum,0,0,0,0,196,4,54,1,6,29,35,126,159,285,0,292,7,1,10,1.63934,0.0655738,17.377,85.622,61,0
New Zealand,184,233.745,7.39674,0.36413,227.951,7.30435,0.353261,809,TG Southee,0,0,0,0,196,4,54,1,6,29,35,126,159,285,0,292,7,1,10,0.764706,0,7.03922,92.7649,51,0
India,259,242.378,7.15058,0.339768,244.568,7.12741,0.30888,809,R Ashwin,0,0,0,2,200,4,29,3,10,14,24,110,143,253,293,268,15,0,10,1.16364,0.0181818,11.9455,84.7742,55,1
India,259,242.378,7.15058,0.339768,244.568,7.12741,0.30888,809,I Sharma,0,0,0,0,200,4,29,3,10,14,24,110,143,253,293,268,15,0,10,0.24,0,2.84,34.1346,25,3
India,259,242.378,7.15058,0.339768,244.568,7.12741,0.30888,809,Mohammed Shami,0,0,0,0,200,4,29,3,10,14,24,110,143,253,293,268,15,0,10,0.684211,0,5.68421,88.5246,19,0
India,259,242.378,7.15058,0.339768,244.568,7.12741,0.30888,811,MS Dhoni,47,18,29,58,174,5,45,0,32,16,48,162,105,267,0,278,11,0,10,3.47872,0.292553,36.7713,84.1612,188,4
India,259,242.378,7.15058,0.339768,244.568,7.12741,0.30888,811,RA Jadeja,46,36,10,41,174,5,45,0,32,16,48,162,105,267,0,278,11,0,10,2.12941,0.117647,21.7529,82.4342,85,4
New Zealand,184,233.745,7.39674,0.36413,227.951,7.30435,0.353261,811,LRPL Taylor,108,60,48,121,208,3,39,0,18,10,28,160,115,275,279,280,5,1,10,3.68382,0.301471,36.7206,79.3959,136,4
New Zealand,184,233.745,7.39674,0.36413,227.951,7.30435,0.353261,811,BB McCullum,25,16,9,25,208,3,39,0,18,10,28,160,115,275,279,280,5,1,10,3.98611,0.201389,29.9028,98.4004,144,0
New Zealand,184,233.745,7.39674,0.36413,227.951,7.30435,0.353261,812,LRPL Taylor,92,42,50,97,203,3,38,1,32,18,50,144,147,291,0,303,12,1,10,3.68382,0.301471,36.7206,79.3959,136,4
New Zealand,184,233.745,7.39674,0.36413,227.951,7.30435,0.353261,812,JDS Neesham,5,4,1,5,203,3,38,1,32,18,50,144,147,291,0,303,12,1,10,1.75,0,14.875,93.7008,16,0
New Zealand,184,233.745,7.39674,0.36413,227.951,7.30435,0.353261,812,L Ronchi,0,0,0,0,203,3,38,1,32,18,50,144,147,291,0,303,12,1,10,2.92157,0.0784314,22.1961,115.392,51,0
India,259,242.378,7.15058,0.339768,244.568,7.12741,0.30888,812,Mohammed Shami,1,0,1,3,164,5,19,3,10,17,27,88,122,210,304,216,6,0,10,0.684211,0,5.68421,88.5246,19,0
India,259,242.378,7.15058,0.339768,244.568,7.12741,0.30888,812,B Kumar,6,0,6,10,164,5,19,3,10,17,27,88,122,210,304,216,6,0,10,0.75,0,7.39286,72.1254,28,1
India,259,242.378,7.15058,0.339768,244.568,7.12741,0.30888,812,VR Aaron,0,0,0,0,164,5,19,3,10,17,27,88,122,210,304,216,6,0,10,0.333333,0,2.66667,53.3333,3,3
India,259,242.378,7.15058,0.339768,244.568,7.12741,0.30888,813,MS Dhoni,36,16,20,46,196,4,43,0,16,20,36,144,131,275,0,304,29,0,10,3.47872,0.292553,36.7713,84.1612,188,4
India,259,242.378,7.15058,0.339768,244.568,7.12741,0.30888,813,SK Raina,99,66,33,76,196,4,43,0,16,20,36,144,131,275,0,304,29,0,10,3.11111,0.216374,28.9064,91.8944,171,0
India,259,242.378,7.15058,0.339768,244.568,7.12741,0.30888,813,RA Jadeja,0,0,0,0,196,4,43,0,16,20,36,144,131,275,0,304,29,0,10,2.12941,0.117647,21.7529,82.4342,85,4
India,259,242.378,7.15058,0.339768,244.568,7.12741,0.30888,813,R Ashwin,0,0,0,0,196,4,43,0,16,20,36,144,131,275,0,304,29,0,10,1.16364,0.0181818,11.9455,84.7742,55,1
England,221,237.176,7.17647,0.289593,230.633,7.45701,0.384615,814,JC Buttler,35,8,27,53,157,6,21,1,26,17,43,70,151,221,0,227,6,1,10,3.47458,0.186441,29.9153,115.359,59,0
England,221,237.176,7.17647,0.289593,230.633,7.45701,0.384615,814,JC Tredwell,0,0,0,0,157,6,21,1,26,17,43,70,151,221,0,227,6,1,10,0.52,0,6.52,65.9919,25,1
England,221,237.176,7.17647,0.289593,230.633,7.45701,0.384615,814,ST Finn,0,0,0,0,157,6,21,1,26,17,43,70,151,221,0,227,6,1,10,0.583333,0,5.41667,59.633,24,3
England,221,237.176,7.17647,0.289593,230.633,7.45701,0.384615,815,MM Ali,63,34,29,44,152,6,30,1,0,10,10,70,122,192,0,206,14,1,10,2.67647,0.117647,21.3824,94.5384,34,0
England,221,237.176,7.17647,0.289593,230.633,7.45701,0.384615,815,ST Finn,0,0,0,0,152,6,30,1,0,10,10,70,122,192,0,206,14,1,10,0.583333,0,5.41667,59.633,24,3
England,221,237.176,7.17647,0.289593,230.633,7.45701,0.384615,815,JM Anderson,0,0,0,0,152,6,30,1,0,10,10,70,122,192,0,206,14,1,10,0.365385,0,3.92308,52.7132,52,3
England,221,237.176,7.17647,0.289593,230.633,7.45701,0.384615,815,HF Gurney,0,0,0,0,152,6,30,1,0,10,10,70,122,192,0,206,14,1,10,0.166667,0,2.5,45.4545,6,3
England,221,237.176,7.17647,0.289593,230.633,7.45701,0.384615,816,BA Stokes,6,4,2,8,199,4,42,1,32,12,44,162,123,285,0,294,9,1,10,2.23529,0.117647,20.1471,90.0131,34,0
England,221,237.176,7.17647,0.289593,230.633,7.45701,0.384615,816,JE Root,113,58,55,109,199,4,42,1,32,12,44,162,123,285,0,294,9,1,10,3.68852,0.327869,41.6721,83.3443,61,4
England,221,237.176,7.17647,0.289593,230.633,7.45701,0.384615,816,CR Woakes,0,0,0,0,199,4,42,1,32,12,44,162,123,285,0,294,9,1,10,1.09375,0,15.1562,76.8621,32,1
England,221,237.176,7.17647,0.289593,230.633,7.45701,0.384615,816,JC Tredwell,0,0,0,0,199,4,42,1,32,12,44,162,123,285,0,294,9,1,10,0.52,0,6.52,65.9919,25,1
India,259,242.378,7.15058,0.339768,244.568,7.12741,0.30888,816,RA Jadeja,44,12,32,47,183,6,22,3,36,7,43,124,124,248,295,253,5,0,10,2.12941,0.117647,21.7529,82.4342,85,4
Sri Lanka,244,223.373,7.09016,0.344262,227.578,7.47541,0.385246,818,AD Mathews,26,8,18,32,153,4,44,0,16,23,39,78,158,236,0,256,20,0,10,2.64122,0.198473,28.6794,82.3362,131,4
Sri Lanka,244,223.373,7.09016,0.344262,227.578,7.47541,0.385246,818,SMA Priyanjan,31,12,19,30,153,4,44,0,16,23,39,78,158,236,0,256,20,0,10,2.5,0.1,20.95,78.6116,20,4
Sri Lanka,244,223.373,7.09016,0.344262,227.578,7.47541,0.385246,818,LD Chandimal,0,0,0,0,153,4,44,0,16,23,39,78,158,236,0,256,20,0,10,2.18478,0.184783,25.7391,73.8615,92,4
Sri Lanka,244,223.373,7.09016,0.344262,227.578,7.47541,0.385246,818,KMDN Kulasekara,0,0,0,0,153,4,44,0,16,23,39,78,158,236,0,256,20,0,10,1.21,0.04,11.8,80.9328,100,1
Sri Lanka,244,223.373,7.09016,0.344262,227.578,7.47541,0.385246,818,SMSM Senanayake,0,0,0,0,153,4,44,0,16,23,39,78,158,236,0,256,20,0,10,1.0625,0,8.625,87.0662,32,1
Sri Lanka,244,223.373,7.09016,0.344262,227.578,7.47541,0.385246,818,KTGD Prasad,0,0,0,0,153,4,44,0,16,23,39,78,158,236,0,256,20,0,10,1.33333,0,12.4444,106.667,9,0
England,221,237.176,7.17647,0.289593,230.633,7.45701,0.384615,820,CJ Jordan,18,4,14,34,168,6,18,2,8,9,17,50,153,203,0,219,16,1,10,0.833333,0,8.22222,84.0909,18,1
England,221,237.176,7.17647,0.289593,230.633,7.45701,0.384615,820,JM Anderson,0,0,0,0,168,6,18,2,8,9,17,50,153,203,0,219,16,1,10,0.365385,0,3.92308,52.7132,52,3
England,221,237.176,7.17647,0.289593,230.633,7.45701,0.384615,820,HF Gurney,0,0,0,0,168,6,18,2,8,9,17,50,153,203,0,219,16,1,10,0.166667,0,2.5,45.4545,6,3
Sri Lanka,244,223.373,7.09016,0.344262,227.578,7.47541,0.385246,820,AD Mathews,18,4,14,25,147,4,26,0,24,7,31,82,122,204,220,222,18,0,10,2.64122,0.198473,28.6794,82.3362,131,4
Sri Lanka,244,223.373,7.09016,0.344262,227.578,7.47541,0.385246,820,HDRL Thirimanne,53,10,43,93,147,4,26,0,24,7,31,82,122,204,220,222,18,0,10,2.77778,0.246914,31.5802,71.4725,81,4
Bangladesh,160,218.438,7.70625,0.4,211.106,7.05,0.325,821,Sohag Gazi,1,0,1,1,195,5,24,1,12,18,30,130,119,249,0,265,16,1,10,1.46667,0,12.1333,87.9227,15,0
Bangladesh,160,218.438,7.70625,0.4,211.106,7.05,0.325,821,Mahmudullah,25,14,11,27,195,5,24,1,12,18,30,130,119,249,0,265,16,1,10,2.26531,0.153061,24.4286,70.9544,98,4
Bangladesh,160,218.438,7.70625,0.4,211.106,7.05,0.325,821,Mashrafe Mortaza,0,0,0,0,195,5,24,1,12,18,30,130,119,249,0,265,16,1,10,1.27536,0,11.1594,76.9231,69,1
Bangladesh,160,218.438,7.70625,0.4,211.106,7.05,0.325,821,Abdur Razzak,0,0,0,0,195,5,24,1,12,18,30,130,119,249,0,265,16,1,10,0.849315,0.0136986,8.39726,73.8554,73,1
Bangladesh,160,218.438,7.70625,0.4,211.106,7.05,0.325,821,Rubel Hossain,0,0,0,0,195,5,24,1,12,18,30,130,119,249,0,265,16,1,10,0.32,0,2.68,52.3438,25,3
Bangladesh,160,218.438,7.70625,0.4,211.106,7.05,0.325,822,Sohag Gazi,24,10,14,22,175,6,32,0,14,10,24,112,119,231,0,247,16,1,10,1.46667,0,12.1333,87.9227,15,0
Bangladesh,160,218.438,7.70625,0.4,211.106,7.05,0.325,822,Mahmudullah,19,4,15,25,175,6,32,0,14,10,24,112,119,231,0,247,16,1,10,2.26531,0.153061,24.4286,70.9544,98,4
Bangladesh,160,218.438,7.70625,0.4,211.106,7.05,0.325,822,Mashrafe Mortaza,0,0,0,0,175,6,32,0,14,10,24,112,119,231,0,247,16,1,10,1.27536,0,11.1594,76.9231,69,1
Bangladesh,160,218.438,7.70625,0.4,211.106,7.05,0.325,822,Rubel Hossain,0,0,0,0,175,6,32,0,14,10,24,112,119,231,0,247,16,1,10,0.32,0,2.68,52.3438,25,3
Bangladesh,160,218.438,7.70625,0.4,211.106,7.05,0.325,822,Abdur Razzak,0,0,0,0,175,6,32,0,14,10,24,112,119,231,0,247,16,1,10,0.849315,0.0136986,8.39726,73.8554,73,1
New Zealand,184,233.745,7.39674,0.36413,227.951,7.30435,0.353261,822,NL McCullum,18,6,12,21,143,8,27,0,16,4,20,84,106,190,248,207,17,0,10,1.63934,0.0655738,17.377,85.622,61,0
New Zealand,184,233.745,7.39674,0.36413,227.951,7.30435,0.353261,822,KD Mills,14,6,8,19,143,8,27,0,16,4,20,84,106,190,248,207,17,0,10,1.52542,0.0338983,12.8644,90.7895,59,0
New Zealand,184,233.745,7.39674,0.36413,227.951,7.30435,0.353261,822,TG Southee,0,0,0,0,143,8,27,0,16,4,20,84,106,190,248,207,17,0,10,0.764706,0,7.03922,92.7649,51,0
New Zealand,184,233.745,7.39674,0.36413,227.951,7.30435,0.353261,823,L Ronchi,1,0,1,3,205,3,25,2,54,14,68,146,152,298,0,307,9,0,10,2.92157,0.0784314,22.1961,115.392,51,0
New Zealand,184,233.745,7.39674,0.36413,227.951,7.30435,0.353261,823,LRPL Taylor,51,8,43,70,205,3,25,2,54,14,68,146,152,298,0,307,9,0,10,3.68382,0.301471,36.7206,79.3959,136,4
Bangladesh,160,218.438,7.70625,0.4,211.106,7.05,0.325,823,Mahmudullah,8,4,4,7,224,4,28,1,18,16,34,146,140,286,308,309,23,1,10,2.26531,0.153061,24.4286,70.9544,98,4
Bangladesh,160,218.438,7.70625,0.4,211.106,7.05,0.325,823,Nasir Hossain,29,16,13,28,224,4,28,1,18,16,34,146,140,286,308,309,23,1,10,2.75,0.159091,27.0455,79.3863,44,4
Bangladesh,160,218.438,7.70625,0.4,211.106,7.05,0.325,823,Sohag Gazi,0,0,0,0,224,4,28,1,18,16,34,146,140,286,308,309,23,1,10,1.46667,0,12.1333,87.9227,15,0
West Indies,176,217.33,7.15909,0.3125,225.278,7.57386,0.380682,826,JO Holder,13,8,5,20,185,7,15,1,0,4,4,108,96,204,0,211,7,0,10,2.13636,0.0909091,16.9091,97.8947,22,0
West Indies,176,217.33,7.15909,0.3125,225.278,7.57386,0.380682,826,SP Narine,0,0,0,4,185,7,15,1,0,4,4,108,96,204,0,211,7,0,10,1.05882,0,8.55882,76.378,34,1
West Indies,176,217.33,7.15909,0.3125,225.278,7.57386,0.380682,826,R Rampaul,0,0,0,0,185,7,15,1,0,4,4,108,96,204,0,211,7,0,10,1.30303,0.030303,9.90909,77.4882,33,1
India,259,242.378,7.15058,0.339768,244.568,7.12741,0.30888,827,MS Dhoni,13,6,7,26,200,5,16,0,44,18,62,144,134,278,0,288,10,1,10,3.47872,0.292553,36.7713,84.1612,188,4
India,259,242.378,7.15058,0.339768,244.568,7.12741,0.30888,827,RA Jadeja,6,0,6,15,200,5,16,0,44,18,62,144,134,278,0,288,10,1,10,2.12941,0.117647,21.7529,82.4342,85,4
India,259,242.378,7.15058,0.339768,244.568,7.12741,0.30888,827,R Ashwin,0,0,0,0,200,5,16,0,44,18,62,144,134,278,0,288,10,1,10,1.16364,0.0181818,11.9455,84.7742,55,1
India,259,242.378,7.15058,0.339768,244.568,7.12741,0.30888,827,B Kumar,0,0,0,0,200,5,16,0,44,18,62,144,134,278,0,288,10,1,10,0.75,0,7.39286,72.1254,28,1
West Indies,176,217.33,7.15909,0.3125,225.278,7.57386,0.380682,827,LMP Simmons,55,22,33,67,197,5,45,0,24,13,37,160,119,279,289,289,10,0,10,3.3125,0.28125,30.5938,71.4338,64,4
West Indies,176,217.33,7.15909,0.3125,225.278,7.57386,0.380682,827,DJG Sammy,40,24,16,36,197,5,45,0,24,13,37,160,119,279,289,289,10,0,10,2.25,0.09,18.25,95.8005,100,0
West Indies,176,217.33,7.15909,0.3125,225.278,7.57386,0.380682,827,JO Holder,0,0,0,0,197,5,45,0,24,13,37,160,119,279,289,289,10,0,10,2.13636,0.0909091,16.9091,97.8947,22,0
West Indies,176,217.33,7.15909,0.3125,225.278,7.57386,0.380682,827,SP Narine,0,0,0,0,197,5,45,0,24,13,37,160,119,279,289,289,10,0,10,1.05882,0,8.55882,76.378,34,1
West Indies,176,217.33,7.15909,0.3125,225.278,7.57386,0.380682,827,V Permaul,0,0,0,0,197,5,45,0,24,13,37,160,119,279,289,289,10,0,10,0.333333,0,3.66667,50,3,3
West Indies,176,217.33,7.15909,0.3125,225.278,7.57386,0.380682,828,DJG Sammy,4,0,4,10,185,4,17,1,30,25,55,130,127,257,0,263,6,0,10,2.25,0.09,18.25,95.8005,100,0
West Indies,176,217.33,7.15909,0.3125,225.278,7.57386,0.380682,828,DM Bravo,29,14,15,43,185,4,17,1,30,25,55,130,127,257,0,263,6,0,10,3,0.226667,28.52,67.4551,75,4
India,259,242.378,7.15058,0.339768,244.568,7.12741,0.30888,828,RA Jadeja,1,0,1,6,225,4,25,1,4,2,6,144,112,256,264,266,10,1,10,2.12941,0.117647,21.7529,82.4342,85,4
India,259,242.378,7.15058,0.339768,244.568,7.12741,0.30888,828,MS Dhoni,18,8,10,21,225,4,25,1,4,2,6,144,112,256,264,266,10,1,10,3.47872,0.292553,36.7713,84.1612,188,4
Pakistan,211,222.621,7.38389,0.393365,235.517,7.54976,0.336493,829,Bilawal Bhatti,26,14,12,18,139,7,30,0,26,15,41,82,128,210,0,218,8,0,10,1.71429,0,12.5714,114.286,7,0
Pakistan,211,222.621,7.38389,0.393365,235.517,7.54976,0.336493,829,Anwar Ali,18,8,10,39,139,7,30,0,26,15,41,82,128,210,0,218,8,0,10,2.14286,0,18.5714,82.2785,14,1
Pakistan,211,222.621,7.38389,0.393365,235.517,7.54976,0.336493,829,Saeed Ajmal,0,0,0,0,139,7,30,0,26,15,41,82,128,210,0,218,8,0,10,0.34375,0,4.60938,58.3004,64,3
Pakistan,211,222.621,7.38389,0.393365,235.517,7.54976,0.336493,829,Junaid Khan,0,0,0,0,139,7,30,0,26,15,41,82,128,210,0,218,8,0,10,0.210526,0,2.84211,47.7876,19,3
South Africa,190,234.274,7.4,0.373684,232.363,7.33158,0.342105,829,DW Steyn,5,0,5,22,155,7,24,1,10,4,14,94,99,193,219,195,2,1,10,0.75,0,6.52273,61.588,44,1
South Africa,190,234.274,7.4,0.373684,232.363,7.33158,0.342105,829,M Morkel,13,10,3,9,155,7,24,1,10,4,14,94,99,193,219,195,2,1,10,0.6,0,5.28571,72.2656,35,1
Pakistan,211,222.621,7.38389,0.393365,235.517,7.54976,0.336493,831,Misbah-ul-Haq,65,16,49,102,128,7,23,2,12,2,14,78,87,165,0,179,14,0,10,2.95238,0.285714,34.9921,71.8195,126,4
Pakistan,211,222.621,7.38389,0.393365,235.517,7.54976,0.336493,831,Saeed Ajmal,0,0,0,1,128,7,23,2,12,2,14,78,87,165,0,179,14,0,10,0.34375,0,4.60938,58.3004,64,3
Sri Lanka,244,223.373,7.09016,0.344262,227.578,7.47541,0.385246,833,KC Sangakkara,119,48,71,113,183,4,58,0,24,17,41,134,148,282,0,289,7,0,10,4.33659,0.360976,41.9854,80.6276,205,4
Sri Lanka,244,223.373,7.09016,0.344262,227.578,7.47541,0.385246,833,AD Mathews,37,22,15,25,183,4,58,0,24,17,41,134,148,282,0,289,7,0,10,2.64122,0.198473,28.6794,82.3362,131,4
Sri Lanka,244,223.373,7.09016,0.344262,227.578,7.47541,0.385246,833,NLTC Perera,0,0,0,0,183,4,58,0,24,17,41,134,148,282,0,289,7,0,10,1.65333,0.0666667,14.32,105.397,75,0
Sri Lanka,244,223.373,7.09016,0.344262,227.578,7.47541,0.385246,833,KDK Vithanage,0,0,0,0,183,4,58,0,24,17,41,134,148,282,0,289,7,0,10,1.83333,0,12.3333,80.4348,6,1
Bangladesh,160,218.438,7.70625,0.4,211.106,7.05,0.325,834,Sohag Gazi,1,0,1,1,177,5,16,2,26,12,38,98,133,231,0,240,9,1,10,1.46667,0,12.1333,87.9227,15,0
Bangladesh,160,218.438,7.70625,0.4,211.106,7.05,0.325,834,Shafiul Islam,0,0,0,2,177,5,16,2,26,12,38,98,133,231,0,240,9,1,10,0.535714,0,4.42857,57.6744,28,3
Bangladesh,160,218.438,7.70625,0.4,211.106,7.05,0.325,834,Arafat Sunny,0,0,0,0,177,5,16,2,26,12,38,98,133,231,0,240,9,1,10,0.5,0,4.7,50,10,3
Sri Lanka,244,223.373,7.09016,0.344262,227.578,7.47541,0.385246,834,AD Mathews,11,0,11,19,197,3,25,1,10,7,17,104,135,239,241,246,7,0,10,2.64122,0.198473,28.6794,82.3362,131,4
Sri Lanka,244,223.373,7.09016,0.344262,227.578,7.47541,0.385246,834,SMA Priyanjan,14,12,2,11,197,3,25,1,10,7,17,104,135,239,241,246,7,0,10,2.5,0.1,20.95,78.6116,20,4
Ireland,55,219.527,7.65455,0.290909,202.727,7.56364,0.4,838,GC Wilson,54,12,42,88,140,6,26,0,8,16,24,60,130,190,0,202,12,0,10,2.22727,0.227273,22,78.1906,22,4
Ireland,55,219.527,7.65455,0.290909,202.727,7.56364,0.4,838,SR Thompson,21,8,13,26,140,6,26,0,8,16,24,60,130,190,0,202,12,0,10,1.16667,0,12,88.8889,6,0
Ireland,55,219.527,7.65455,0.290909,202.727,7.56364,0.4,838,MC Sorensen,0,0,0,0,140,6,26,0,8,16,24,60,130,190,0,202,12,0,10,2,0,15.75,84,4,1
Ireland,55,219.527,7.65455,0.290909,202.727,7.56364,0.4,838,GH Dockrell,0,0,0,0,140,6,26,0,8,16,24,60,130,190,0,202,12,0,10,0.875,0,9.0625,69.7115,16,1
Ireland,55,219.527,7.65455,0.290909,202.727,7.56364,0.4,838,TJ Murtagh,0,0,0,0,140,6,26,0,8,16,24,60,130,190,0,202,12,0,10,1,0,8.2,93.1818,5,0
Sri Lanka,244,223.373,7.09016,0.344262,227.578,7.47541,0.385246,839,KMDN Kulasekara,17,10,7,17,129,6,27,1,26,18,44,96,104,200,0,219,19,0,10,1.21,0.04,11.8,80.9328,100,1
Sri Lanka,244,223.373,7.09016,0.344262,227.578,7.47541,0.385246,839,SMSM Senanayake,2,0,2,12,129,6,27,1,26,18,44,96,104,200,0,219,19,0,10,1.0625,0,8.625,87.0662,32,1
Sri Lanka,244,223.373,7.09016,0.344262,227.578,7.47541,0.385246,839,BAW Mendis,0,0,0,0,129,6,27,1,26,18,44,96,104,200,0,219,19,0,10,0.447368,0,4.47368,66.4062,38,1
Sri Lanka,244,223.373,7.09016,0.344262,227.578,7.47541,0.385246,840,LD Chandimal,2,0,2,5,217,4,21,2,16,24,40,128,150,278,0,296,18,0,10,2.18478,0.184783,25.7391,73.8615,92,4
Sri Lanka,244,223.373,7.09016,0.344262,227.578,7.47541,0.385246,840,AD Mathews,32,18,14,35,217,4,21,2,16,24,40,128,150,278,0,296,18,0,10,2.64122,0.198473,28.6794,82.3362,131,4
Pakistan,211,222.621,7.38389,0.393365,235.517,7.54976,0.336493,840,Bilawal Bhatti,1,0,1,2,203,4,38,3,16,14,30,140,131,271,297,284,13,0,10,1.71429,0,12.5714,114.286,7,0
Pakistan,211,222.621,7.38389,0.393365,235.517,7.54976,0.336493,840,Umar Gul,0,0,0,0,203,4,38,3,16,14,30,140,131,271,297,284,13,0,10,0.77193,0,7.14035,68.2886,57,1
Pakistan,211,222.621,7.38389,0.393365,235.517,7.54976,0.336493,840,Saeed Ajmal,0,0,0,0,203,4,38,3,16,14,30,140,131,271,297,284,13,0,10,0.34375,0,4.60938,58.3004,64,3
Pakistan,211,222.621,7.38389,0.393365,235.517,7.54976,0.336493,840,Junaid Khan,0,0,0,0,203,4,38,3,16,14,30,140,131,271,297,284,13,0,10,0.210526,0,2.84211,47.7876,19,3
Bangladesh,160,218.438,7.70625,0.4,211.106,7.05,0.325,841,Mushfiqur Rahim,97,32,65,109,193,3,26,1,22,20,42,116,145,261,0,279,18,1,10,2.61111,0.18254,27.7778,75.2526,126,4
Bangladesh,160,218.438,7.70625,0.4,211.106,7.05,0.325,841,Nasir Hossain,1,0,1,3,193,3,26,1,22,20,42,116,145,261,0,279,18,1,10,2.75,0.159091,27.0455,79.3863,44,4
Bangladesh,160,218.438,7.70625,0.4,211.106,7.05,0.325,841,Ziaur Rahman,0,0,0,0,193,3,26,1,22,20,42,116,145,261,0,279,18,1,10,1.2,0,8.3,91.2088,10,0
Bangladesh,160,218.438,7.70625,0.4,211.106,7.05,0.325,841,Sohag Gazi,0,0,0,0,193,3,26,1,22,20,42,116,145,261,0,279,18,1,10,1.46667,0,12.1333,87.9227,15,0
Bangladesh,160,218.438,7.70625,0.4,211.106,7.05,0.325,841,Mashrafe Mortaza,0,0,0,0,193,3,26,1,22,20,42,116,145,261,0,279,18,1,10,1.27536,0,11.1594,76.9231,69,1
India,259,242.378,7.15058,0.339768,244.568,7.12741,0.30888,841,AM Rahane,67,30,37,77,208,2,44,0,4,13,17,140,129,269,280,280,11,0,10,3.55738,0.262295,32.2295,78.0159,61,4
India,259,242.378,7.15058,0.339768,244.568,7.12741,0.30888,841,V Kohli,136,76,60,128,208,2,44,0,4,13,17,140,129,269,280,280,11,0,10,4.66456,0.379747,44.9937,88.3325,158,4
India,259,242.378,7.15058,0.339768,244.568,7.12741,0.30888,841,AT Rayudu,0,0,0,0,208,2,44,0,4,13,17,140,129,269,280,280,11,0,10,3.38462,0.269231,35.6923,76.0656,26,4
India,259,242.378,7.15058,0.339768,244.568,7.12741,0.30888,841,KD Karthik,0,0,0,0,208,2,44,0,4,13,17,140,129,269,280,280,11,0,10,2.46429,0.107143,21.6786,71.8769,56,1
India,259,242.378,7.15058,0.339768,244.568,7.12741,0.30888,843,RA Jadeja,14,6,8,13,197,5,23,2,16,17,33,98,155,253,0,264,11,0,10,2.12941,0.117647,21.7529,82.4342,85,4
India,259,242.378,7.15058,0.339768,244.568,7.12741,0.30888,843,R Ashwin,7,4,3,7,197,5,23,2,16,17,33,98,155,253,0,264,11,0,10,1.16364,0.0181818,11.9455,84.7742,55,1
India,259,242.378,7.15058,0.339768,244.568,7.12741,0.30888,843,B Kumar,0,0,0,0,197,5,23,2,16,17,33,98,155,253,0,264,11,0,10,0.75,0,7.39286,72.1254,28,1
India,259,242.378,7.15058,0.339768,244.568,7.12741,0.30888,843,Mohammed Shami,0,0,0,0,197,5,23,2,16,17,33,98,155,253,0,264,11,0,10,0.684211,0,5.68421,88.5246,19,0
Sri Lanka,244,223.373,7.09016,0.344262,227.578,7.47541,0.385246,843,KC Sangakkara,72,32,40,71,183,6,30,1,26,18,44,124,133,257,265,265,8,0,10,4.33659,0.360976,41.9854,80.6276,205,4
Sri Lanka,244,223.373,7.09016,0.344262,227.578,7.47541,0.385246,843,NLTC Perera,3,0,3,8,183,6,30,1,26,18,44,124,133,257,265,265,8,0,10,1.65333,0.0666667,14.32,105.397,75,0
Sri Lanka,244,223.373,7.09016,0.344262,227.578,7.47541,0.385246,843,BAW Mendis,0,0,0,0,183,6,30,1,26,18,44,124,133,257,265,265,8,0,10,0.447368,0,4.47368,66.4062,38,1
India,259,242.378,7.15058,0.339768,244.568,7.12741,0.30888,845,AT Rayudu,57,22,35,62,160,5,33,0,28,16,44,122,115,237,0,245,8,0,10,3.38462,0.269231,35.6923,76.0656,26,4
India,259,242.378,7.15058,0.339768,244.568,7.12741,0.30888,845,RA Jadeja,19,8,11,32,160,5,33,0,28,16,44,122,115,237,0,245,8,0,10,2.12941,0.117647,21.7529,82.4342,85,4
India,259,242.378,7.15058,0.339768,244.568,7.12741,0.30888,845,R Ashwin,0,0,0,0,160,5,33,0,28,16,44,122,115,237,0,245,8,0,10,1.16364,0.0181818,11.9455,84.7742,55,1
India,259,242.378,7.15058,0.339768,244.568,7.12741,0.30888,845,Mohammed Shami,0,0,0,0,160,5,33,0,28,16,44,122,115,237,0,245,8,0,10,0.684211,0,5.68421,88.5246,19,0
India,259,242.378,7.15058,0.339768,244.568,7.12741,0.30888,845,A Mishra,0,0,0,0,160,5,33,0,28,16,44,122,115,237,0,245,8,0,10,0.375,0,3.5,42.4242,8,3
Pakistan,211,222.621,7.38389,0.393365,235.517,7.54976,0.336493,845,Shahid Afridi,2,0,2,3,164,4,23,2,32,13,45,112,120,232,246,249,17,0,10,2.72917,0.0972222,21.4097,127.766,144,0
Pakistan,211,222.621,7.38389,0.393365,235.517,7.54976,0.336493,845,Umar Gul,0,0,0,2,164,4,23,2,32,13,45,112,120,232,246,249,17,0,10,0.77193,0,7.14035,68.2886,57,1
Pakistan,211,222.621,7.38389,0.393365,235.517,7.54976,0.336493,845,Saeed Ajmal,0,0,0,0,164,4,23,2,32,13,45,112,120,232,246,249,17,0,10,0.34375,0,4.60938,58.3004,64,3
Pakistan,211,222.621,7.38389,0.393365,235.517,7.54976,0.336493,845,Junaid Khan,0,0,0,0,164,4,23,2,32,13,45,112,120,232,246,249,17,0,10,0.210526,0,2.84211,47.7876,19,3
Bangladesh,160,218.438,7.70625,0.4,211.106,7.05,0.325,848,Ziaur Rahman,2,0,2,2,141,5,30,1,4,12,16,62,125,187,0,204,17,1,10,1.2,0,8.3,91.2088,10,0
Bangladesh,160,218.438,7.70625,0.4,211.106,7.05,0.325,848,Nasir Hossain,26,4,22,44,141,5,30,1,4,12,16,62,125,187,0,204,17,1,10,2.75,0.159091,27.0455,79.3863,44,4
Bangladesh,160,218.438,7.70625,0.4,211.106,7.05,0.325,848,Arafat Sunny,0,0,0,0,141,5,30,1,4,12,16,62,125,187,0,204,17,1,10,0.5,0,4.7,50,10,3
Bangladesh,160,218.438,7.70625,0.4,211.106,7.05,0.325,848,Rubel Hossain,0,0,0,0,141,5,30,1,4,12,16,62,125,187,0,204,17,1,10,0.32,0,2.68,52.3438,25,3
Sri Lanka,244,223.373,7.09016,0.344262,227.578,7.47541,0.385246,848,AD Mathews,61,30,31,93,150,6,23,0,8,18,26,82,117,199,205,208,9,0,10,2.64122,0.198473,28.6794,82.3362,131,4
Sri Lanka,244,223.373,7.09016,0.344262,227.578,7.47541,0.385246,848,NLTC Perera,9,0,9,17,150,6,23,0,8,18,26,82,117,199,205,208,9,0,10,1.65333,0.0666667,14.32,105.397,75,0
Sri Lanka,244,223.373,7.09016,0.344262,227.578,7.47541,0.385246,848,SMSM Senanayake,0,0,0,0,150,6,23,0,8,18,26,82,117,199,205,208,9,0,10,1.0625,0,8.625,87.0662,32,1
Pakistan,211,222.621,7.38389,0.393365,235.517,7.54976,0.336493,849,Umar Akmal,28,8,20,28,157,4,40,0,34,23,57,114,140,254,0,260,6,0,10,2.76842,0.2,27.5053,82.7947,95,4
Pakistan,211,222.621,7.38389,0.393365,235.517,7.54976,0.336493,849,Fawad Alam,88,36,52,121,157,4,40,0,34,23,57,114,140,254,0,260,6,0,10,1.85294,0.176471,26.5588,72.6468,34,4
Sri Lanka,244,223.373,7.09016,0.344262,227.578,7.47541,0.385246,849,AD Mathews,9,4,5,9,217,3,23,2,8,5,13,144,109,253,261,261,8,0,10,2.64122,0.198473,28.6794,82.3362,131,4
Sri Lanka,244,223.373,7.09016,0.344262,227.578,7.47541,0.385246,849,PC de Silva,0,0,0,6,217,3,23,2,8,5,13,144,109,253,261,261,8,0,10,1.4,0,12.4,73.8095,5,1
South Africa,190,234.274,7.4,0.373684,232.363,7.33158,0.342105,850,JP Duminy,10,0,10,16,218,4,25,2,4,6,10,112,141,253,0,279,26,1,10,2.3252,0.186992,29.9675,80.2351,123,4
South Africa,190,234.274,7.4,0.373684,232.363,7.33158,0.342105,850,DW Steyn,0,0,0,0,218,4,25,2,4,6,10,112,141,253,0,279,26,1,10,0.75,0,6.52273,61.588,44,1
South Africa,190,234.274,7.4,0.373684,232.363,7.33158,0.342105,850,VD Philander,4,0,4,6,218,4,25,2,4,6,10,112,141,253,0,279,26,1,10,0.8125,0,8.8125,66.5094,16,1
South Africa,190,234.274,7.4,0.373684,232.363,7.33158,0.342105,850,M Morkel,0,0,0,0,218,4,25,2,4,6,10,112,141,253,0,279,26,1,10,0.6,0,5.28571,72.2656,35,1
South Africa,190,234.274,7.4,0.373684,232.363,7.33158,0.342105,851,HM Amla,137,48,89,130,271,1,82,0,64,13,77,244,186,430,0,439,9,1,10,5.20168,0.403361,48.7899,86.9292,119,4
South Africa,190,234.274,7.4,0.373684,232.363,7.33158,0.342105,851,AB de Villiers,88,76,12,28,271,1,82,0,64,13,77,244,186,430,0,439,9,1,10,5.04969,0.403727,47.2174,98.8428,161,4
West Indies,176,217.33,7.15909,0.3125,225.278,7.57386,0.380682,851,DJG Sammy,17,8,9,28,223,6,23,1,12,9,21,134,133,267,440,291,24,0,10,2.25,0.09,18.25,95.8005,100,0
West Indies,176,217.33,7.15909,0.3125,225.278,7.57386,0.380682,851,JO Holder,8,0,8,8,223,6,23,1,12,9,21,134,133,267,440,291,24,0,10,2.13636,0.0909091,16.9091,97.8947,22,0
South Africa,190,234.274,7.4,0.373684,232.363,7.33158,0.342105,853,WD Parnell,7,0,7,11,172,5,25,1,26,20,46,110,133,243,0,262,19,1,10,1.47826,0.0434783,15.8261,74.7433,23,1
South Africa,190,234.274,7.4,0.373684,232.363,7.33158,0.342105,853,DA Miller,90,36,54,116,172,5,25,1,26,20,46,110,133,243,0,262,19,1,10,2.57353,0.132353,24.9412,97.2477,68,0
South Africa,190,234.274,7.4,0.373684,232.363,7.33158,0.342105,853,AM Phangiso,0,0,0,0,172,5,25,1,26,20,46,110,133,243,0,262,19,1,10,0.555556,0,7.33333,62.2642,9,1
South Africa,190,234.274,7.4,0.373684,232.363,7.33158,0.342105,853,KJ Abbott,0,0,0,0,172,5,25,1,26,20,46,110,133,243,0,262,19,1,10,0.6,0,6.6,58.4071,10,3
West Indies,176,217.33,7.15909,0.3125,225.278,7.57386,0.380682,853,CR Brathwaite,8,6,2,8,181,7,28,1,28,7,35,150,94,244,263,266,22,0,10,1.14286,0,10.1429,81.6092,7,1
West Indies,176,217.33,7.15909,0.3125,225.278,7.57386,0.380682,853,AD Russell,33,22,11,26,181,7,28,1,28,7,35,150,94,244,263,266,22,0,10,3.38095,0.0952381,23.2857,129.536,42,0
Australia,228,239.627,7.69737,0.372807,232.079,7.23246,0.337719,855,BJ Haddin,17,8,9,18,185,4,28,2,20,10,30,98,145,243,0,255,12,0,10,3.14737,0.147368,26.7789,81.382,95,4
Australia,228,239.627,7.69737,0.372807,232.079,7.23246,0.337719,855,MG Johnson,0,0,0,0,185,4,28,2,20,10,30,98,145,243,0,255,12,0,10,1.18519,0.0246914,10.7901,94.181,81,0
Australia,228,239.627,7.69737,0.372807,232.079,7.23246,0.337719,855,KW Richardson,0,0,0,0,185,4,28,2,20,10,30,98,145,243,0,255,12,0,10,1,0,7.5,157.895,4,2
Australia,228,239.627,7.69737,0.372807,232.079,7.23246,0.337719,856,SPD Smith,73,12,61,100,163,6,28,0,10,25,35,72,154,226,0,231,5,0,10,3.19298,0.22807,34.5614,87.0526,57,4
Australia,228,239.627,7.69737,0.372807,232.079,7.23246,0.337719,856,MA Starc,0,0,0,0,163,6,28,0,10,25,35,72,154,226,0,231,5,0,10,0.692308,0,8.46154,70.0637,13,1
Australia,228,239.627,7.69737,0.372807,232.079,7.23246,0.337719,856,JP Faulkner,17,4,13,28,163,6,28,0,10,25,35,72,154,226,0,231,5,0,10,2.88235,0.147059,24.1471,109.613,34,0
Australia,228,239.627,7.69737,0.372807,232.079,7.23246,0.337719,856,KW Richardson,0,0,0,0,163,6,28,0,10,25,35,72,154,226,0,231,5,0,10,1,0,7.5,157.895,4,2
Australia,228,239.627,7.69737,0.372807,232.079,7.23246,0.337719,856,XJ Doherty,0,0,0,0,163,6,28,0,10,25,35,72,154,226,0,231,5,0,10,0.190476,0,4.28571,52.0231,21,3
Pakistan,211,222.621,7.38389,0.393365,235.517,7.54976,0.336493,856,Anwar Ali,13,6,7,26,162,6,18,1,10,15,25,78,127,205,232,230,25,0,10,2.14286,0,18.5714,82.2785,14,1
Pakistan,211,222.621,7.38389,0.393365,235.517,7.54976,0.336493,856,Sohail Tanvir,0,0,0,3,162,6,18,1,10,15,25,78,127,205,232,230,25,0,10,1.18919,0,9.08108,81.5534,37,1
Pakistan,211,222.621,7.38389,0.393365,235.517,7.54976,0.336493,856,Zulfiqar Babar,0,0,0,0,162,6,18,1,10,15,25,78,127,205,232,230,25,0,10,0.6,0,7,87.5,5,0
Pakistan,211,222.621,7.38389,0.393365,235.517,7.54976,0.336493,856,Mohammad Irfan,0,0,0,0,162,6,18,1,10,15,25,78,127,205,232,230,25,0,10,0.233333,0,1.56667,30.9211,30,3
South Africa,190,234.274,7.4,0.373684,232.363,7.33158,0.342105,860,DA Miller,5,0,5,8,215,3,18,2,28,24,52,110,175,285,0,304,19,0,10,2.57353,0.132353,24.9412,97.2477,68,0
South Africa,190,234.274,7.4,0.373684,232.363,7.33158,0.342105,860,R McLaren,1,0,1,1,215,3,18,2,28,24,52,110,175,285,0,304,19,0,10,1.2,0.025,11.975,69.8251,40,1
Sri Lanka,244,223.373,7.09016,0.344262,227.578,7.47541,0.385246,861,SMA Priyanjan,12,4,8,9,197,4,32,1,14,11,25,92,162,254,0,267,13,1,10,2.5,0.1,20.95,78.6116,20,4
Sri Lanka,244,223.373,7.09016,0.344262,227.578,7.47541,0.385246,861,AD Mathews,33,10,23,37,197,4,32,1,14,11,25,92,162,254,0,267,13,1,10,2.64122,0.198473,28.6794,82.3362,131,4
Sri Lanka,244,223.373,7.09016,0.344262,227.578,7.47541,0.385246,861,KMDN Kulasekara,0,0,0,0,197,4,32,1,14,11,25,92,162,254,0,267,13,1,10,1.21,0.04,11.8,80.9328,100,1
Sri Lanka,244,223.373,7.09016,0.344262,227.578,7.47541,0.385246,861,SMSM Senanayake,0,0,0,0,197,4,32,1,14,11,25,92,162,254,0,267,13,1,10,1.0625,0,8.625,87.0662,32,1
Sri Lanka,244,223.373,7.09016,0.344262,227.578,7.47541,0.385246,861,BAW Mendis,0,0,0,0,197,4,32,1,14,11,25,92,162,254,0,267,13,1,10,0.447368,0,4.47368,66.4062,38,1
Sri Lanka,244,223.373,7.09016,0.344262,227.578,7.47541,0.385246,861,SL Malinga,0,0,0,0,197,4,32,1,14,11,25,92,162,254,0,267,13,1,10,0.617284,0.0123457,4.97531,74.6296,81,1
South Africa,190,234.274,7.4,0.373684,232.363,7.33158,0.342105,862,AB de Villiers,83,48,35,61,240,2,32,1,34,17,51,164,159,323,0,339,16,0,10,5.04969,0.403727,47.2174,98.8428,161,4
South Africa,190,234.274,7.4,0.373684,232.363,7.33158,0.342105,862,JP Duminy,9,0,9,12,240,2,32,1,34,17,51,164,159,323,0,339,16,0,10,2.3252,0.186992,29.9675,80.2351,123,4
South Africa,190,234.274,7.4,0.373684,232.363,7.33158,0.342105,862,R McLaren,0,0,0,0,240,2,32,1,34,17,51,164,159,323,0,339,16,0,10,1.2,0.025,11.975,69.8251,40,1
South Africa,190,234.274,7.4,0.373684,232.363,7.33158,0.342105,862,DA Miller,0,0,0,0,240,2,32,1,34,17,51,164,159,323,0,339,16,0,10,2.57353,0.132353,24.9412,97.2477,68,0
Bangladesh,160,218.438,7.70625,0.4,211.106,7.05,0.325,863,Anamul Haque,83,30,53,125,145,5,28,0,20,13,33,82,124,206,0,217,11,0,10,4.12,0.24,36.8,69.6442,25,4
Bangladesh,160,218.438,7.70625,0.4,211.106,7.05,0.325,863,Nasir Hossain,24,8,16,35,145,5,28,0,20,13,33,82,124,206,0,217,11,0,10,2.75,0.159091,27.0455,79.3863,44,4
Bangladesh,160,218.438,7.70625,0.4,211.106,7.05,0.325,863,Sohag Gazi,0,0,0,0,145,5,28,0,20,13,33,82,124,206,0,217,11,0,10,1.46667,0,12.1333,87.9227,15,0
Bangladesh,160,218.438,7.70625,0.4,211.106,7.05,0.325,863,Mashrafe Mortaza,0,0,0,0,145,5,28,0,20,13,33,82,124,206,0,217,11,0,10,1.27536,0,11.1594,76.9231,69,1
West Indies,176,217.33,7.15909,0.3125,225.278,7.57386,0.380682,864,KA Pollard,20,10,10,16,160,4,37,0,20,15,35,102,130,232,0,247,15,1,10,2.70513,0.115385,24.5,88.0645,78,4
West Indies,176,217.33,7.15909,0.3125,225.278,7.57386,0.380682,864,LMP Simmons,32,12,20,49,160,4,37,0,20,15,35,102,130,232,0,247,15,1,10,3.3125,0.28125,30.5938,71.4338,64,4
West Indies,176,217.33,7.15909,0.3125,225.278,7.57386,0.380682,864,DJ Bravo,0,0,0,0,160,4,37,0,20,15,35,102,130,232,0,247,15,1,10,2.35514,0.11215,23.1589,80.9011,107,4
West Indies,176,217.33,7.15909,0.3125,225.278,7.57386,0.380682,864,SP Narine,0,0,0,0,160,4,37,0,20,15,35,102,130,232,0,247,15,1,10,1.05882,0,8.55882,76.378,34,1
West Indies,176,217.33,7.15909,0.3125,225.278,7.57386,0.380682,864,JO Holder,0,0,0,0,160,4,37,0,20,15,35,102,130,232,0,247,15,1,10,2.13636,0.0909091,16.9091,97.8947,22,0
South Africa,190,234.274,7.4,0.373684,232.363,7.33158,0.342105,865,AB de Villiers,4,0,4,4,196,1,30,1,42,19,61,122,165,287,0,309,22,0,10,5.04969,0.403727,47.2174,98.8428,161,4
South Africa,190,234.274,7.4,0.373684,232.363,7.33158,0.342105,865,HM Amla,100,26,74,125,196,1,30,1,42,19,61,122,165,287,0,309,22,0,10,5.20168,0.403361,48.7899,86.9292,119,4
South Africa,190,234.274,7.4,0.373684,232.363,7.33158,0.342105,865,JP Duminy,0,0,0,0,196,1,30,1,42,19,61,122,165,287,0,309,22,0,10,2.3252,0.186992,29.9675,80.2351,123,4
Zimbabwe,142,212.077,7.5,0.380282,227.704,6.97887,0.316901,865,P Utseya,1,0,1,2,180,5,14,3,0,13,13,88,119,207,310,216,9,1,10,0.842105,0.0263158,11.8289,55.8385,76,3
Zimbabwe,142,212.077,7.5,0.380282,227.704,6.97887,0.316901,865,E Chigumbura,28,12,16,49,180,5,14,3,0,13,13,88,119,207,310,216,9,1,10,2.28947,0.114035,22.7895,77.7844,114,4
Zimbabwe,142,212.077,7.5,0.380282,227.704,6.97887,0.316901,865,J Nyumbu,0,0,0,0,180,5,14,3,0,13,13,88,119,207,310,216,9,1,10,0.153846,0,3.46154,50,13,3
South Africa,190,234.274,7.4,0.373684,232.363,7.33158,0.342105,866,WD Parnell,15,4,11,19,193,6,20,1,12,18,30,84,159,243,0,257,14,0,10,1.47826,0.0434783,15.8261,74.7433,23,1
South Africa,190,234.274,7.4,0.373684,232.363,7.33158,0.342105,866,KJ Abbott,4,0,4,10,193,6,20,1,12,18,30,84,159,243,0,257,14,0,10,0.6,0,6.6,58.4071,10,3
South Africa,190,234.274,7.4,0.373684,232.363,7.33158,0.342105,866,AM Phangiso,0,0,0,0,193,6,20,1,12,18,30,84,159,243,0,257,14,0,10,0.555556,0,7.33333,62.2642,9,1
Zimbabwe,142,212.077,7.5,0.380282,227.704,6.97887,0.316901,866,J Nyumbu,14,10,4,11,116,7,30,1,28,5,33,96,83,179,258,196,17,1,10,0.153846,0,3.46154,50,13,3
Zimbabwe,142,212.077,7.5,0.380282,227.704,6.97887,0.316901,866,N Madziva,16,8,8,27,116,7,30,1,28,5,33,96,83,179,258,196,17,1,10,0.714286,0,7,50.5155,7,3
Zimbabwe,142,212.077,7.5,0.380282,227.704,6.97887,0.316901,866,BV Vitori,0,0,0,0,116,7,30,1,28,5,33,96,83,179,258,196,17,1,10,0.9,0,6.3,86.3014,10,1
Australia,228,239.627,7.69737,0.372807,232.079,7.23246,0.337719,868,MR Marsh,83,46,37,82,197,3,77,0,44,17,61,198,137,335,0,350,15,0,10,3.61538,0.269231,32.2308,95.3356,26,0
Australia,228,239.627,7.69737,0.372807,232.079,7.23246,0.337719,868,GJ Maxwell,64,46,18,33,197,3,77,0,44,17,61,198,137,335,0,350,15,0,10,3.79245,0.226415,28.2264,119.68,53,0
Australia,228,239.627,7.69737,0.372807,232.079,7.23246,0.337719,868,SPD Smith,0,0,0,0,197,3,77,0,44,17,61,198,137,335,0,350,15,0,10,3.19298,0.22807,34.5614,87.0526,57,4
Australia,228,239.627,7.69737,0.372807,232.079,7.23246,0.337719,868,JP Faulkner,0,0,0,0,197,3,77,0,44,17,61,198,137,335,0,350,15,0,10,2.88235,0.147059,24.1471,109.613,34,0
Australia,228,239.627,7.69737,0.372807,232.079,7.23246,0.337719,868,MG Johnson,0,0,0,0,197,3,77,0,44,17,61,198,137,335,0,350,15,0,10,1.18519,0.0246914,10.7901,94.181,81,0
Australia,228,239.627,7.69737,0.372807,232.079,7.23246,0.337719,869,SPD Smith,7,0,7,7,216,3,32,3,32,24,56,146,158,304,0,327,23,0,10,3.19298,0.22807,34.5614,87.0526,57,4
Australia,228,239.627,7.69737,0.372807,232.079,7.23246,0.337719,869,JP Faulkner,1,0,1,3,216,3,32,3,32,24,56,146,158,304,0,327,23,0,10,2.88235,0.147059,24.1471,109.613,34,0
Australia,228,239.627,7.69737,0.372807,232.079,7.23246,0.337719,869,MG Johnson,0,0,0,0,216,3,32,3,32,24,56,146,158,304,0,327,23,0,10,1.18519,0.0246914,10.7901,94.181,81,0
South Africa,190,234.274,7.4,0.373684,232.363,7.33158,0.342105,869,JP Duminy,24,6,18,24,267,3,35,0,8,8,16,140,178,318,328,328,10,0,10,2.3252,0.186992,29.9675,80.2351,123,4
South Africa,190,234.274,7.4,0.373684,232.363,7.33158,0.342105,869,AB de Villiers,129,52,77,106,267,3,35,0,8,8,16,140,178,318,328,328,10,0,10,5.04969,0.403727,47.2174,98.8428,161,4
South Africa,190,234.274,7.4,0.373684,232.363,7.33158,0.342105,870,AM Phangiso,2,0,2,4,172,7,15,2,12,18,30,72,145,217,0,231,14,0,10,0.555556,0,7.33333,62.2642,9,1
South Africa,190,234.274,7.4,0.373684,232.363,7.33158,0.342105,870,Imran Tahir,4,0,4,6,172,7,15,2,12,18,30,72,145,217,0,231,14,0,10,0.625,0,5.0625,65.8537,16,1
Australia,228,239.627,7.69737,0.372807,232.079,7.23246,0.337719,871,BCJ Cutting,3,0,3,8,130,5,21,2,36,17,53,76,128,204,0,209,5,0,10,2.5,0,26.5,79.1045,2,4
Australia,228,239.627,7.69737,0.372807,232.079,7.23246,0.337719,871,BJ Haddin,27,10,17,53,130,5,21,2,36,17,53,76,128,204,0,209,5,0,10,3.14737,0.147368,26.7789,81.382,95,4
Australia,228,239.627,7.69737,0.372807,232.079,7.23246,0.337719,871,NM Lyon,0,0,0,0,130,5,21,2,36,17,53,76,128,204,0,209,5,0,10,0.666667,0,4,133.333,3,0
Zimbabwe,142,212.077,7.5,0.380282,227.704,6.97887,0.316901,871,E Chigumbura,49,16,33,62,144,7,26,0,10,7,17,88,99,187,210,211,24,1,10,2.28947,0.114035,22.7895,77.7844,114,4
Zimbabwe,142,212.077,7.5,0.380282,227.704,6.97887,0.316901,871,P Utseya,16,4,12,21,144,7,26,0,10,7,17,88,99,187,210,211,24,1,10,0.842105,0.0263158,11.8289,55.8385,76,3
Australia,228,239.627,7.69737,0.372807,232.079,7.23246,0.337719,872,BJ Haddin,10,4,6,13,173,4,30,1,54,14,68,130,141,271,0,282,11,0,10,3.14737,0.147368,26.7789,81.382,95,4
Australia,228,239.627,7.69737,0.372807,232.079,7.23246,0.337719,872,MR Marsh,22,8,14,27,173,4,30,1,54,14,68,130,141,271,0,282,11,0,10,3.61538,0.269231,32.2308,95.3356,26,0
Australia,228,239.627,7.69737,0.372807,232.079,7.23246,0.337719,872,MG Johnson,0,0,0,0,173,4,30,1,54,14,68,130,141,271,0,282,11,0,10,1.18519,0.0246914,10.7901,94.181,81,0
Australia,228,239.627,7.69737,0.372807,232.079,7.23246,0.337719,872,MA Starc,0,0,0,0,173,4,30,1,54,14,68,130,141,271,0,282,11,0,10,0.692308,0,8.46154,70.0637,13,1
South Africa,190,234.274,7.4,0.373684,232.363,7.33158,0.342105,873,JP Duminy,43,8,35,57,174,4,31,0,36,19,55,102,158,260,0,271,11,0,10,2.3252,0.186992,29.9675,80.2351,123,4
South Africa,190,234.274,7.4,0.373684,232.363,7.33158,0.342105,873,F du Plessis,94,22,72,132,174,4,31,0,36,19,55,102,158,260,0,271,11,0,10,3.45122,0.292683,34.9268,83.135,82,4
South Africa,190,234.274,7.4,0.373684,232.363,7.33158,0.342105,873,DA Miller,0,0,0,0,174,4,31,0,36,19,55,102,158,260,0,271,11,0,10,2.57353,0.132353,24.9412,97.2477,68,0
South Africa,190,234.274,7.4,0.373684,232.363,7.33158,0.342105,873,WD Parnell,0,0,0,0,174,4,31,0,36,19,55,102,158,260,0,271,11,0,10,1.47826,0.0434783,15.8261,74.7433,23,1
Zimbabwe,142,212.077,7.5,0.380282,227.704,6.97887,0.316901,873,BRM Taylor,75,28,47,94,162,8,25,0,4,4,8,70,125,195,272,208,13,1,10,3.3,0.26,33.56,76.3421,100,4
Zimbabwe,142,212.077,7.5,0.380282,227.704,6.97887,0.316901,873,J Nyumbu,0,0,0,0,162,8,25,0,4,4,8,70,125,195,272,208,13,1,10,0.153846,0,3.46154,50,13,3
Zimbabwe,142,212.077,7.5,0.380282,227.704,6.97887,0.316901,873,TL Chatara,10,4,6,18,162,8,25,0,4,4,8,70,125,195,272,208,13,1,10,0.705882,0,5.82353,57.2254,17,3
New Zealand,184,233.745,7.39674,0.36413,227.951,7.30435,0.353261,876,DL Vettori,19,4,15,22,157,6,36,0,16,23,39,94,138,232,0,246,14,0,10,1.43662,0.028169,15.7606,86.0108,71,0
New Zealand,184,233.745,7.39674,0.36413,227.951,7.30435,0.353261,876,NL McCullum,0,0,0,0,157,6,36,0,16,23,39,94,138,232,0,246,14,0,10,1.63934,0.0655738,17.377,85.622,61,0
New Zealand,184,233.745,7.39674,0.36413,227.951,7.30435,0.353261,876,LRPL Taylor,87,34,53,126,157,6,36,0,16,23,39,94,138,232,0,246,14,0,10,3.68382,0.301471,36.7206,79.3959,136,4
Pakistan,211,222.621,7.38389,0.393365,235.517,7.54976,0.336493,876,Haris Sohail,67,18,49,98,166,6,30,0,22,19,41,100,137,237,247,250,13,0,10,3.25,0.3,35.2,80.8266,20,4
Pakistan,211,222.621,7.38389,0.393365,235.517,7.54976,0.336493,876,Shahid Afridi,47,24,23,45,166,6,30,0,22,19,41,100,137,237,247,250,13,0,10,2.72917,0.0972222,21.4097,127.766,144,0
Pakistan,211,222.621,7.38389,0.393365,235.517,7.54976,0.336493,876,Wahab Riaz,0,0,0,0,166,6,30,0,22,19,41,100,137,237,247,250,13,0,10,1.29167,0.0416667,10.9792,79.1291,48,1
Pakistan,211,222.621,7.38389,0.393365,235.517,7.54976,0.336493,877,Sarfraz Ahmed,16,0,16,23,188,6,32,2,8,13,21,114,127,241,0,252,11,0,10,2.04878,0.097561,25.4878,83.9357,41,4
Pakistan,211,222.621,7.38389,0.393365,235.517,7.54976,0.336493,877,Sohail Tanvir,0,0,0,0,188,6,32,2,8,13,21,114,127,241,0,252,11,0,10,1.18919,0,9.08108,81.5534,37,1
New Zealand,184,233.745,7.39674,0.36413,227.951,7.30435,0.353261,877,DL Vettori,11,8,3,5,194,5,41,1,0,4,4,130,109,239,253,255,16,0,10,1.43662,0.028169,15.7606,86.0108,71,0
New Zealand,184,233.745,7.39674,0.36413,227.951,7.30435,0.353261,877,KS Williamson,68,28,40,88,194,5,41,1,0,4,4,130,109,239,253,255,16,0,10,4.31707,0.390244,43.0488,82.8833,82,4
Pakistan,211,222.621,7.38389,0.393365,235.517,7.54976,0.336493,878,Shahid Afridi,45,38,7,21,233,4,55,1,38,19,57,214,131,345,0,364,19,0,10,2.72917,0.0972222,21.4097,127.766,144,0
Pakistan,211,222.621,7.38389,0.393365,235.517,7.54976,0.336493,878,Umar Akmal,0,0,0,0,233,4,55,1,38,19,57,214,131,345,0,364,19,0,10,2.76842,0.2,27.5053,82.7947,95,4
Pakistan,211,222.621,7.38389,0.393365,235.517,7.54976,0.336493,878,Sarfraz Ahmed,0,0,0,0,233,4,55,1,38,19,57,214,131,345,0,364,19,0,10,2.04878,0.097561,25.4878,83.9357,41,4
Pakistan,211,222.621,7.38389,0.393365,235.517,7.54976,0.336493,878,Sohail Tanvir,0,0,0,0,233,4,55,1,38,19,57,214,131,345,0,364,19,0,10,1.18919,0,9.08108,81.5534,37,1
New Zealand,184,233.745,7.39674,0.36413,227.951,7.30435,0.353261,879,KS Williamson,84,28,56,84,199,3,38,1,20,29,49,118,168,286,0,299,13,0,10,4.31707,0.390244,43.0488,82.8833,82,4
New Zealand,184,233.745,7.39674,0.36413,227.951,7.30435,0.353261,879,TWM Latham,4,0,4,4,199,3,38,1,20,29,49,118,168,286,0,299,13,0,10,2.76471,0.147059,25.3529,75.2182,34,4
Pakistan,211,222.621,7.38389,0.393365,235.517,7.54976,0.336493,879,Sarfraz Ahmed,13,8,5,8,198,5,42,2,16,20,36,110,166,276,300,292,16,0,10,2.04878,0.097561,25.4878,83.9357,41,4
Pakistan,211,222.621,7.38389,0.393365,235.517,7.54976,0.336493,879,Sohail Tanvir,0,0,0,0,198,5,42,2,16,20,36,110,166,276,300,292,16,0,10,1.18919,0,9.08108,81.5534,37,1
Pakistan,211,222.621,7.38389,0.393365,235.517,7.54976,0.336493,879,Anwar Ali,0,0,0,0,198,5,42,2,16,20,36,110,166,276,300,292,16,0,10,2.14286,0,18.5714,82.2785,14,1
New Zealand,184,233.745,7.39674,0.36413,227.951,7.30435,0.353261,880,L Ronchi,9,4,5,10,184,2,30,1,30,21,51,100,165,265,0,275,10,0,10,2.92157,0.0784314,22.1961,115.392,51,0
New Zealand,184,233.745,7.39674,0.36413,227.951,7.30435,0.353261,880,LRPL Taylor,66,18,48,84,184,2,30,1,30,21,51,100,165,265,0,275,10,0,10,3.68382,0.301471,36.7206,79.3959,136,4
New Zealand,184,233.745,7.39674,0.36413,227.951,7.30435,0.353261,880,TWM Latham,0,0,0,0,184,2,30,1,30,21,51,100,165,265,0,275,10,0,10,2.76471,0.147059,25.3529,75.2182,34,4
England,221,237.176,7.17647,0.289593,230.633,7.45701,0.384615,881,JC Buttler,105,62,43,72,284,6,54,0,48,14,62,236,164,400,0,408,8,1,10,3.47458,0.186441,29.9153,115.359,59,0
England,221,237.176,7.17647,0.289593,230.633,7.45701,0.384615,881,AU Rashid,46,24,22,36,284,6,54,0,48,14,62,236,164,400,0,408,8,1,10,2.41176,0.0588235,17.2941,108.889,17,0
England,221,237.176,7.17647,0.289593,230.633,7.45701,0.384615,881,CJ Jordan,0,0,0,0,284,6,54,0,48,14,62,236,164,400,0,408,8,1,10,0.833333,0,8.22222,84.0909,18,1
England,221,237.176,7.17647,0.289593,230.633,7.45701,0.384615,881,LE Plunkett,0,0,0,0,284,6,54,0,48,14,62,236,164,400,0,408,8,1,10,1.38095,0,13.1905,113.992,21,0
New Zealand,184,233.745,7.39674,0.36413,227.951,7.30435,0.353261,882,LRPL Taylor,89,46,43,82,276,3,60,1,26,19,45,238,143,381,0,398,17,0,10,3.68382,0.301471,36.7206,79.3959,136,4
New Zealand,184,233.745,7.39674,0.36413,227.951,7.30435,0.353261,882,L Ronchi,33,26,7,15,276,3,60,1,26,19,45,238,143,381,0,398,17,0,10,2.92157,0.0784314,22.1961,115.392,51,0
New Zealand,184,233.745,7.39674,0.36413,227.951,7.30435,0.353261,882,MJ Santner,0,0,0,0,276,3,60,1,26,19,45,238,143,381,0,398,17,0,10,3,0,26.7273,102.083,11,0
England,221,237.176,7.17647,0.289593,230.633,7.45701,0.384615,882,ST Finn,0,0,0,0,300,7,46,2,4,5,9,220,135,355,399,365,10,1,10,0.583333,0,5.41667,59.633,24,3
England,221,237.176,7.17647,0.289593,230.633,7.45701,0.384615,882,CJ Jordan,0,0,0,0,300,7,46,2,4,5,9,220,135,355,399,365,10,1,10,0.833333,0,8.22222,84.0909,18,1
New Zealand,184,233.745,7.39674,0.36413,227.951,7.30435,0.353261,883,GD Elliott,35,20,15,42,228,3,38,2,50,15,65,192,139,331,0,349,18,0,10,2.67188,0.203125,29.4375,79.7629,64,4
New Zealand,184,233.745,7.39674,0.36413,227.951,7.30435,0.353261,883,MJ Santner,3,0,3,5,228,3,38,2,50,15,65,192,139,331,0,349,18,0,10,3,0,26.7273,102.083,11,0
New Zealand,184,233.745,7.39674,0.36413,227.951,7.30435,0.353261,883,TG Southee,0,0,0,0,228,3,38,2,50,15,65,192,139,331,0,349,18,0,10,0.764706,0,7.03922,92.7649,51,0
New Zealand,184,233.745,7.39674,0.36413,227.951,7.30435,0.353261,883,BM Wheeler,0,0,0,0,228,3,38,2,50,15,65,192,139,331,0,349,18,0,10,1.75,0,14.5,123.404,4,0
New Zealand,184,233.745,7.39674,0.36413,227.951,7.30435,0.353261,884,BM Wheeler,7,4,3,11,202,4,23,3,36,17,53,124,154,278,0,283,5,0,10,1.75,0,14.5,123.404,4,0
New Zealand,184,233.745,7.39674,0.36413,227.951,7.30435,0.353261,884,TG Southee,9,4,5,7,202,4,23,3,36,17,53,124,154,278,0,283,5,0,10,0.764706,0,7.03922,92.7649,51,0
New Zealand,184,233.745,7.39674,0.36413,227.951,7.30435,0.353261,884,MJ Henry,0,0,0,0,202,4,23,3,36,17,53,124,154,278,0,283,5,0,10,1.33333,0,9.55556,103.614,9,0
Australia,228,239.627,7.69737,0.372807,232.079,7.23246,0.337719,886,MR Marsh,20,8,12,20,210,6,41,0,26,25,51,138,164,302,0,305,3,0,10,3.61538,0.269231,32.2308,95.3356,26,0
Australia,228,239.627,7.69737,0.372807,232.079,7.23246,0.337719,886,MS Wade,40,28,12,34,210,6,41,0,26,25,51,138,164,302,0,305,3,0,10,1.86275,0.117647,20.3333,78.2642,51,1
England,221,237.176,7.17647,0.289593,230.633,7.45701,0.384615,886,ST Finn,8,0,8,14,216,7,23,2,0,2,2,128,113,241,306,246,5,1,10,0.583333,0,5.41667,59.633,24,3
Australia,228,239.627,7.69737,0.372807,232.079,7.23246,0.337719,887,MR Marsh,27,18,9,16,210,5,50,0,28,12,40,160,140,300,0,309,9,0,10,3.61538,0.269231,32.2308,95.3356,26,0
Australia,228,239.627,7.69737,0.372807,232.079,7.23246,0.337719,887,SR Watson,37,16,21,31,210,5,50,0,28,12,40,160,140,300,0,309,9,0,10,4.71318,0.286822,37.7907,90.0943,129,4
Australia,228,239.627,7.69737,0.372807,232.079,7.23246,0.337719,887,MS Wade,0,0,0,0,210,5,50,0,28,12,40,160,140,300,0,309,9,0,10,1.86275,0.117647,20.3333,78.2642,51,1
England,221,237.176,7.17647,0.289593,230.633,7.45701,0.384615,888,JM Bairstow,11,4,7,15,223,4,27,0,16,17,33,114,169,283,0,300,17,1,10,3,0.1,25.9,91.1972,10,0
England,221,237.176,7.17647,0.289593,230.633,7.45701,0.384615,888,JWA Taylor,91,16,75,106,223,4,27,0,16,17,33,114,169,283,0,300,17,1,10,3.375,0.333333,35.9167,79.8888,24,4
England,221,237.176,7.17647,0.289593,230.633,7.45701,0.384615,888,MM Ali,0,0,0,0,223,4,27,0,16,17,33,114,169,283,0,300,17,1,10,2.67647,0.117647,21.3824,94.5384,34,0
England,221,237.176,7.17647,0.289593,230.633,7.45701,0.384615,888,LE Plunkett,0,0,0,0,223,4,27,0,16,17,33,114,169,283,0,300,17,1,10,1.38095,0,13.1905,113.992,21,0
England,221,237.176,7.17647,0.289593,230.633,7.45701,0.384615,888,CR Woakes,0,0,0,0,223,4,27,0,16,17,33,114,169,283,0,300,17,1,10,1.09375,0,15.1562,76.8621,32,1
England,221,237.176,7.17647,0.289593,230.633,7.45701,0.384615,888,AU Rashid,0,0,0,0,223,4,27,0,16,17,33,114,169,283,0,300,17,1,10,2.41176,0.0588235,17.2941,108.889,17,0
Australia,228,239.627,7.69737,0.372807,232.079,7.23246,0.337719,889,JW Hastings,14,12,2,15,199,4,23,3,42,23,65,144,143,287,0,299,12,0,10,1.76923,0,13.8462,95.2381,13,0
Australia,228,239.627,7.69737,0.372807,232.079,7.23246,0.337719,889,MS Wade,5,0,5,8,199,4,23,3,42,23,65,144,143,287,0,299,12,0,10,1.86275,0.117647,20.3333,78.2642,51,1
England,221,237.176,7.17647,0.289593,230.633,7.45701,0.384615,889,LE Plunkett,17,14,3,9,228,5,41,1,10,12,22,172,119,291,300,304,13,1,10,1.38095,0,13.1905,113.992,21,0
England,221,237.176,7.17647,0.289593,230.633,7.45701,0.384615,889,MM Ali,11,6,5,13,228,5,41,1,10,12,22,172,119,291,300,304,13,1,10,2.67647,0.117647,21.3824,94.5384,34,0
England,221,237.176,7.17647,0.289593,230.633,7.45701,0.384615,889,DJ Willey,0,0,0,0,228,5,41,1,10,12,22,172,119,291,300,304,13,1,10,0.571429,0,8.28571,86.5672,7,1
Bangladesh,160,218.438,7.70625,0.4,211.106,7.05,0.325,891,Nasir Hossain,20,16,4,17,185,4,37,2,22,17,39,142,119,261,0,272,11,1,10,2.75,0.159091,27.0455,79.3863,44,4
Bangladesh,160,218.438,7.70625,0.4,211.106,7.05,0.325,891,Ziaur Rahman,0,0,0,0,185,4,37,2,22,17,39,142,119,261,0,272,11,1,10,1.2,0,8.3,91.2088,10,0
Bangladesh,160,218.438,7.70625,0.4,211.106,7.05,0.325,891,Mashrafe Mortaza,0,0,0,0,185,4,37,2,22,17,39,142,119,261,0,272,11,1,10,1.27536,0,11.1594,76.9231,69,1
Bangladesh,160,218.438,7.70625,0.4,211.106,7.05,0.325,891,Abdur Razzak,0,0,0,0,185,4,37,2,22,17,39,142,119,261,0,272,11,1,10,0.849315,0.0136986,8.39726,73.8554,73,1
Sri Lanka,244,223.373,7.09016,0.344262,227.578,7.47541,0.385246,893,NLTC Perera,20,8,12,20,190,6,32,0,44,19,63,148,137,285,0,310,25,1,10,1.65333,0.0666667,14.32,105.397,75,0
Sri Lanka,244,223.373,7.09016,0.344262,227.578,7.47541,0.385246,893,AD Mathews,80,24,56,109,190,6,32,0,44,19,63,148,137,285,0,310,25,1,10,2.64122,0.198473,28.6794,82.3362,131,4
Sri Lanka,244,223.373,7.09016,0.344262,227.578,7.47541,0.385246,893,KMDN Kulasekara,0,0,0,0,190,6,32,0,44,19,63,148,137,285,0,310,25,1,10,1.21,0.04,11.8,80.9328,100,1
Sri Lanka,244,223.373,7.09016,0.344262,227.578,7.47541,0.385246,893,SL Malinga,0,0,0,0,190,6,32,0,44,19,63,148,137,285,0,310,25,1,10,0.617284,0.0123457,4.97531,74.6296,81,1
New Zealand,184,233.745,7.39674,0.36413,227.951,7.30435,0.353261,895,L Ronchi,99,62,37,83,167,9,50,0,0,0,0,134,83,217,0,230,13,1,10,2.92157,0.0784314,22.1961,115.392,51,0
South Africa,190,234.274,7.4,0.373684,232.363,7.33158,0.342105,895,JP Duminy,44,14,30,65,155,4,38,0,26,9,35,88,140,228,231,236,8,0,10,2.3252,0.186992,29.9675,80.2351,123,4
South Africa,190,234.274,7.4,0.373684,232.363,7.33158,0.342105,895,AB de Villiers,68,20,48,75,155,4,38,0,26,9,35,88,140,228,231,236,8,0,10,5.04969,0.403727,47.2174,98.8428,161,4
South Africa,190,234.274,7.4,0.373684,232.363,7.33158,0.342105,896,JP Duminy,3,0,3,3,214,2,39,2,8,15,23,130,146,276,0,282,6,0,10,2.3252,0.186992,29.9675,80.2351,123,4
South Africa,190,234.274,7.4,0.373684,232.363,7.33158,0.342105,896,DA Miller,1,0,1,3,214,2,39,2,8,15,23,130,146,276,0,282,6,0,10,2.57353,0.132353,24.9412,97.2477,68,0
South Africa,190,234.274,7.4,0.373684,232.363,7.33158,0.342105,896,RR Rossouw,0,0,0,0,214,2,39,2,8,15,23,130,146,276,0,282,6,0,10,3.80769,0.230769,31.3846,93.1507,26,0
South Africa,190,234.274,7.4,0.373684,232.363,7.33158,0.342105,896,VD Philander,0,0,0,0,214,2,39,2,8,15,23,130,146,276,0,282,6,0,10,0.8125,0,8.8125,66.5094,16,1
South Africa,190,234.274,7.4,0.373684,232.363,7.33158,0.342105,896,DW Steyn,0,0,0,0,214,2,39,2,8,15,23,130,146,276,0,282,6,0,10,0.75,0,6.52273,61.588,44,1
South Africa,190,234.274,7.4,0.373684,232.363,7.33158,0.342105,896,Imran Tahir,0,0,0,0,214,2,39,2,8,15,23,130,146,276,0,282,6,0,10,0.625,0,5.0625,65.8537,16,1
New Zealand,184,233.745,7.39674,0.36413,227.951,7.30435,0.353261,896,L Ronchi,73,30,43,78,154,9,37,0,4,4,8,90,109,199,283,210,11,1,10,2.92157,0.0784314,22.1961,115.392,51,0
New Zealand,184,233.745,7.39674,0.36413,227.951,7.30435,0.353261,896,MJ McClenaghan,32,16,16,40,154,9,37,0,4,4,8,90,109,199,283,210,11,1,10,0.928571,0,7.71429,75.5245,14,1
Sri Lanka,244,223.373,7.09016,0.344262,227.578,7.47541,0.385246,897,DPMD Jayawardene,98,50,48,104,148,5,37,0,12,14,26,106,105,211,0,218,7,0,10,3.20833,0.244792,31.6979,79.1109,192,4
Sri Lanka,244,223.373,7.09016,0.344262,227.578,7.47541,0.385246,897,BMAJ Mendis,21,14,7,20,148,5,37,0,12,14,26,106,105,211,0,218,7,0,10,1.43243,0.027027,15.1622,82.8656,37,1
Sri Lanka,244,223.373,7.09016,0.344262,227.578,7.47541,0.385246,897,NLTC Perera,0,0,0,0,148,5,37,0,12,14,26,106,105,211,0,218,7,0,10,1.65333,0.0666667,14.32,105.397,75,0
Sri Lanka,244,223.373,7.09016,0.344262,227.578,7.47541,0.385246,897,SMSM Senanayake,0,0,0,0,148,5,37,0,12,14,26,106,105,211,0,218,7,0,10,1.0625,0,8.625,87.0662,32,1
Sri Lanka,244,223.373,7.09016,0.344262,227.578,7.47541,0.385246,897,KMDN Kulasekara,0,0,0,0,148,5,37,0,12,14,26,106,105,211,0,218,7,0,10,1.21,0.04,11.8,80.9328,100,1
Sri Lanka,244,223.373,7.09016,0.344262,227.578,7.47541,0.385246,897,RMS Eranga,0,0,0,0,148,5,37,0,12,14,26,106,105,211,0,218,7,0,10,0.444444,0,3.77778,51.5152,9,3
New Zealand,184,233.745,7.39674,0.36413,227.951,7.30435,0.353261,898,AF Milne,12,0,12,19,185,7,18,1,20,20,40,126,117,243,0,248,5,1,10,1,0,11.5455,95.4887,11,0
New Zealand,184,233.745,7.39674,0.36413,227.951,7.30435,0.353261,898,MJ Henry,0,0,0,1,185,7,18,1,20,20,40,126,117,243,0,248,5,1,10,1.33333,0,9.55556,103.614,9,0
New Zealand,184,233.745,7.39674,0.36413,227.951,7.30435,0.353261,898,TA Boult,0,0,0,0,185,7,18,1,20,20,40,126,117,243,0,248,5,1,10,0.727273,0,5.27273,77.3333,11,1
Sri Lanka,244,223.373,7.09016,0.344262,227.578,7.47541,0.385246,898,AD Mathews,25,14,11,38,196,3,31,0,12,4,16,148,95,243,249,252,9,0,10,2.64122,0.198473,28.6794,82.3362,131,4
Sri Lanka,244,223.373,7.09016,0.344262,227.578,7.47541,0.385246,898,TM Dilshan,116,68,48,125,196,3,31,0,12,4,16,148,95,243,249,252,9,0,10,4.60199,0.273632,38.3632,86.0219,201,4
Sri Lanka,244,223.373,7.09016,0.344262,227.578,7.47541,0.385246,898,HDRL Thirimanne,0,0,0,0,196,3,31,0,12,4,16,148,95,243,249,252,9,0,10,2.77778,0.246914,31.5802,71.4725,81,4
Sri Lanka,244,223.373,7.09016,0.344262,227.578,7.47541,0.385246,899,NLTC Perera,1,0,1,1,199,4,40,1,6,15,21,118,142,260,0,276,16,0,10,1.65333,0.0666667,14.32,105.397,75,0
Sri Lanka,244,223.373,7.09016,0.344262,227.578,7.47541,0.385246,899,DPMD Jayawardene,94,54,40,82,199,4,40,1,6,15,21,118,142,260,0,276,16,0,10,3.20833,0.244792,31.6979,79.1109,192,4
Sri Lanka,244,223.373,7.09016,0.344262,227.578,7.47541,0.385246,899,BMAJ Mendis,0,0,0,0,199,4,40,1,6,15,21,118,142,260,0,276,16,0,10,1.43243,0.027027,15.1622,82.8656,37,1
Sri Lanka,244,223.373,7.09016,0.344262,227.578,7.47541,0.385246,899,KMDN Kulasekara,0,0,0,0,199,4,40,1,6,15,21,118,142,260,0,276,16,0,10,1.21,0.04,11.8,80.9328,100,1
Sri Lanka,244,223.373,7.09016,0.344262,227.578,7.47541,0.385246,899,SMSM Senanayake,0,0,0,0,199,4,40,1,6,15,21,118,142,260,0,276,16,0,10,1.0625,0,8.625,87.0662,32,1
Sri Lanka,244,223.373,7.09016,0.344262,227.578,7.47541,0.385246,899,HMRKB Herath,0,0,0,0,199,4,40,1,6,15,21,118,142,260,0,276,16,0,10,0.444444,0,5.18519,61.674,27,1
New Zealand,184,233.745,7.39674,0.36413,227.951,7.30435,0.353261,899,L Ronchi,1,0,1,2,194,4,39,1,26,13,39,106,166,272,277,280,8,1,10,2.92157,0.0784314,22.1961,115.392,51,0
New Zealand,184,233.745,7.39674,0.36413,227.951,7.30435,0.353261,899,CJ Anderson,46,20,26,44,194,4,39,1,26,13,39,106,166,272,277,280,8,1,10,3.90909,0.151515,30.2424,112.514,33,0
New Zealand,184,233.745,7.39674,0.36413,227.951,7.30435,0.353261,899,DL Vettori,0,0,0,0,194,4,39,1,26,13,39,106,166,272,277,280,8,1,10,1.43662,0.028169,15.7606,86.0108,71,0
New Zealand,184,233.745,7.39674,0.36413,227.951,7.30435,0.353261,900,GD Elliott,75,22,53,84,232,5,45,0,54,22,76,206,147,353,0,360,7,1,10,2.67188,0.203125,29.4375,79.7629,64,4
New Zealand,184,233.745,7.39674,0.36413,227.951,7.30435,0.353261,900,L Ronchi,123,74,49,82,232,5,45,0,54,22,76,206,147,353,0,360,7,1,10,2.92157,0.0784314,22.1961,115.392,51,0
Sri Lanka,244,223.373,7.09016,0.344262,227.578,7.47541,0.385246,901,NLTC Perera,14,6,8,8,204,4,34,1,22,16,38,122,154,276,0,287,11,0,10,1.65333,0.0666667,14.32,105.397,75,0
Sri Lanka,244,223.373,7.09016,0.344262,227.578,7.47541,0.385246,901,KC Sangakkara,93,44,49,93,204,4,34,1,22,16,38,122,154,276,0,287,11,0,10,4.33659,0.360976,41.9854,80.6276,205,4
Sri Lanka,244,223.373,7.09016,0.344262,227.578,7.47541,0.385246,901,KMDN Kulasekara,0,0,0,0,204,4,34,1,22,16,38,122,154,276,0,287,11,0,10,1.21,0.04,11.8,80.9328,100,1
New Zealand,184,233.745,7.39674,0.36413,227.951,7.30435,0.353261,901,KD Mills,29,14,15,16,204,7,37,2,0,1,1,112,130,242,288,253,11,1,10,1.52542,0.0338983,12.8644,90.7895,59,0
New Zealand,184,233.745,7.39674,0.36413,227.951,7.30435,0.353261,901,MJ McClenaghan,5,4,1,5,204,7,37,2,0,1,1,112,130,242,288,253,11,1,10,0.928571,0,7.71429,75.5245,14,1
Pakistan,211,222.621,7.38389,0.393365,235.517,7.54976,0.336493,902,Ehsan Adil,2,0,2,5,162,6,31,3,4,0,4,118,79,197,0,210,13,0,10,0.666667,0,7.33333,66.6667,3,1
New Zealand,184,233.745,7.39674,0.36413,227.951,7.30435,0.353261,903,LRPL Taylor,61,30,31,53,249,3,54,0,40,15,55,208,150,358,0,369,11,1,10,3.68382,0.301471,36.7206,79.3959,136,4
New Zealand,184,233.745,7.39674,0.36413,227.951,7.30435,0.353261,903,GD Elliott,23,12,11,15,249,3,54,0,40,15,55,208,150,358,0,369,11,1,10,2.67188,0.203125,29.4375,79.7629,64,4
New Zealand,184,233.745,7.39674,0.36413,227.951,7.30435,0.353261,903,L Ronchi,0,0,0,0,249,3,54,0,40,15,55,208,150,358,0,369,11,1,10,2.92157,0.0784314,22.1961,115.392,51,0
New Zealand,184,233.745,7.39674,0.36413,227.951,7.30435,0.353261,903,NL McCullum,0,0,0,0,249,3,54,0,40,15,55,208,150,358,0,369,11,1,10,1.63934,0.0655738,17.377,85.622,61,0
Sri Lanka,244,223.373,7.09016,0.344262,227.578,7.47541,0.385246,904,NLTC Perera,4,0,4,5,208,3,39,2,28,23,51,140,158,298,0,317,19,1,10,1.65333,0.0666667,14.32,105.397,75,0
Sri Lanka,244,223.373,7.09016,0.344262,227.578,7.47541,0.385246,904,HDRL Thirimanne,6,4,2,7,208,3,39,2,28,23,51,140,158,298,0,317,19,1,10,2.77778,0.246914,31.5802,71.4725,81,4
Sri Lanka,244,223.373,7.09016,0.344262,227.578,7.47541,0.385246,904,BMAJ Mendis,0,0,0,0,208,3,39,2,28,23,51,140,158,298,0,317,19,1,10,1.43243,0.027027,15.1622,82.8656,37,1
England,221,237.176,7.17647,0.289593,230.633,7.45701,0.384615,904,JC Tredwell,5,0,5,9,236,7,32,1,8,7,15,128,155,283,318,292,9,0,10,0.52,0,6.52,65.9919,25,1
England,221,237.176,7.17647,0.289593,230.633,7.45701,0.384615,904,RS Bopara,52,20,32,53,236,7,32,1,8,7,15,128,155,283,318,292,9,0,10,2.22115,0.144231,25.1538,75.9361,104,4
England,221,237.176,7.17647,0.289593,230.633,7.45701,0.384615,904,HF Gurney,0,0,0,0,236,7,32,1,8,7,15,128,155,283,318,292,9,0,10,0.166667,0,2.5,45.4545,6,3
England,221,237.176,7.17647,0.289593,230.633,7.45701,0.384615,907,CR Woakes,0,0,0,0,190,5,23,2,26,19,45,102,156,258,0,265,7,0,10,1.09375,0,15.1562,76.8621,32,1
England,221,237.176,7.17647,0.289593,230.633,7.45701,0.384615,907,EJG Morgan,25,8,17,33,190,5,23,2,26,19,45,102,156,258,0,265,7,0,10,3.19549,0.233083,30.0526,86.9291,133,4
England,221,237.176,7.17647,0.289593,230.633,7.45701,0.384615,907,CJ Jordan,0,0,0,0,190,5,23,2,26,19,45,102,156,258,0,265,7,0,10,0.833333,0,8.22222,84.0909,18,1
England,221,237.176,7.17647,0.289593,230.633,7.45701,0.384615,907,ST Finn,0,0,0,0,190,5,23,2,26,19,45,102,156,258,0,265,7,0,10,0.583333,0,5.41667,59.633,24,3
Sri Lanka,244,223.373,7.09016,0.344262,227.578,7.47541,0.385246,907,HDRL Thirimanne,11,4,7,12,193,3,28,1,16,10,26,96,151,247,266,267,20,1,10,2.77778,0.246914,31.5802,71.4725,81,4
Sri Lanka,244,223.373,7.09016,0.344262,227.578,7.47541,0.385246,907,AD Mathews,33,8,25,45,193,3,28,1,16,10,26,96,151,247,266,267,20,1,10,2.64122,0.198473,28.6794,82.3362,131,4
Sri Lanka,244,223.373,7.09016,0.344262,227.578,7.47541,0.385246,908,NLTC Perera,1,0,1,1,160,4,29,3,22,9,31,106,114,220,0,239,19,1,10,1.65333,0.0666667,14.32,105.397,75,0
Sri Lanka,244,223.373,7.09016,0.344262,227.578,7.47541,0.385246,908,SMSM Senanayake,0,0,0,0,160,4,29,3,22,9,31,106,114,220,0,239,19,1,10,1.0625,0,8.625,87.0662,32,1
Sri Lanka,244,223.373,7.09016,0.344262,227.578,7.47541,0.385246,908,KTGD Prasad,0,0,0,0,160,4,29,3,22,9,31,106,114,220,0,239,19,1,10,1.33333,0,12.4444,106.667,9,0
Sri Lanka,244,223.373,7.09016,0.344262,227.578,7.47541,0.385246,908,BAW Mendis,0,0,0,0,160,4,29,3,22,9,31,106,114,220,0,239,19,1,10,0.447368,0,4.47368,66.4062,38,1
England,221,237.176,7.17647,0.289593,230.633,7.45701,0.384615,908,JE Root,91,28,63,104,184,3,25,0,10,12,22,84,147,231,240,240,9,0,10,3.68852,0.327869,41.6721,83.3443,61,4
England,221,237.176,7.17647,0.289593,230.633,7.45701,0.384615,908,RS Bopara,26,4,22,43,184,3,25,0,10,12,22,84,147,231,240,240,9,0,10,2.22115,0.144231,25.1538,75.9361,104,4
England,221,237.176,7.17647,0.289593,230.633,7.45701,0.384615,908,EJG Morgan,0,0,0,0,184,3,25,0,10,12,22,84,147,231,240,240,9,0,10,3.19549,0.233083,30.0526,86.9291,133,4
England,221,237.176,7.17647,0.289593,230.633,7.45701,0.384615,908,JC Buttler,0,0,0,0,184,3,25,0,10,12,22,84,147,231,240,240,9,0,10,3.47458,0.186441,29.9153,115.359,59,0
Sri Lanka,244,223.373,7.09016,0.344262,227.578,7.47541,0.385246,909,NLTC Perera,2,0,2,2,187,4,37,1,24,21,45,144,125,269,0,292,23,1,10,1.65333,0.0666667,14.32,105.397,75,0
Sri Lanka,244,223.373,7.09016,0.344262,227.578,7.47541,0.385246,909,LD Chandimal,16,8,8,22,187,4,37,1,24,21,45,144,125,269,0,292,23,1,10,2.18478,0.184783,25.7391,73.8615,92,4
Sri Lanka,244,223.373,7.09016,0.344262,227.578,7.47541,0.385246,909,BMAJ Mendis,0,0,0,0,187,4,37,1,24,21,45,144,125,269,0,292,23,1,10,1.43243,0.027027,15.1622,82.8656,37,1
Australia,228,239.627,7.69737,0.372807,232.079,7.23246,0.337719,910,GJ Maxwell,7,4,3,6,175,5,52,1,28,16,44,126,145,271,0,300,29,1,10,3.79245,0.226415,28.2264,119.68,53,0
Australia,228,239.627,7.69737,0.372807,232.079,7.23246,0.337719,910,MS Wade,35,8,27,41,175,5,52,1,28,16,44,126,145,271,0,300,29,1,10,1.86275,0.117647,20.3333,78.2642,51,1
Australia,228,239.627,7.69737,0.372807,232.079,7.23246,0.337719,910,MG Johnson,0,0,0,0,175,5,52,1,28,16,44,126,145,271,0,300,29,1,10,1.18519,0.0246914,10.7901,94.181,81,0
Australia,228,239.627,7.69737,0.372807,232.079,7.23246,0.337719,910,NM Coulter-Nile,0,0,0,0,175,5,52,1,28,16,44,126,145,271,0,300,29,1,10,0.571429,0,8.57143,69.7674,7,1
South Africa,190,234.274,7.4,0.373684,232.363,7.33158,0.342105,910,M Morkel,14,8,6,17,208,8,25,1,16,8,24,106,151,257,301,268,11,0,10,0.6,0,5.28571,72.2656,35,1
South Africa,190,234.274,7.4,0.373684,232.363,7.33158,0.342105,910,Imran Tahir,6,4,2,11,208,8,25,1,16,8,24,106,151,257,301,268,11,0,10,0.625,0,5.0625,65.8537,16,1
Australia,228,239.627,7.69737,0.372807,232.079,7.23246,0.337719,912,MR Marsh,1,0,1,2,231,2,25,2,28,33,61,152,165,317,0,329,12,1,10,3.61538,0.269231,32.2308,95.3356,26,0
Australia,228,239.627,7.69737,0.372807,232.079,7.23246,0.337719,912,SPD Smith,41,12,29,42,231,2,25,2,28,33,61,152,165,317,0,329,12,1,10,3.19298,0.22807,34.5614,87.0526,57,4
Australia,228,239.627,7.69737,0.372807,232.079,7.23246,0.337719,912,MS Wade,0,0,0,0,231,2,25,2,28,33,61,152,165,317,0,329,12,1,10,1.86275,0.117647,20.3333,78.2642,51,1
South Africa,190,234.274,7.4,0.373684,232.363,7.33158,0.342105,913,R McLaren,11,8,3,9,201,4,27,1,6,14,20,86,162,248,0,267,19,0,10,1.2,0.025,11.975,69.8251,40,1
South Africa,190,234.274,7.4,0.373684,232.363,7.33158,0.342105,913,RJ Peterson,0,0,0,0,201,4,27,1,6,14,20,86,162,248,0,267,19,0,10,1.62069,0.0344828,15.7931,83.5766,29,1
South Africa,190,234.274,7.4,0.373684,232.363,7.33158,0.342105,913,F Behardien,18,8,10,17,201,4,27,1,6,14,20,86,162,248,0,267,19,0,10,2.0303,0.0909091,21.2424,91.395,33,0
South Africa,190,234.274,7.4,0.373684,232.363,7.33158,0.342105,913,WD Parnell,0,0,0,0,201,4,27,1,6,14,20,86,162,248,0,267,19,0,10,1.47826,0.0434783,15.8261,74.7433,23,1
South Africa,190,234.274,7.4,0.373684,232.363,7.33158,0.342105,913,DW Steyn,0,0,0,0,201,4,27,1,6,14,20,86,162,248,0,267,19,0,10,0.75,0,6.52273,61.588,44,1
Australia,228,239.627,7.69737,0.372807,232.079,7.23246,0.337719,913,JP Faulkner,6,4,2,3,177,5,39,1,20,18,38,90,164,254,268,268,14,1,10,2.88235,0.147059,24.1471,109.613,34,0
Australia,228,239.627,7.69737,0.372807,232.079,7.23246,0.337719,913,SPD Smith,95,28,67,108,177,5,39,1,20,18,38,90,164,254,268,268,14,1,10,3.19298,0.22807,34.5614,87.0526,57,4
Australia,228,239.627,7.69737,0.372807,232.079,7.23246,0.337719,913,PJ Cummins,0,0,0,0,177,5,39,1,20,18,38,90,164,254,268,268,14,1,10,0.571429,0,4.85714,53.9683,7,3
South Africa,190,234.274,7.4,0.373684,232.363,7.33158,0.342105,914,WD Parnell,6,0,6,12,187,4,33,1,24,21,45,132,133,265,0,280,15,0,10,1.47826,0.0434783,15.8261,74.7433,23,1
South Africa,190,234.274,7.4,0.373684,232.363,7.33158,0.342105,914,F Behardien,31,20,11,23,187,4,33,1,24,21,45,132,133,265,0,280,15,0,10,2.0303,0.0909091,21.2424,91.395,33,0
South Africa,190,234.274,7.4,0.373684,232.363,7.33158,0.342105,914,R McLaren,0,0,0,0,187,4,33,1,24,21,45,132,133,265,0,280,15,0,10,1.2,0.025,11.975,69.8251,40,1
Australia,228,239.627,7.69737,0.372807,232.079,7.23246,0.337719,914,MS Wade,3,0,3,5,232,3,28,3,4,3,7,136,131,267,281,275,8,1,10,1.86275,0.117647,20.3333,78.2642,51,1
Australia,228,239.627,7.69737,0.372807,232.079,7.23246,0.337719,914,PJ Cummins,0,0,0,0,232,3,28,3,4,3,7,136,131,267,281,275,8,1,10,0.571429,0,4.85714,53.9683,7,3
Australia,228,239.627,7.69737,0.372807,232.079,7.23246,0.337719,914,MA Starc,0,0,0,0,232,3,28,3,4,3,7,136,131,267,281,275,8,1,10,0.692308,0,8.46154,70.0637,13,1
Australia,228,239.627,7.69737,0.372807,232.079,7.23246,0.337719,914,JP Faulkner,0,0,0,1,232,3,28,3,4,3,7,136,131,267,281,275,8,1,10,2.88235,0.147059,24.1471,109.613,34,0
India,259,242.378,7.15058,0.339768,244.568,7.12741,0.30888,915,RG Sharma,127,58,69,137,193,4,27,2,6,21,27,104,143,247,0,267,20,0,10,3.82836,0.268657,35.9179,83.083,134,4
India,259,242.378,7.15058,0.339768,244.568,7.12741,0.30888,915,R Ashwin,0,0,0,2,193,4,27,2,6,21,27,104,143,247,0,267,20,0,10,1.16364,0.0181818,11.9455,84.7742,55,1
India,259,242.378,7.15058,0.339768,244.568,7.12741,0.30888,915,B Kumar,0,0,0,0,193,4,27,2,6,21,27,104,143,247,0,267,20,0,10,0.75,0,7.39286,72.1254,28,1
India,259,242.378,7.15058,0.339768,244.568,7.12741,0.30888,915,Mohammed Shami,0,0,0,0,193,4,27,2,6,21,27,104,143,247,0,267,20,0,10,0.684211,0,5.68421,88.5246,19,0
Australia,228,239.627,7.69737,0.372807,232.079,7.23246,0.337719,915,BJ Haddin,2,0,2,3,209,3,21,2,12,13,25,116,139,255,268,269,14,1,10,3.14737,0.147368,26.7789,81.382,95,4
Australia,228,239.627,7.69737,0.372807,232.079,7.23246,0.337719,915,GJ Maxwell,15,10,5,17,209,3,21,2,12,13,25,116,139,255,268,269,14,1,10,3.79245,0.226415,28.2264,119.68,53,0
Australia,228,239.627,7.69737,0.372807,232.079,7.23246,0.337719,915,JP Faulkner,0,0,0,0,209,3,21,2,12,13,25,116,139,255,268,269,14,1,10,2.88235,0.147059,24.1471,109.613,34,0
England,221,237.176,7.17647,0.289593,230.633,7.45701,0.384615,916,EJG Morgan,107,52,55,132,156,6,35,1,14,9,23,88,126,214,0,234,20,0,10,3.19549,0.233083,30.0526,86.9291,133,4
England,221,237.176,7.17647,0.289593,230.633,7.45701,0.384615,916,CJ Jordan,8,0,8,12,156,6,35,1,14,9,23,88,126,214,0,234,20,0,10,0.833333,0,8.22222,84.0909,18,1
England,221,237.176,7.17647,0.289593,230.633,7.45701,0.384615,916,ST Finn,0,0,0,0,156,6,35,1,14,9,23,88,126,214,0,234,20,0,10,0.583333,0,5.41667,59.633,24,3
England,221,237.176,7.17647,0.289593,230.633,7.45701,0.384615,918,RS Bopara,1,0,1,2,240,2,31,3,4,18,22,128,165,293,0,303,10,0,10,2.22115,0.144231,25.1538,75.9361,104,4
England,221,237.176,7.17647,0.289593,230.633,7.45701,0.384615,918,JC Buttler,9,4,5,10,240,2,31,3,4,18,22,128,165,293,0,303,10,0,10,3.47458,0.186441,29.9153,115.359,59,0
England,221,237.176,7.17647,0.289593,230.633,7.45701,0.384615,918,CR Woakes,0,0,0,0,240,2,31,3,4,18,22,128,165,293,0,303,10,0,10,1.09375,0,15.1562,76.8621,32,1
England,221,237.176,7.17647,0.289593,230.633,7.45701,0.384615,918,SCJ Broad,0,0,0,0,240,2,31,3,4,18,22,128,165,293,0,303,10,0,10,0.725806,0,8.04839,74.0356,62,1
Australia,228,239.627,7.69737,0.372807,232.079,7.23246,0.337719,918,BJ Haddin,30,18,12,21,225,5,42,0,10,21,31,120,178,298,304,304,6,1,10,3.14737,0.147368,26.7789,81.382,95,4
Australia,228,239.627,7.69737,0.372807,232.079,7.23246,0.337719,918,SPD Smith,88,24,64,86,225,5,42,0,10,21,31,120,178,298,304,304,6,1,10,3.19298,0.22807,34.5614,87.0526,57,4
Australia,228,239.627,7.69737,0.372807,232.079,7.23246,0.337719,918,MA Starc,0,0,0,0,225,5,42,0,10,21,31,120,178,298,304,304,6,1,10,0.692308,0,8.46154,70.0637,13,1
Australia,228,239.627,7.69737,0.372807,232.079,7.23246,0.337719,919,JP Faulkner,2,0,2,4,188,4,32,3,40,11,51,170,101,271,0,278,7,1,10,2.88235,0.147059,24.1471,109.613,34,0
Australia,228,239.627,7.69737,0.372807,232.079,7.23246,0.337719,919,MG Johnson,0,0,0,0,188,4,32,3,40,11,51,170,101,271,0,278,7,1,10,1.18519,0.0246914,10.7901,94.181,81,0
Bangladesh,160,218.438,7.70625,0.4,211.106,7.05,0.325,923,Mushfiqur Rahim,57,16,41,71,191,4,23,1,34,13,47,108,153,261,0,281,20,1,10,2.61111,0.18254,27.7778,75.2526,126,4
Bangladesh,160,218.438,7.70625,0.4,211.106,7.05,0.325,923,Sabbir Rahman,7,0,7,9,191,4,23,1,34,13,47,108,153,261,0,281,20,1,10,3.23529,0.117647,25.6471,98.1982,17,0
Bangladesh,160,218.438,7.70625,0.4,211.106,7.05,0.325,923,Mashrafe Mortaza,0,0,0,0,191,4,23,1,34,13,47,108,153,261,0,281,20,1,10,1.27536,0,11.1594,76.9231,69,1
Bangladesh,160,218.438,7.70625,0.4,211.106,7.05,0.325,923,Arafat Sunny,0,0,0,0,191,4,23,1,34,13,47,108,153,261,0,281,20,1,10,0.5,0,4.7,50,10,3
Bangladesh,160,218.438,7.70625,0.4,211.106,7.05,0.325,924,Mominul Haque,5,0,5,5,172,4,30,2,12,25,37,86,153,239,0,251,12,1,10,2.57143,0.0952381,23.3333,73.4633,21,4
Bangladesh,160,218.438,7.70625,0.4,211.106,7.05,0.325,924,Mashrafe Mortaza,2,0,2,5,172,4,30,2,12,25,37,86,153,239,0,251,12,1,10,1.27536,0,11.1594,76.9231,69,1
Bangladesh,160,218.438,7.70625,0.4,211.106,7.05,0.325,924,Rubel Hossain,0,0,0,0,172,4,30,2,12,25,37,86,153,239,0,251,12,1,10,0.32,0,2.68,52.3438,25,3
Bangladesh,160,218.438,7.70625,0.4,211.106,7.05,0.325,925,Mahmudullah,13,8,5,9,180,3,57,2,24,19,43,116,164,280,0,297,17,1,10,2.26531,0.153061,24.4286,70.9544,98,4
Bangladesh,160,218.438,7.70625,0.4,211.106,7.05,0.325,925,Sabbir Rahman,1,0,1,1,180,3,57,2,24,19,43,116,164,280,0,297,17,1,10,3.23529,0.117647,25.6471,98.1982,17,0
Bangladesh,160,218.438,7.70625,0.4,211.106,7.05,0.325,925,Mashrafe Mortaza,0,0,0,0,180,3,57,2,24,19,43,116,164,280,0,297,17,1,10,1.27536,0,11.1594,76.9231,69,1
Bangladesh,160,218.438,7.70625,0.4,211.106,7.05,0.325,926,Mashrafe Mortaza,22,14,8,16,163,6,36,1,18,20,38,100,137,237,0,256,19,1,10,1.27536,0,11.1594,76.9231,69,1
Bangladesh,160,218.438,7.70625,0.4,211.106,7.05,0.325,926,Mahmudullah,68,24,44,104,163,6,36,1,18,20,38,100,137,237,0,256,19,1,10,2.26531,0.153061,24.4286,70.9544,98,4
Bangladesh,160,218.438,7.70625,0.4,211.106,7.05,0.325,926,Rubel Hossain,0,0,0,0,163,6,36,1,18,20,38,100,137,237,0,256,19,1,10,0.32,0,2.68,52.3438,25,3
Zimbabwe,142,212.077,7.5,0.380282,227.704,6.97887,0.316901,926,RW Chakabva,23,8,15,28,178,6,22,0,14,14,28,114,114,228,257,235,7,0,10,0.846154,0,13.2692,51.3393,26,3
Zimbabwe,142,212.077,7.5,0.380282,227.704,6.97887,0.316901,926,PJ Moor,7,0,7,21,178,6,22,0,14,14,28,114,114,228,257,235,7,0,10,0.5,0,7.5,41.6667,2,3
Zimbabwe,142,212.077,7.5,0.380282,227.704,6.97887,0.316901,926,N Madziva,0,0,0,0,178,6,22,0,14,14,28,114,114,228,257,235,7,0,10,0.714286,0,7,50.5155,7,3
Zimbabwe,142,212.077,7.5,0.380282,227.704,6.97887,0.316901,926,TL Chatara,0,0,0,0,178,6,22,0,14,14,28,114,114,228,257,235,7,0,10,0.705882,0,5.82353,57.2254,17,3
India,259,242.378,7.15058,0.339768,244.568,7.12741,0.30888,928,RA Jadeja,6,0,6,15,175,4,27,1,18,25,43,98,147,245,0,263,18,1,10,2.12941,0.117647,21.7529,82.4342,85,4
India,259,242.378,7.15058,0.339768,244.568,7.12741,0.30888,928,B Kumar,0,0,0,0,175,4,27,1,18,25,43,98,147,245,0,263,18,1,10,0.75,0,7.39286,72.1254,28,1
India,259,242.378,7.15058,0.339768,244.568,7.12741,0.30888,928,MS Dhoni,27,12,15,26,175,4,27,1,18,25,43,98,147,245,0,263,18,1,10,3.47872,0.292553,36.7713,84.1612,188,4
India,259,242.378,7.15058,0.339768,244.568,7.12741,0.30888,928,Mohammed Shami,0,0,0,0,175,4,27,1,18,25,43,98,147,245,0,263,18,1,10,0.684211,0,5.68421,88.5246,19,0
West Indies,176,217.33,7.15909,0.3125,225.278,7.57386,0.380682,928,R Rampaul,9,6,3,6,187,4,19,5,4,3,7,106,107,213,264,215,2,0,10,1.30303,0.030303,9.90909,77.4882,33,1
West Indies,176,217.33,7.15909,0.3125,225.278,7.57386,0.380682,928,SJ Benn,0,0,0,1,187,4,19,5,4,3,7,106,107,213,264,215,2,0,10,0.8,0,6.75,72.973,20,1
India,259,242.378,7.15058,0.339768,244.568,7.12741,0.30888,929,MS Dhoni,1,0,1,1,227,2,45,1,22,27,49,176,145,321,0,330,9,1,10,3.47872,0.292553,36.7713,84.1612,188,4
India,259,242.378,7.15058,0.339768,244.568,7.12741,0.30888,929,V Kohli,97,54,43,98,227,2,45,1,22,27,49,176,145,321,0,330,9,1,10,4.66456,0.379747,44.9937,88.3325,158,4
India,259,242.378,7.15058,0.339768,244.568,7.12741,0.30888,929,RA Jadeja,0,0,0,0,227,2,45,1,22,27,49,176,145,321,0,330,9,1,10,2.12941,0.117647,21.7529,82.4342,85,4
India,259,242.378,7.15058,0.339768,244.568,7.12741,0.30888,929,AT Rayudu,0,0,0,0,227,2,45,1,22,27,49,176,145,321,0,330,9,1,10,3.38462,0.269231,35.6923,76.0656,26,4
West Indies,176,217.33,7.15909,0.3125,225.278,7.57386,0.380682,929,MN Samuels,99,64,35,100,193,6,39,2,12,8,20,158,94,252,331,271,19,0,10,3.74757,0.23301,31.6214,74.5821,103,4
West Indies,176,217.33,7.15909,0.3125,225.278,7.57386,0.380682,929,JE Taylor,5,4,1,6,193,6,39,2,12,8,20,158,94,252,331,271,19,0,10,0.903226,0,6.96774,83.3977,31,1
West Indies,176,217.33,7.15909,0.3125,225.278,7.57386,0.380682,929,SJ Benn,0,0,0,0,193,6,39,2,12,8,20,158,94,252,331,271,19,0,10,0.8,0,6.75,72.973,20,1
India,259,242.378,7.15058,0.339768,244.568,7.12741,0.30888,930,AT Rayudu,2,0,2,4,246,2,52,1,28,23,51,208,141,349,0,363,14,1,10,3.38462,0.269231,35.6923,76.0656,26,4
India,259,242.378,7.15058,0.339768,244.568,7.12741,0.30888,930,V Kohli,20,8,12,19,246,2,52,1,28,23,51,208,141,349,0,363,14,1,10,4.66456,0.379747,44.9937,88.3325,158,4
India,259,242.378,7.15058,0.339768,244.568,7.12741,0.30888,930,WP Saha,0,0,0,0,246,2,52,1,28,23,51,208,141,349,0,363,14,1,10,0.75,0,6,64.8649,4,1
India,259,242.378,7.15058,0.339768,244.568,7.12741,0.30888,930,AR Patel,0,0,0,0,246,2,52,1,28,23,51,208,141,349,0,363,14,1,10,0.642857,0,6.14286,92.4731,14,0
Sri Lanka,244,223.373,7.09016,0.344262,227.578,7.47541,0.385246,931,AD Mathews,79,42,37,91,196,6,22,2,16,22,38,126,130,256,0,274,18,0,10,2.64122,0.198473,28.6794,82.3362,131,4
Sri Lanka,244,223.373,7.09016,0.344262,227.578,7.47541,0.385246,931,KTGD Prasad,5,4,1,8,196,6,22,2,16,22,38,126,130,256,0,274,18,0,10,1.33333,0,12.4444,106.667,9,0
Sri Lanka,244,223.373,7.09016,0.344262,227.578,7.47541,0.385246,932,S Prasanna,23,14,9,26,178,7,35,1,0,13,13,104,122,226,0,242,16,0,10,1.25,0,9.5,78.8382,20,1
Sri Lanka,244,223.373,7.09016,0.344262,227.578,7.47541,0.385246,932,KMDN Kulasekara,0,0,0,3,178,7,35,1,0,13,13,104,122,226,0,242,16,0,10,1.21,0.04,11.8,80.9328,100,1
India,259,242.378,7.15058,0.339768,244.568,7.12741,0.30888,933,RV Uthappa,6,0,6,9,267,3,49,1,64,13,77,248,145,393,0,404,11,1,10,3,0.117647,22.1471,89.0071,34,0
India,259,242.378,7.15058,0.339768,244.568,7.12741,0.30888,933,RG Sharma,197,126,71,152,267,3,49,1,64,13,77,248,145,393,0,404,11,1,10,3.82836,0.268657,35.9179,83.083,134,4
Sri Lanka,244,223.373,7.09016,0.344262,227.578,7.47541,0.385246,934,AD Mathews,79,34,45,96,166,4,41,1,54,12,66,150,123,273,0,286,13,0,10,2.64122,0.198473,28.6794,82.3362,131,4
Sri Lanka,244,223.373,7.09016,0.344262,227.578,7.47541,0.385246,934,NLTC Perera,0,0,0,0,166,4,41,1,54,12,66,150,123,273,0,286,13,0,10,1.65333,0.0666667,14.32,105.397,75,0
Sri Lanka,244,223.373,7.09016,0.344262,227.578,7.47541,0.385246,934,S Prasanna,0,0,0,0,166,4,41,1,54,12,66,150,123,273,0,286,13,0,10,1.25,0,9.5,78.8382,20,1
Sri Lanka,244,223.373,7.09016,0.344262,227.578,7.47541,0.385246,934,BAW Mendis,0,0,0,0,166,4,41,1,54,12,66,150,123,273,0,286,13,0,10,0.447368,0,4.47368,66.4062,38,1
India,259,242.378,7.15058,0.339768,244.568,7.12741,0.30888,934,V Kohli,102,40,62,114,206,5,24,2,30,17,47,148,129,277,287,288,11,1,10,4.66456,0.379747,44.9937,88.3325,158,4
India,259,242.378,7.15058,0.339768,244.568,7.12741,0.30888,934,AR Patel,7,4,3,7,206,5,24,2,30,17,47,148,129,277,287,288,11,1,10,0.642857,0,6.14286,92.4731,14,0
England,221,237.176,7.17647,0.289593,230.633,7.45701,0.384615,935,BA Stokes,32,12,20,31,287,4,44,1,32,19,51,242,140,382,0,399,17,0,10,2.23529,0.117647,20.1471,90.0131,34,0
England,221,237.176,7.17647,0.289593,230.633,7.45701,0.384615,935,MM Ali,14,10,4,10,287,4,44,1,32,19,51,242,140,382,0,399,17,0,10,2.67647,0.117647,21.3824,94.5384,34,0
England,221,237.176,7.17647,0.289593,230.633,7.45701,0.384615,935,CJ Jordan,0,0,0,0,287,4,44,1,32,19,51,242,140,382,0,399,17,0,10,0.833333,0,8.22222,84.0909,18,1
England,221,237.176,7.17647,0.289593,230.633,7.45701,0.384615,935,AU Rashid,0,0,0,0,287,4,44,1,32,19,51,242,140,382,0,399,17,0,10,2.41176,0.0588235,17.2941,108.889,17,0
England,221,237.176,7.17647,0.289593,230.633,7.45701,0.384615,935,DJ Willey,0,0,0,0,287,4,44,1,32,19,51,242,140,382,0,399,17,0,10,0.571429,0,8.28571,86.5672,7,1
South Africa,190,234.274,7.4,0.373684,232.363,7.33158,0.342105,936,F Behardien,8,0,8,11,188,3,26,3,8,23,31,88,157,245,0,262,17,1,10,2.0303,0.0909091,21.2424,91.395,33,0
South Africa,190,234.274,7.4,0.373684,232.363,7.33158,0.342105,936,K Rabada,3,0,3,3,188,3,26,3,8,23,31,88,157,245,0,262,17,1,10,1,0,8,64.8649,6,1
South Africa,190,234.274,7.4,0.373684,232.363,7.33158,0.342105,936,KJ Abbott,0,0,0,0,188,3,26,3,8,23,31,88,157,245,0,262,17,1,10,0.6,0,6.6,58.4071,10,3
England,221,237.176,7.17647,0.289593,230.633,7.45701,0.384615,936,MM Ali,10,4,6,11,185,4,35,1,26,3,29,114,135,249,263,263,14,0,10,2.67647,0.117647,21.3824,94.5384,34,0
England,221,237.176,7.17647,0.289593,230.633,7.45701,0.384615,936,JC Buttler,30,16,14,24,185,4,35,1,26,3,29,114,135,249,263,263,14,0,10,3.47458,0.186441,29.9153,115.359,59,0
England,221,237.176,7.17647,0.289593,230.633,7.45701,0.384615,937,AU Rashid,20,12,8,15,191,6,36,2,12,13,25,114,138,252,0,262,10,0,10,2.41176,0.0588235,17.2941,108.889,17,0
England,221,237.176,7.17647,0.289593,230.633,7.45701,0.384615,937,SCJ Broad,0,0,0,0,191,6,36,2,12,13,25,114,138,252,0,262,10,0,10,0.725806,0,8.04839,74.0356,62,1
South Africa,190,234.274,7.4,0.373684,232.363,7.33158,0.342105,937,CH Morris,40,16,24,29,195,6,34,2,24,2,26,118,137,255,263,266,11,1,10,1.83333,0.166667,16,101.053,6,0
South Africa,190,234.274,7.4,0.373684,232.363,7.33158,0.342105,937,KJ Abbott,3,0,3,8,195,6,34,2,24,2,26,118,137,255,263,266,11,1,10,0.6,0,6.6,58.4071,10,3
South Africa,190,234.274,7.4,0.373684,232.363,7.33158,0.342105,937,Imran Tahir,0,0,0,0,195,6,34,2,24,2,26,118,137,255,263,266,11,1,10,0.625,0,5.0625,65.8537,16,1
South Africa,190,234.274,7.4,0.373684,232.363,7.33158,0.342105,947,DA Miller,1,0,1,1,200,1,39,3,26,16,42,154,127,281,0,304,23,1,10,2.57353,0.132353,24.9412,97.2477,68,0
South Africa,190,234.274,7.4,0.373684,232.363,7.33158,0.342105,947,F Behardien,0,0,0,0,200,1,39,3,26,16,42,154,127,281,0,304,23,1,10,2.0303,0.0909091,21.2424,91.395,33,0
South Africa,190,234.274,7.4,0.373684,232.363,7.33158,0.342105,947,D Wiese,0,0,0,0,200,1,39,3,26,16,42,154,127,281,0,304,23,1,10,2,0,17,86.4407,6,0
New Zealand,184,233.745,7.39674,0.36413,227.951,7.30435,0.353261,947,MJ McClenaghan,0,0,0,0,201,5,24,3,14,13,27,122,130,252,305,284,32,0,10,0.928571,0,7.71429,75.5245,14,1
New Zealand,184,233.745,7.39674,0.36413,227.951,7.30435,0.353261,947,AF Milne,4,0,4,6,201,5,24,3,14,13,27,122,130,252,305,284,32,0,10,1,0,11.5455,95.4887,11,0
South Africa,190,234.274,7.4,0.373684,232.363,7.33158,0.342105,948,F Behardien,70,26,44,86,169,6,15,0,0,16,16,62,138,200,0,204,4,1,10,2.0303,0.0909091,21.2424,91.395,33,0
South Africa,190,234.274,7.4,0.373684,232.363,7.33158,0.342105,948,VD Philander,21,4,17,42,169,6,15,0,0,16,16,62,138,200,0,204,4,1,10,0.8125,0,8.8125,66.5094,16,1
South Africa,190,234.274,7.4,0.373684,232.363,7.33158,0.342105,948,AM Phangiso,0,0,0,0,169,6,15,0,0,16,16,62,138,200,0,204,4,1,10,0.555556,0,7.33333,62.2642,9,1
South Africa,190,234.274,7.4,0.373684,232.363,7.33158,0.342105,948,DW Steyn,0,0,0,0,169,6,15,0,0,16,16,62,138,200,0,204,4,1,10,0.75,0,6.52273,61.588,44,1
South Africa,190,234.274,7.4,0.373684,232.363,7.33158,0.342105,948,Imran Tahir,0,0,0,0,169,6,15,0,0,16,16,62,138,200,0,204,4,1,10,0.625,0,5.0625,65.8537,16,1
South Africa,190,234.274,7.4,0.373684,232.363,7.33158,0.342105,949,D Wiese,5,0,5,7,204,3,28,2,22,9,31,140,123,263,0,283,20,1,10,2,0,17,86.4407,6,0
South Africa,190,234.274,7.4,0.373684,232.363,7.33158,0.342105,949,F Behardien,19,12,7,14,204,3,28,2,22,9,31,140,123,263,0,283,20,1,10,2.0303,0.0909091,21.2424,91.395,33,0
South Africa,190,234.274,7.4,0.373684,232.363,7.33158,0.342105,949,KJ Abbott,0,0,0,0,204,3,28,2,22,9,31,140,123,263,0,283,20,1,10,0.6,0,6.6,58.4071,10,3
New Zealand,184,233.745,7.39674,0.36413,227.951,7.30435,0.353261,949,C Munro,35,8,27,43,180,6,17,2,8,10,18,86,129,215,284,221,6,0,10,2.77778,0.222222,27.1111,93.1298,9,0
New Zealand,184,233.745,7.39674,0.36413,227.951,7.30435,0.353261,949,BM Wheeler,0,0,0,1,180,6,17,2,8,10,18,86,129,215,284,221,6,0,10,1.75,0,14.5,123.404,4,0
Bangladesh,160,218.438,7.70625,0.4,211.106,7.05,0.325,950,Mushfiqur Rahim,103,64,39,71,230,2,44,1,18,20,38,180,132,312,0,329,17,1,10,2.61111,0.18254,27.7778,75.2526,126,4
Bangladesh,160,218.438,7.70625,0.4,211.106,7.05,0.325,950,Shakib Al Hasan,14,8,6,12,230,2,44,1,18,20,38,180,132,312,0,329,17,1,10,2.86992,0.252033,29.9106,79.0163,123,4
Bangladesh,160,218.438,7.70625,0.4,211.106,7.05,0.325,950,Sabbir Rahman,0,0,0,0,230,2,44,1,18,20,38,180,132,312,0,329,17,1,10,3.23529,0.117647,25.6471,98.1982,17,0
Bangladesh,160,218.438,7.70625,0.4,211.106,7.05,0.325,950,Nasir Hossain,0,0,0,0,230,2,44,1,18,20,38,180,132,312,0,329,17,1,10,2.75,0.159091,27.0455,79.3863,44,4
Pakistan,211,222.621,7.38389,0.393365,235.517,7.54976,0.336493,950,Saeed Ajmal,0,0,0,3,212,6,28,3,0,1,1,106,135,241,330,250,9,0,10,0.34375,0,4.60938,58.3004,64,3
Pakistan,211,222.621,7.38389,0.393365,235.517,7.54976,0.336493,951,Saad Nasim,62,26,36,84,159,6,23,0,28,18,46,100,128,228,0,239,11,0,10,3.33333,0.333333,33,79.2,3,4
Pakistan,211,222.621,7.38389,0.393365,235.517,7.54976,0.336493,951,Wahab Riaz,20,8,12,24,159,6,23,0,28,18,46,100,128,228,0,239,11,0,10,1.29167,0.0416667,10.9792,79.1291,48,1
Pakistan,211,222.621,7.38389,0.393365,235.517,7.54976,0.336493,952,Wahab Riaz,2,0,2,3,206,4,25,2,4,9,13,100,144,244,0,250,6,0,10,1.29167,0.0416667,10.9792,79.1291,48,1
Pakistan,211,222.621,7.38389,0.393365,235.517,7.54976,0.336493,952,Saad Nasim,19,12,7,17,206,4,25,2,4,9,13,100,144,244,0,250,6,0,10,3.33333,0.333333,33,79.2,3,4
Pakistan,211,222.621,7.38389,0.393365,235.517,7.54976,0.336493,952,Umar Gul,0,0,0,0,206,4,25,2,4,9,13,100,144,244,0,250,6,0,10,0.77193,0,7.14035,68.2886,57,1
Pakistan,211,222.621,7.38389,0.393365,235.517,7.54976,0.336493,952,Zulfiqar Babar,0,0,0,0,206,4,25,2,4,9,13,100,144,244,0,250,6,0,10,0.6,0,7,87.5,5,0
Pakistan,211,222.621,7.38389,0.393365,235.517,7.54976,0.336493,952,Junaid Khan,0,0,0,0,206,4,25,2,4,9,13,100,144,244,0,250,6,0,10,0.210526,0,2.84211,47.7876,19,3
Sri Lanka,244,223.373,7.09016,0.344262,227.578,7.47541,0.385246,953,LD Chandimal,51,22,29,60,178,4,22,2,18,19,37,106,131,237,0,255,18,1,10,2.18478,0.184783,25.7391,73.8615,92,4
Sri Lanka,244,223.373,7.09016,0.344262,227.578,7.47541,0.385246,953,TAM Siriwardana,3,0,3,7,178,4,22,2,18,19,37,106,131,237,0,255,18,1,10,3.1,0.2,26.2,111.489,10,0
Sri Lanka,244,223.373,7.09016,0.344262,227.578,7.47541,0.385246,953,S Prasanna,0,0,0,0,178,4,22,2,18,19,37,106,131,237,0,255,18,1,10,1.25,0,9.5,78.8382,20,1
Sri Lanka,244,223.373,7.09016,0.344262,227.578,7.47541,0.385246,953,SL Malinga,0,0,0,0,178,4,22,2,18,19,37,106,131,237,0,255,18,1,10,0.617284,0.0123457,4.97531,74.6296,81,1
Pakistan,211,222.621,7.38389,0.393365,235.517,7.54976,0.336493,953,Shoaib Malik,49,22,27,45,219,4,28,0,6,0,6,140,113,253,256,259,6,0,10,2.77551,0.193878,28.7041,81.4418,98,4
Pakistan,211,222.621,7.38389,0.393365,235.517,7.54976,0.336493,954,Anwar Ali,5,0,5,7,187,5,33,1,28,22,50,116,154,270,0,287,17,0,10,2.14286,0,18.5714,82.2785,14,1
Pakistan,211,222.621,7.38389,0.393365,235.517,7.54976,0.336493,954,Mohammad Rizwan,27,12,15,25,187,5,33,1,28,22,50,116,154,270,0,287,17,0,10,2.76923,0.230769,26.7692,92.8,13,0
Pakistan,211,222.621,7.38389,0.393365,235.517,7.54976,0.336493,954,Yasir Shah,0,0,0,0,187,5,33,1,28,22,50,116,154,270,0,287,17,0,10,1.16667,0,12.6667,91.5663,6,0
Sri Lanka,244,223.373,7.09016,0.344262,227.578,7.47541,0.385246,954,LD Chandimal,41,12,29,55,244,7,23,0,0,12,12,134,145,279,288,288,9,1,10,2.18478,0.184783,25.7391,73.8615,92,4
Sri Lanka,244,223.373,7.09016,0.344262,227.578,7.47541,0.385246,954,NLTC Perera,12,0,12,17,244,7,23,0,0,12,12,134,145,279,288,288,9,1,10,1.65333,0.0666667,14.32,105.397,75,0
Sri Lanka,244,223.373,7.09016,0.344262,227.578,7.47541,0.385246,954,SL Malinga,0,0,0,0,244,7,23,0,0,12,12,134,145,279,288,288,9,1,10,0.617284,0.0123457,4.97531,74.6296,81,1
Sri Lanka,244,223.373,7.09016,0.344262,227.578,7.47541,0.385246,955,SMA Priyanjan,17,0,17,26,174,4,37,2,18,12,30,68,173,241,0,256,15,1,10,2.5,0.1,20.95,78.6116,20,4
Sri Lanka,244,223.373,7.09016,0.344262,227.578,7.47541,0.385246,955,SS Pathirana,3,0,3,2,174,4,37,2,18,12,30,68,173,241,0,256,15,1,10,2.33333,0,21.6667,85.5263,3,4
Sri Lanka,244,223.373,7.09016,0.344262,227.578,7.47541,0.385246,955,SL Malinga,0,0,0,0,174,4,37,2,18,12,30,68,173,241,0,256,15,1,10,0.617284,0.0123457,4.97531,74.6296,81,1
Sri Lanka,244,223.373,7.09016,0.344262,227.578,7.47541,0.385246,956,AD Mathews,35,18,17,27,241,3,49,1,46,23,69,192,167,359,0,368,9,1,10,2.64122,0.198473,28.6794,82.3362,131,4
Sri Lanka,244,223.373,7.09016,0.344262,227.578,7.47541,0.385246,956,TAM Siriwardana,18,14,4,10,241,3,49,1,46,23,69,192,167,359,0,368,9,1,10,3.1,0.2,26.2,111.489,10,0
Pakistan,211,222.621,7.38389,0.393365,235.517,7.54976,0.336493,957,Shoaib Malik,86,48,38,59,256,2,61,0,22,27,49,200,166,366,0,375,9,1,10,2.77551,0.193878,28.7041,81.4418,98,4
Pakistan,211,222.621,7.38389,0.393365,235.517,7.54976,0.336493,957,Haris Sohail,66,26,40,54,256,2,61,0,22,27,49,200,166,366,0,375,9,1,10,3.25,0.3,35.2,80.8266,20,4
Zimbabwe,142,212.077,7.5,0.380282,227.704,6.97887,0.316901,957,P Utseya,1,0,1,2,236,3,53,2,24,14,38,170,157,327,376,334,7,0,10,0.842105,0.0263158,11.8289,55.8385,76,3
Zimbabwe,142,212.077,7.5,0.380282,227.704,6.97887,0.316901,957,R Mutumbami,3,0,3,5,236,3,53,2,24,14,38,170,157,327,376,334,7,0,10,1.93333,0.0666667,15.4667,69.8795,15,1
Zimbabwe,142,212.077,7.5,0.380282,227.704,6.97887,0.316901,958,Sikandar Raza,70,32,38,68,181,4,32,1,28,17,45,118,140,258,0,268,10,0,10,3,0.131579,26.1842,81.1582,38,4
Zimbabwe,142,212.077,7.5,0.380282,227.704,6.97887,0.316901,958,CK Coventry,1,0,1,2,181,4,32,1,28,17,45,118,140,258,0,268,10,0,10,3.33333,0.166667,29.3889,90.273,18,4
Zimbabwe,142,212.077,7.5,0.380282,227.704,6.97887,0.316901,958,AG Cremer,0,0,0,0,181,4,32,1,28,17,45,118,140,258,0,268,10,0,10,0.766667,0,10.5,54.6875,30,3
Zimbabwe,142,212.077,7.5,0.380282,227.704,6.97887,0.316901,958,T Panyangara,0,0,0,0,181,4,32,1,28,17,45,118,140,258,0,268,10,0,10,0.6,0,4.84,51.2712,25,3
Pakistan,211,222.621,7.38389,0.393365,235.517,7.54976,0.336493,958,Shoaib Malik,24,14,10,13,207,3,36,1,12,11,23,94,172,266,269,269,3,1,10,2.77551,0.193878,28.7041,81.4418,98,4
Pakistan,211,222.621,7.38389,0.393365,235.517,7.54976,0.336493,958,Haris Sohail,41,20,21,42,207,3,36,1,12,11,23,94,172,266,269,269,3,1,10,3.25,0.3,35.2,80.8266,20,4
Bangladesh,160,218.438,7.70625,0.4,211.106,7.05,0.325,959,Mashrafe Mortaza,1,0,1,4,236,5,21,1,20,13,33,148,142,290,0,307,17,1,10,1.27536,0,11.1594,76.9231,69,1
Bangladesh,160,218.438,7.70625,0.4,211.106,7.05,0.325,959,Nasir Hossain,27,14,13,23,236,5,21,1,20,13,33,148,142,290,0,307,17,1,10,2.75,0.159091,27.0455,79.3863,44,4
Bangladesh,160,218.438,7.70625,0.4,211.106,7.05,0.325,959,Rubel Hossain,0,0,0,0,236,5,21,1,20,13,33,148,142,290,0,307,17,1,10,0.32,0,2.68,52.3438,25,3
India,259,242.378,7.15058,0.339768,244.568,7.12741,0.30888,959,B Kumar,24,14,10,20,187,8,30,1,0,1,1,84,134,218,308,228,10,0,10,0.75,0,7.39286,72.1254,28,1
India,259,242.378,7.15058,0.339768,244.568,7.12741,0.30888,959,UT Yadav,2,0,2,6,187,8,30,1,0,1,1,84,134,218,308,228,10,0,10,0.533333,0,3.46667,56.5217,15,3
India,259,242.378,7.15058,0.339768,244.568,7.12741,0.30888,961,SK Raina,15,10,5,8,218,3,39,1,28,22,50,138,169,307,0,317,10,0,10,3.11111,0.216374,28.9064,91.8944,171,0
India,259,242.378,7.15058,0.339768,244.568,7.12741,0.30888,961,MS Dhoni,69,30,39,76,218,3,39,1,28,22,50,138,169,307,0,317,10,0,10,3.47872,0.292553,36.7713,84.1612,188,4
India,259,242.378,7.15058,0.339768,244.568,7.12741,0.30888,961,STR Binny,0,0,0,0,218,3,39,1,28,22,50,138,169,307,0,317,10,0,10,2.4,0.1,20.5,95.7944,10,0
India,259,242.378,7.15058,0.339768,244.568,7.12741,0.30888,961,AR Patel,0,0,0,0,218,3,39,1,28,22,50,138,169,307,0,317,10,0,10,0.642857,0,6.14286,92.4731,14,0
Bangladesh,160,218.438,7.70625,0.4,211.106,7.05,0.325,961,Arafat Sunny,9,0,9,38,202,8,11,1,8,2,10,106,117,223,318,240,17,1,10,0.5,0,4.7,50,10,3
Bangladesh,160,218.438,7.70625,0.4,211.106,7.05,0.325,961,Mustafizur Rahman,4,0,4,7,202,8,11,1,8,2,10,106,117,223,318,240,17,1,10,0.5,0,3.75,44.1176,4,3
India,259,242.378,7.15058,0.339768,244.568,7.12741,0.30888,962,AT Rayudu,104,46,58,121,157,5,39,0,26,23,49,114,131,245,0,255,10,0,10,3.38462,0.269231,35.6923,76.0656,26,4
India,259,242.378,7.15058,0.339768,244.568,7.12741,0.30888,962,STR Binny,50,18,32,63,157,5,39,0,26,23,49,114,131,245,0,255,10,0,10,2.4,0.1,20.5,95.7944,10,0
India,259,242.378,7.15058,0.339768,244.568,7.12741,0.30888,962,AR Patel,0,0,0,0,157,5,39,0,26,23,49,114,131,245,0,255,10,0,10,0.642857,0,6.14286,92.4731,14,0
Zimbabwe,142,212.077,7.5,0.380282,227.704,6.97887,0.316901,962,E Chigumbura,72,26,46,82,159,6,31,0,16,27,43,104,129,233,256,251,18,1,10,2.28947,0.114035,22.7895,77.7844,114,4
Zimbabwe,142,212.077,7.5,0.380282,227.704,6.97887,0.316901,962,AG Cremer,17,4,13,29,159,6,31,0,16,27,43,104,129,233,256,251,18,1,10,0.766667,0,10.5,54.6875,30,3
Zimbabwe,142,212.077,7.5,0.380282,227.704,6.97887,0.316901,962,DT Tiripano,0,0,0,0,159,6,31,0,16,27,43,104,129,233,256,251,18,1,10,0.75,0,5.75,56.0976,4,3
India,259,242.378,7.15058,0.339768,244.568,7.12741,0.30888,963,RV Uthappa,11,4,7,9,188,2,33,2,12,25,37,82,176,258,0,271,13,0,10,3,0.117647,22.1471,89.0071,34,0
India,259,242.378,7.15058,0.339768,244.568,7.12741,0.30888,963,STR Binny,12,4,8,8,188,2,33,2,12,25,37,82,176,258,0,271,13,0,10,2.4,0.1,20.5,95.7944,10,0
India,259,242.378,7.15058,0.339768,244.568,7.12741,0.30888,963,KM Jadhav,0,0,0,0,188,2,33,2,12,25,37,82,176,258,0,271,13,0,10,4.5,0.25,36.25,103.571,4,0
India,259,242.378,7.15058,0.339768,244.568,7.12741,0.30888,963,Harbhajan Singh,0,0,0,0,188,2,33,2,12,25,37,82,176,258,0,271,13,0,10,0.901639,0,9.98361,76.4115,61,1
India,259,242.378,7.15058,0.339768,244.568,7.12741,0.30888,963,AR Patel,0,0,0,0,188,2,33,2,12,25,37,82,176,258,0,271,13,0,10,0.642857,0,6.14286,92.4731,14,0
Zimbabwe,142,212.077,7.5,0.380282,227.704,6.97887,0.316901,963,DT Tiripano,0,0,0,0,154,6,31,2,8,6,14,92,107,199,272,209,10,1,10,0.75,0,5.75,56.0976,4,3
Zimbabwe,142,212.077,7.5,0.380282,227.704,6.97887,0.316901,963,AG Cremer,27,8,19,40,154,6,31,2,8,6,14,92,107,199,272,209,10,1,10,0.766667,0,10.5,54.6875,30,3
Zimbabwe,142,212.077,7.5,0.380282,227.704,6.97887,0.316901,963,BV Vitori,0,0,0,0,154,6,31,2,8,6,14,92,107,199,272,209,10,1,10,0.9,0,6.3,86.3014,10,1
New Zealand,184,233.745,7.39674,0.36413,227.951,7.30435,0.353261,964,GD Elliott,39,18,21,30,180,3,57,0,22,32,54,134,157,291,0,303,12,0,10,2.67188,0.203125,29.4375,79.7629,64,4
New Zealand,184,233.745,7.39674,0.36413,227.951,7.30435,0.353261,964,LRPL Taylor,76,24,52,105,180,3,57,0,22,32,54,134,157,291,0,303,12,0,10,3.68382,0.301471,36.7206,79.3959,136,4
New Zealand,184,233.745,7.39674,0.36413,227.951,7.30435,0.353261,964,JDS Neesham,0,0,0,0,180,3,57,0,22,32,54,134,157,291,0,303,12,0,10,1.75,0,14.875,93.7008,16,0
Zimbabwe,142,212.077,7.5,0.380282,227.704,6.97887,0.316901,964,SC Williams,0,0,0,0,204,2,44,1,28,13,41,144,145,289,304,304,15,1,10,2.56923,0.276923,28.5385,80.7927,65,4
Zimbabwe,142,212.077,7.5,0.380282,227.704,6.97887,0.316901,964,CR Ervine,96,46,50,95,204,2,44,1,28,13,41,144,145,289,304,304,15,1,10,3.06667,0.2,30.5333,73.9903,30,4
Zimbabwe,142,212.077,7.5,0.380282,227.704,6.97887,0.316901,965,T Panyangara,18,8,10,26,154,8,24,0,26,21,47,96,129,225,0,235,10,1,10,0.6,0,4.84,51.2712,25,3
Zimbabwe,142,212.077,7.5,0.380282,227.704,6.97887,0.316901,965,Sikandar Raza,68,26,42,82,154,8,24,0,26,21,47,96,129,225,0,235,10,1,10,3,0.131579,26.1842,81.1582,38,4
New Zealand,184,233.745,7.39674,0.36413,227.951,7.30435,0.353261,966,JDS Neesham,13,0,13,18,194,4,18,1,20,30,50,112,150,262,0,273,11,0,10,1.75,0,14.875,93.7008,16,0
New Zealand,184,233.745,7.39674,0.36413,227.951,7.30435,0.353261,966,L Ronchi,6,4,2,12,194,4,18,1,20,30,50,112,150,262,0,273,11,0,10,2.92157,0.0784314,22.1961,115.392,51,0
New Zealand,184,233.745,7.39674,0.36413,227.951,7.30435,0.353261,966,NL McCullum,0,0,0,0,194,4,18,1,20,30,50,112,150,262,0,273,11,0,10,1.63934,0.0655738,17.377,85.622,61,0
Zimbabwe,142,212.077,7.5,0.380282,227.704,6.97887,0.316901,966,SC Williams,53,18,35,58,172,6,27,1,14,6,20,102,117,219,274,235,16,1,10,2.56923,0.276923,28.5385,80.7927,65,4
Zimbabwe,142,212.077,7.5,0.380282,227.704,6.97887,0.316901,966,T Panyangara,0,0,0,0,172,6,27,1,14,6,20,102,117,219,274,235,16,1,10,0.6,0,4.84,51.2712,25,3
Zimbabwe,142,212.077,7.5,0.380282,227.704,6.97887,0.316901,966,J Nyumbu,0,0,0,0,172,6,27,1,14,6,20,102,117,219,274,235,16,1,10,0.153846,0,3.46154,50,13,3
Zimbabwe,142,212.077,7.5,0.380282,227.704,6.97887,0.316901,966,N Madziva,0,0,0,1,172,6,27,1,14,6,20,102,117,219,274,235,16,1,10,0.714286,0,7,50.5155,7,3
India,259,242.378,7.15058,0.339768,244.568,7.12741,0.30888,967,MS Dhoni,5,4,1,3,208,1,31,1,36,24,60,154,145,299,0,309,10,0,10,3.47872,0.292553,36.7713,84.1612,188,4
India,259,242.378,7.15058,0.339768,244.568,7.12741,0.30888,967,RG Sharma,134,68,66,149,208,1,31,1,36,24,60,154,145,299,0,309,10,0,10,3.82836,0.268657,35.9179,83.083,134,4
India,259,242.378,7.15058,0.339768,244.568,7.12741,0.30888,967,RA Jadeja,0,0,0,0,208,1,31,1,36,24,60,154,145,299,0,309,10,0,10,2.12941,0.117647,21.7529,82.4342,85,4
Australia,228,239.627,7.69737,0.372807,232.079,7.23246,0.337719,967,MR Marsh,4,0,4,3,237,2,35,2,0,21,21,108,185,293,310,310,17,1,10,3.61538,0.269231,32.2308,95.3356,26,0
Australia,228,239.627,7.69737,0.372807,232.079,7.23246,0.337719,967,SPD Smith,137,56,81,126,237,2,35,2,0,21,21,108,185,293,310,310,17,1,10,3.19298,0.22807,34.5614,87.0526,57,4
Australia,228,239.627,7.69737,0.372807,232.079,7.23246,0.337719,967,JP Faulkner,0,0,0,0,237,2,35,2,0,21,21,108,185,293,310,310,17,1,10,2.88235,0.147059,24.1471,109.613,34,0
India,259,242.378,7.15058,0.339768,244.568,7.12741,0.30888,968,MS Dhoni,8,0,8,6,229,2,34,1,12,26,38,116,185,301,0,308,7,0,10,3.47872,0.292553,36.7713,84.1612,188,4
India,259,242.378,7.15058,0.339768,244.568,7.12741,0.30888,968,AM Rahane,66,22,44,68,229,2,34,1,12,26,38,116,185,301,0,308,7,0,10,3.55738,0.262295,32.2295,78.0159,61,4
India,259,242.378,7.15058,0.339768,244.568,7.12741,0.30888,968,MK Pandey,0,0,0,0,229,2,34,1,12,26,38,116,185,301,0,308,7,0,10,5,0.666667,59.6667,101.705,3,4
India,259,242.378,7.15058,0.339768,244.568,7.12741,0.30888,968,RA Jadeja,0,0,0,0,229,2,34,1,12,26,38,116,185,301,0,308,7,0,10,2.12941,0.117647,21.7529,82.4342,85,4
India,259,242.378,7.15058,0.339768,244.568,7.12741,0.30888,968,R Ashwin,0,0,0,0,229,2,34,1,12,26,38,116,185,301,0,308,7,0,10,1.16364,0.0181818,11.9455,84.7742,55,1
Australia,228,239.627,7.69737,0.372807,232.079,7.23246,0.337719,968,GJ Bailey,64,30,34,49,224,2,39,1,8,19,27,108,182,290,309,309,19,1,10,3.34921,0.301587,36.3492,84.658,63,4
Australia,228,239.627,7.69737,0.372807,232.079,7.23246,0.337719,968,GJ Maxwell,11,0,11,11,224,2,39,1,8,19,27,108,182,290,309,309,19,1,10,3.79245,0.226415,28.2264,119.68,53,0
India,259,242.378,7.15058,0.339768,244.568,7.12741,0.30888,969,MS Dhoni,0,0,0,0,200,2,39,1,24,18,42,122,159,281,0,295,14,0,10,3.47872,0.292553,36.7713,84.1612,188,4
India,259,242.378,7.15058,0.339768,244.568,7.12741,0.30888,969,V Kohli,115,40,75,114,200,2,39,1,24,18,42,122,159,281,0,295,14,0,10,4.66456,0.379747,44.9937,88.3325,158,4
India,259,242.378,7.15058,0.339768,244.568,7.12741,0.30888,969,Gurkeerat Singh,0,0,0,0,200,2,39,1,24,18,42,122,159,281,0,295,14,0,10,1,0,6.5,100,2,0
India,259,242.378,7.15058,0.339768,244.568,7.12741,0.30888,969,RA Jadeja,0,0,0,0,200,2,39,1,24,18,42,122,159,281,0,295,14,0,10,2.12941,0.117647,21.7529,82.4342,85,4
India,259,242.378,7.15058,0.339768,244.568,7.12741,0.30888,969,R Dhawan,0,0,0,0,200,2,39,1,24,18,42,122,159,281,0,295,14,0,10,0.5,0,6,92.3077,2,0
Australia,228,239.627,7.69737,0.372807,232.079,7.23246,0.337719,969,JP Faulkner,9,0,9,14,224,6,29,0,22,12,34,134,153,287,296,296,9,1,10,2.88235,0.147059,24.1471,109.613,34,0
Australia,228,239.627,7.69737,0.372807,232.079,7.23246,0.337719,969,GJ Maxwell,74,32,42,73,224,6,29,0,22,12,34,134,153,287,296,296,9,1,10,3.79245,0.226415,28.2264,119.68,53,0
Australia,228,239.627,7.69737,0.372807,232.079,7.23246,0.337719,970,GJ Maxwell,1,0,1,1,230,2,55,1,30,20,50,178,157,335,0,348,13,1,10,3.79245,0.226415,28.2264,119.68,53,0
Australia,228,239.627,7.69737,0.372807,232.079,7.23246,0.337719,970,SPD Smith,51,34,17,28,230,2,55,1,30,20,50,178,157,335,0,348,13,1,10,3.19298,0.22807,34.5614,87.0526,57,4
Australia,228,239.627,7.69737,0.372807,232.079,7.23246,0.337719,970,GJ Bailey,0,0,0,0,230,2,55,1,30,20,50,178,157,335,0,348,13,1,10,3.34921,0.301587,36.3492,84.658,63,4
Australia,228,239.627,7.69737,0.372807,232.079,7.23246,0.337719,970,JP Faulkner,0,0,0,0,230,2,55,1,30,20,50,178,157,335,0,348,13,1,10,2.88235,0.147059,24.1471,109.613,34,0
Australia,228,239.627,7.69737,0.372807,232.079,7.23246,0.337719,970,MS Wade,0,0,0,0,230,2,55,1,30,20,50,178,157,335,0,348,13,1,10,1.86275,0.117647,20.3333,78.2642,51,1
India,259,242.378,7.15058,0.339768,244.568,7.12741,0.30888,970,B Kumar,2,0,2,3,277,4,29,3,4,7,11,156,161,317,349,323,6,0,10,0.75,0,7.39286,72.1254,28,1
India,259,242.378,7.15058,0.339768,244.568,7.12741,0.30888,970,UT Yadav,0,0,0,0,277,4,29,3,4,7,11,156,161,317,349,323,6,0,10,0.533333,0,3.46667,56.5217,15,3
India,259,242.378,7.15058,0.339768,244.568,7.12741,0.30888,970,RA Jadeja,15,0,15,18,277,4,29,3,4,7,11,156,161,317,349,323,6,0,10,2.12941,0.117647,21.7529,82.4342,85,4
India,259,242.378,7.15058,0.339768,244.568,7.12741,0.30888,970,I Sharma,0,0,0,0,277,4,29,3,4,7,11,156,161,317,349,323,6,0,10,0.24,0,2.84,34.1346,25,3
Australia,228,239.627,7.69737,0.372807,232.079,7.23246,0.337719,971,MS Wade,22,8,14,21,233,5,40,0,14,23,37,132,178,310,0,330,20,1,10,1.86275,0.117647,20.3333,78.2642,51,1
Australia,228,239.627,7.69737,0.372807,232.079,7.23246,0.337719,971,MR Marsh,82,40,42,69,233,5,40,0,14,23,37,132,178,310,0,330,20,1,10,3.61538,0.269231,32.2308,95.3356,26,0
Australia,228,239.627,7.69737,0.372807,232.079,7.23246,0.337719,971,JP Faulkner,0,0,0,0,233,5,40,0,14,23,37,132,178,310,0,330,20,1,10,2.88235,0.147059,24.1471,109.613,34,0
Australia,228,239.627,7.69737,0.372807,232.079,7.23246,0.337719,971,JW Hastings,0,0,0,0,233,5,40,0,14,23,37,132,178,310,0,330,20,1,10,1.76923,0,13.8462,95.2381,13,0
India,259,242.378,7.15058,0.339768,244.568,7.12741,0.30888,971,MS Dhoni,16,0,16,30,252,3,29,0,18,24,42,140,183,323,331,331,8,0,10,3.47872,0.292553,36.7713,84.1612,188,4
India,259,242.378,7.15058,0.339768,244.568,7.12741,0.30888,971,MK Pandey,80,30,50,66,252,3,29,0,18,24,42,140,183,323,331,331,8,0,10,5,0.666667,59.6667,101.705,3,4
England,221,237.176,7.17647,0.289593,230.633,7.45701,0.384615,972,DJ Willey,8,0,8,17,170,7,19,1,0,18,18,76,131,207,0,216,9,0,10,0.571429,0,8.28571,86.5672,7,1
England,221,237.176,7.17647,0.289593,230.633,7.45701,0.384615,972,CR Woakes,20,4,16,33,170,7,19,1,0,18,18,76,131,207,0,216,9,0,10,1.09375,0,15.1562,76.8621,32,1
Pakistan,211,222.621,7.38389,0.393365,235.517,7.54976,0.336493,973,Wahab Riaz,11,0,11,18,153,7,24,1,18,9,27,74,130,204,0,208,4,0,10,1.29167,0.0416667,10.9792,79.1291,48,1
Pakistan,211,222.621,7.38389,0.393365,235.517,7.54976,0.336493,973,Zafar Gohar,10,6,4,10,153,7,24,1,18,9,27,74,130,204,0,208,4,0,10,1,0,15,100,1,0
Pakistan,211,222.621,7.38389,0.393365,235.517,7.54976,0.336493,973,Mohammad Irfan,0,0,0,0,153,7,24,1,18,9,27,74,130,204,0,208,4,0,10,0.233333,0,1.56667,30.9211,30,3
England,221,237.176,7.17647,0.289593,230.633,7.45701,0.384615,974,JC Buttler,50,34,16,31,221,3,48,1,54,19,73,172,170,342,0,355,13,0,10,3.47458,0.186441,29.9153,115.359,59,0
England,221,237.176,7.17647,0.289593,230.633,7.45701,0.384615,974,JWA Taylor,10,6,4,10,221,3,48,1,54,19,73,172,170,342,0,355,13,0,10,3.375,0.333333,35.9167,79.8888,24,4
England,221,237.176,7.17647,0.289593,230.633,7.45701,0.384615,974,MM Ali,0,0,0,0,221,3,48,1,54,19,73,172,170,342,0,355,13,0,10,2.67647,0.117647,21.3824,94.5384,34,0
South Africa,190,234.274,7.4,0.373684,232.363,7.33158,0.342105,975,JP Duminy,15,6,9,16,186,3,44,1,52,13,65,146,149,295,0,303,8,0,10,2.3252,0.186992,29.9675,80.2351,123,4
South Africa,190,234.274,7.4,0.373684,232.363,7.33158,0.342105,975,F Behardien,0,0,0,0,186,3,44,1,52,13,65,146,149,295,0,303,8,0,10,2.0303,0.0909091,21.2424,91.395,33,0
South Africa,190,234.274,7.4,0.373684,232.363,7.33158,0.342105,975,AB de Villiers,74,30,44,66,186,3,44,1,52,13,65,146,149,295,0,303,8,0,10,5.04969,0.403727,47.2174,98.8428,161,4
India,259,242.378,7.15058,0.339768,244.568,7.12741,0.30888,975,RG Sharma,140,82,58,130,202,3,40,0,10,29,39,132,149,281,304,298,17,1,10,3.82836,0.268657,35.9179,83.083,134,4
India,259,242.378,7.15058,0.339768,244.568,7.12741,0.30888,975,MS Dhoni,8,0,8,14,202,3,40,0,10,29,39,132,149,281,304,298,17,1,10,3.47872,0.292553,36.7713,84.1612,188,4
India,259,242.378,7.15058,0.339768,244.568,7.12741,0.30888,975,SK Raina,0,0,0,0,202,3,40,0,10,29,39,132,149,281,304,298,17,1,10,3.11111,0.216374,28.9064,91.8944,171,0
India,259,242.378,7.15058,0.339768,244.568,7.12741,0.30888,975,STR Binny,0,0,0,0,202,3,40,0,10,29,39,132,149,281,304,298,17,1,10,2.4,0.1,20.5,95.7944,10,0
India,259,242.378,7.15058,0.339768,244.568,7.12741,0.30888,975,B Kumar,0,0,0,0,202,3,40,0,10,29,39,132,149,281,304,298,17,1,10,0.75,0,7.39286,72.1254,28,1
India,259,242.378,7.15058,0.339768,244.568,7.12741,0.30888,976,Harbhajan Singh,15,10,5,16,156,7,45,0,26,7,33,120,114,234,0,247,13,1,10,0.901639,0,9.98361,76.4115,61,1
India,259,242.378,7.15058,0.339768,244.568,7.12741,0.30888,976,MS Dhoni,70,34,36,70,156,7,45,0,26,7,33,120,114,234,0,247,13,1,10,3.47872,0.292553,36.7713,84.1612,188,4
India,259,242.378,7.15058,0.339768,244.568,7.12741,0.30888,976,UT Yadav,0,0,0,0,156,7,45,0,26,7,33,120,114,234,0,247,13,1,10,0.533333,0,3.46667,56.5217,15,3
India,259,242.378,7.15058,0.339768,244.568,7.12741,0.30888,976,MM Sharma,0,0,0,0,156,7,45,0,26,7,33,120,114,234,0,247,13,1,10,0.625,0,3.75,56.6038,8,3
South Africa,190,234.274,7.4,0.373684,232.363,7.33158,0.342105,977,F Behardien,12,0,12,17,205,4,25,1,12,22,34,110,154,264,0,270,6,0,10,2.0303,0.0909091,21.2424,91.395,33,0
South Africa,190,234.274,7.4,0.373684,232.363,7.33158,0.342105,977,JP Duminy,13,4,9,12,205,4,25,1,12,22,34,110,154,264,0,270,6,0,10,2.3252,0.186992,29.9675,80.2351,123,4
South Africa,190,234.274,7.4,0.373684,232.363,7.33158,0.342105,977,DW Steyn,0,0,0,0,205,4,25,1,12,22,34,110,154,264,0,270,6,0,10,0.75,0,6.52273,61.588,44,1
India,259,242.378,7.15058,0.339768,244.568,7.12741,0.30888,977,V Kohli,77,20,57,102,179,2,27,2,10,25,35,98,143,241,271,252,11,1,10,4.66456,0.379747,44.9937,88.3325,158,4
India,259,242.378,7.15058,0.339768,244.568,7.12741,0.30888,977,AM Rahane,4,0,4,7,179,2,27,2,10,25,35,98,143,241,271,252,11,1,10,3.55738,0.262295,32.2295,78.0159,61,4
India,259,242.378,7.15058,0.339768,244.568,7.12741,0.30888,977,Harbhajan Singh,0,0,0,0,179,2,27,2,10,25,35,98,143,241,271,252,11,1,10,0.901639,0,9.98361,76.4115,61,1
India,259,242.378,7.15058,0.339768,244.568,7.12741,0.30888,977,AR Patel,0,0,0,0,179,2,27,2,10,25,35,98,143,241,271,252,11,1,10,0.642857,0,6.14286,92.4731,14,0
India,259,242.378,7.15058,0.339768,244.568,7.12741,0.30888,978,V Kohli,127,48,79,132,220,3,37,1,6,20,26,108,175,283,0,299,16,1,10,4.66456,0.379747,44.9937,88.3325,158,4
India,259,242.378,7.15058,0.339768,244.568,7.12741,0.30888,978,MS Dhoni,4,4,0,1,220,3,37,1,6,20,26,108,175,283,0,299,16,1,10,3.47872,0.292553,36.7713,84.1612,188,4
India,259,242.378,7.15058,0.339768,244.568,7.12741,0.30888,978,Harbhajan Singh,0,0,0,0,220,3,37,1,6,20,26,108,175,283,0,299,16,1,10,0.901639,0,9.98361,76.4115,61,1
India,259,242.378,7.15058,0.339768,244.568,7.12741,0.30888,978,AR Patel,0,0,0,0,220,3,37,1,6,20,26,108,175,283,0,299,16,1,10,0.642857,0,6.14286,92.4731,14,0
India,259,242.378,7.15058,0.339768,244.568,7.12741,0.30888,978,B Kumar,0,0,0,0,220,3,37,1,6,20,26,108,175,283,0,299,16,1,10,0.75,0,7.39286,72.1254,28,1
South Africa,190,234.274,7.4,0.373684,232.363,7.33158,0.342105,978,AM Phangiso,10,0,10,16,192,6,39,1,8,15,23,110,144,254,300,264,10,0,10,0.555556,0,7.33333,62.2642,9,1
South Africa,190,234.274,7.4,0.373684,232.363,7.33158,0.342105,978,DW Steyn,5,4,1,2,192,6,39,1,8,15,23,110,144,254,300,264,10,0,10,0.75,0,6.52273,61.588,44,1
South Africa,190,234.274,7.4,0.373684,232.363,7.33158,0.342105,978,K Rabada,0,0,0,0,192,6,39,1,8,15,23,110,144,254,300,264,10,0,10,1,0,8,64.8649,6,1
South Africa,190,234.274,7.4,0.373684,232.363,7.33158,0.342105,978,Imran Tahir,0,0,0,0,192,6,39,1,8,15,23,110,144,254,300,264,10,0,10,0.625,0,5.0625,65.8537,16,1
South Africa,190,234.274,7.4,0.373684,232.363,7.33158,0.342105,979,DA Miller,1,0,1,1,287,2,73,1,50,17,67,272,155,427,0,438,11,0,10,2.57353,0.132353,24.9412,97.2477,68,0
South Africa,190,234.274,7.4,0.373684,232.363,7.33158,0.342105,979,AB de Villiers,94,56,38,55,287,2,73,1,50,17,67,272,155,427,0,438,11,0,10,5.04969,0.403727,47.2174,98.8428,161,4
South Africa,190,234.274,7.4,0.373684,232.363,7.33158,0.342105,979,F Behardien,0,0,0,0,287,2,73,1,50,17,67,272,155,427,0,438,11,0,10,2.0303,0.0909091,21.2424,91.395,33,0
South Africa,190,234.274,7.4,0.373684,232.363,7.33158,0.342105,979,D Elgar,0,0,0,0,287,2,73,1,50,17,67,272,155,427,0,438,11,0,10,1,0,19.6,60.4938,5,1
Sri Lanka,244,223.373,7.09016,0.344262,227.578,7.47541,0.385246,981,PVD Chameera,6,0,6,22,156,8,13,1,4,7,11,82,98,180,0,188,8,0,10,0.5,0,6,51.0638,4,3
New Zealand,184,233.745,7.39674,0.36413,227.951,7.30435,0.353261,982,DAJ Bracewell,20,8,12,19,197,6,28,1,16,20,36,124,137,261,0,276,15,1,10,0.428571,0,8.42857,65.5556,7,1
New Zealand,184,233.745,7.39674,0.36413,227.951,7.30435,0.353261,982,AF Milne,9,6,3,12,197,6,28,1,16,20,36,124,137,261,0,276,15,1,10,1,0,11.5455,95.4887,11,0
New Zealand,184,233.745,7.39674,0.36413,227.951,7.30435,0.353261,982,TG Southee,0,0,0,0,197,6,28,1,16,20,36,124,137,261,0,276,15,1,10,0.764706,0,7.03922,92.7649,51,0
Sri Lanka,244,223.373,7.09016,0.344262,227.578,7.47541,0.385246,982,LD Chandimal,26,4,22,37,239,2,23,0,4,4,8,122,148,270,277,277,7,0,10,2.18478,0.184783,25.7391,73.8615,92,4
Sri Lanka,244,223.373,7.09016,0.344262,227.578,7.47541,0.385246,982,HDRL Thirimanne,80,26,54,99,239,2,23,0,4,4,8,122,148,270,277,277,7,0,10,2.77778,0.246914,31.5802,71.4725,81,4
New Zealand,184,233.745,7.39674,0.36413,227.951,7.30435,0.353261,983,L Ronchi,19,8,11,16,206,3,33,1,20,25,45,128,156,284,0,294,10,1,10,2.92157,0.0784314,22.1961,115.392,51,0
New Zealand,184,233.745,7.39674,0.36413,227.951,7.30435,0.353261,983,LRPL Taylor,55,18,37,64,206,3,33,1,20,25,45,128,156,284,0,294,10,1,10,3.68382,0.301471,36.7206,79.3959,136,4
New Zealand,184,233.745,7.39674,0.36413,227.951,7.30435,0.353261,983,MJ Santner,0,0,0,0,206,3,33,1,20,25,45,128,156,284,0,294,10,1,10,3,0,26.7273,102.083,11,0
Sri Lanka,244,223.373,7.09016,0.344262,227.578,7.47541,0.385246,983,AD Mathews,94,24,70,121,205,5,33,2,4,4,8,104,142,246,295,258,12,0,10,2.64122,0.198473,28.6794,82.3362,131,4
Sri Lanka,244,223.373,7.09016,0.344262,227.578,7.47541,0.385246,983,KMDN Kulasekara,8,6,2,5,205,5,33,2,4,4,8,104,142,246,295,258,12,0,10,1.21,0.04,11.8,80.9328,100,1
Sri Lanka,244,223.373,7.09016,0.344262,227.578,7.47541,0.385246,983,PVD Chameera,0,0,0,0,205,5,33,2,4,4,8,104,142,246,295,258,12,0,10,0.5,0,6,51.0638,4,3
New Zealand,184,233.745,7.39674,0.36413,227.951,7.30435,0.353261,984,MJ McClenaghan,1,0,1,2,167,7,23,1,60,10,70,138,122,260,0,280,20,1,10,0.928571,0,7.71429,75.5245,14,1
New Zealand,184,233.745,7.39674,0.36413,227.951,7.30435,0.353261,984,MJ Henry,12,8,4,19,167,7,23,1,60,10,70,138,122,260,0,280,20,1,10,1.33333,0,9.55556,103.614,9,0
New Zealand,184,233.745,7.39674,0.36413,227.951,7.30435,0.353261,984,TA Boult,0,0,0,0,167,7,23,1,60,10,70,138,122,260,0,280,20,1,10,0.727273,0,5.27273,77.3333,11,1
Pakistan,211,222.621,7.38389,0.393365,235.517,7.54976,0.336493,984,Mohammad Amir,0,0,0,2,166,6,32,2,0,0,0,70,128,198,281,210,12,0,10,1.5,0.0714286,12,73.6842,14,1
Pakistan,211,222.621,7.38389,0.393365,235.517,7.54976,0.336493,984,Mohammad Irfan,0,0,0,0,166,6,32,2,0,0,0,70,128,198,281,210,12,0,10,0.233333,0,1.56667,30.9211,30,3
New Zealand,184,233.745,7.39674,0.36413,227.951,7.30435,0.353261,985,AF Milne,1,0,1,1,231,6,25,1,20,20,40,178,118,296,0,307,11,1,10,1,0,11.5455,95.4887,11,0
New Zealand,184,233.745,7.39674,0.36413,227.951,7.30435,0.353261,985,MJ Santner,13,6,7,25,231,6,25,1,20,20,40,178,118,296,0,307,11,1,10,3,0,26.7273,102.083,11,0
New Zealand,184,233.745,7.39674,0.36413,227.951,7.30435,0.353261,985,MJ Henry,0,0,0,0,231,6,25,1,20,20,40,178,118,296,0,307,11,1,10,1.33333,0,9.55556,103.614,9,0
New Zealand,184,233.745,7.39674,0.36413,227.951,7.30435,0.353261,986,AF Milne,24,14,10,17,199,6,41,1,8,25,33,126,147,273,0,281,8,1,10,1,0,11.5455,95.4887,11,0
New Zealand,184,233.745,7.39674,0.36413,227.951,7.30435,0.353261,986,MJ Santner,26,10,16,24,199,6,41,1,8,25,33,126,147,273,0,281,8,1,10,3,0,26.7273,102.083,11,0
New Zealand,184,233.745,7.39674,0.36413,227.951,7.30435,0.353261,986,MJ Henry,0,0,0,0,199,6,41,1,8,25,33,126,147,273,0,281,8,1,10,1.33333,0,9.55556,103.614,9,0
New Zealand,184,233.745,7.39674,0.36413,227.951,7.30435,0.353261,986,TA Boult,0,0,0,0,199,6,41,1,8,25,33,126,147,273,0,281,8,1,10,0.727273,0,5.27273,77.3333,11,1
Australia,228,239.627,7.69737,0.372807,232.079,7.23246,0.337719,986,JW Hastings,33,12,21,42,236,6,24,0,14,1,15,156,119,275,282,283,8,0,10,1.76923,0,13.8462,95.2381,13,0
Australia,228,239.627,7.69737,0.372807,232.079,7.23246,0.337719,986,MR Marsh,69,42,27,70,236,6,24,0,14,1,15,156,119,275,282,283,8,0,10,3.61538,0.269231,32.2308,95.3356,26,0
New Zealand,184,233.745,7.39674,0.36413,227.951,7.30435,0.353261,987,DAJ Bracewell,2,0,2,3,209,4,22,4,0,0,0,104,127,231,0,246,15,1,10,0.428571,0,8.42857,65.5556,7,1
Pakistan,211,222.621,7.38389,0.393365,235.517,7.54976,0.336493,988,Sarfraz Ahmed,35,16,19,45,245,6,24,1,4,2,6,154,121,275,0,290,15,0,10,2.04878,0.097561,25.4878,83.9357,41,4
Pakistan,211,222.621,7.38389,0.393365,235.517,7.54976,0.336493,988,Mohammad Amir,1,0,1,1,245,6,24,1,4,2,6,154,121,275,0,290,15,0,10,1.5,0.0714286,12,73.6842,14,1
Pakistan,211,222.621,7.38389,0.393365,235.517,7.54976,0.336493,988,Mohammad Irfan,0,0,0,0,245,6,24,1,4,2,6,154,121,275,0,290,15,0,10,0.233333,0,1.56667,30.9211,30,3
Pakistan,211,222.621,7.38389,0.393365,235.517,7.54976,0.336493,991,Mohammad Rizwan,48,14,34,60,165,5,29,0,26,25,51,98,147,245,0,259,14,0,10,2.76923,0.230769,26.7692,92.8,13,0
Pakistan,211,222.621,7.38389,0.393365,235.517,7.54976,0.336493,991,Imad Wasim,38,8,30,46,165,5,29,0,26,25,51,98,147,245,0,259,14,0,10,2.33333,0.333333,25.3333,90.4762,3,0
Pakistan,211,222.621,7.38389,0.393365,235.517,7.54976,0.336493,991,Aamer Yamin,0,0,0,0,165,5,29,0,26,25,51,98,147,245,0,259,14,0,10,4.5,0.5,31,84.9315,2,4
Zimbabwe,142,212.077,7.5,0.380282,227.704,6.97887,0.316901,992,E Chigumbura,48,14,34,44,170,3,43,1,30,20,50,106,157,263,0,276,13,1,10,2.28947,0.114035,22.7895,77.7844,114,4
Zimbabwe,142,212.077,7.5,0.380282,227.704,6.97887,0.316901,992,Sikandar Raza,19,14,5,8,170,3,43,1,30,20,50,106,157,263,0,276,13,1,10,3,0.131579,26.1842,81.1582,38,4
Zimbabwe,142,212.077,7.5,0.380282,227.704,6.97887,0.316901,992,R Mutumbami,0,0,0,0,170,3,43,1,30,20,50,106,157,263,0,276,13,1,10,1.93333,0.0666667,15.4667,69.8795,15,1
Zimbabwe,142,212.077,7.5,0.380282,227.704,6.97887,0.316901,992,LM Jongwe,0,0,0,0,170,3,43,1,30,20,50,106,157,263,0,276,13,1,10,1.09091,0,11,65.7609,11,1
Pakistan,211,222.621,7.38389,0.393365,235.517,7.54976,0.336493,992,Shoaib Malik,77,26,51,99,172,7,38,1,12,17,29,122,117,239,277,256,17,0,10,2.77551,0.193878,28.7041,81.4418,98,4
Pakistan,211,222.621,7.38389,0.393365,235.517,7.54976,0.336493,992,Yasir Shah,22,12,10,13,172,7,38,1,12,17,29,122,117,239,277,256,17,0,10,1.16667,0,12.6667,91.5663,6,0
Ireland,55,219.527,7.65455,0.290909,202.727,7.56364,0.4,994,GH Dockrell,1,0,1,2,148,5,16,2,18,25,43,76,131,207,0,219,12,0,10,0.875,0,9.0625,69.7115,16,1
Ireland,55,219.527,7.65455,0.290909,202.727,7.56364,0.4,994,AR McBrine,0,0,0,0,148,5,16,2,18,25,43,76,131,207,0,219,12,0,10,1,0,11.5,93.8776,4,0
Ireland,55,219.527,7.65455,0.290909,202.727,7.56364,0.4,994,GC Wilson,50,12,38,75,148,5,16,2,18,25,43,76,131,207,0,219,12,0,10,2.22727,0.227273,22,78.1906,22,4
Zimbabwe,142,212.077,7.5,0.380282,227.704,6.97887,0.316901,994,Sikandar Raza,45,12,33,63,167,7,22,0,8,18,26,72,143,215,220,222,7,1,10,3,0.131579,26.1842,81.1582,38,4
Zimbabwe,142,212.077,7.5,0.380282,227.704,6.97887,0.316901,994,T Panyangara,0,0,0,0,167,7,22,0,8,18,26,72,143,215,220,222,7,1,10,0.6,0,4.84,51.2712,25,3
Ireland,55,219.527,7.65455,0.290909,202.727,7.56364,0.4,995,GC Wilson,39,20,19,42,185,4,18,1,26,17,43,132,114,246,0,268,22,0,10,2.22727,0.227273,22,78.1906,22,4
Ireland,55,219.527,7.65455,0.290909,202.727,7.56364,0.4,995,KJ O'Brien,5,4,1,10,185,4,18,1,26,17,43,132,114,246,0,268,22,0,10,2.64706,0.0588235,22.3824,79.4363,34,4
Ireland,55,219.527,7.65455,0.290909,202.727,7.56364,0.4,995,JF Mooney,0,0,0,0,185,4,18,1,26,17,43,132,114,246,0,268,22,0,10,1.47619,0,13.7619,72.796,21,1
Ireland,55,219.527,7.65455,0.290909,202.727,7.56364,0.4,995,GH Dockrell,0,0,0,0,185,4,18,1,26,17,43,132,114,246,0,268,22,0,10,0.875,0,9.0625,69.7115,16,1
Zimbabwe,142,212.077,7.5,0.380282,227.704,6.97887,0.316901,995,Sikandar Raza,22,0,22,24,185,4,39,0,18,8,26,110,140,250,269,270,20,1,10,3,0.131579,26.1842,81.1582,38,4
Zimbabwe,142,212.077,7.5,0.380282,227.704,6.97887,0.316901,995,CR Ervine,90,40,50,116,185,4,39,0,18,8,26,110,140,250,269,270,20,1,10,3.06667,0.2,30.5333,73.9903,30,4
Zimbabwe,142,212.077,7.5,0.380282,227.704,6.97887,0.316901,995,E Chigumbura,0,0,0,0,185,4,39,0,18,8,26,110,140,250,269,270,20,1,10,2.28947,0.114035,22.7895,77.7844,114,4
Zimbabwe,142,212.077,7.5,0.380282,227.704,6.97887,0.316901,996,J Nyumbu,0,0,0,0,138,4,29,4,0,10,10,70,107,177,0,187,10,1,10,0.153846,0,3.46154,50,13,3
Ireland,55,219.527,7.65455,0.290909,202.727,7.56364,0.4,996,TJ Murtagh,11,4,7,7,136,6,25,2,8,8,16,76,101,177,188,189,12,0,10,1,0,8.2,93.1818,5,0
Ireland,55,219.527,7.65455,0.290909,202.727,7.56364,0.4,996,AR McBrine,6,0,6,16,136,6,25,2,8,8,16,76,101,177,188,189,12,0,10,1,0,11.5,93.8776,4,0
Bangladesh,160,218.438,7.70625,0.4,211.106,7.05,0.325,1000,Nasir Hossain,28,4,24,44,171,5,26,1,12,14,26,114,109,223,0,241,18,1,10,2.75,0.159091,27.0455,79.3863,44,4
Bangladesh,160,218.438,7.70625,0.4,211.106,7.05,0.325,1000,Mashrafe Mortaza,9,4,5,9,171,5,26,1,12,14,26,114,109,223,0,241,18,1,10,1.27536,0,11.1594,76.9231,69,1
Bangladesh,160,218.438,7.70625,0.4,211.106,7.05,0.325,1000,Arafat Sunny,0,0,0,0,171,5,26,1,12,14,26,114,109,223,0,241,18,1,10,0.5,0,4.7,50,10,3
Bangladesh,160,218.438,7.70625,0.4,211.106,7.05,0.325,1000,Mustafizur Rahman,0,0,0,0,171,5,26,1,12,14,26,114,109,223,0,241,18,1,10,0.5,0,3.75,44.1176,4,3
Bangladesh,160,218.438,7.70625,0.4,211.106,7.05,0.325,1001,Mashrafe Mortaza,1,0,1,1,195,3,30,3,20,19,39,136,128,264,0,276,12,1,10,1.27536,0,11.1594,76.9231,69,1
Bangladesh,160,218.438,7.70625,0.4,211.106,7.05,0.325,1001,Mahmudullah,32,18,14,26,195,3,30,3,20,19,39,136,128,264,0,276,12,1,10,2.26531,0.153061,24.4286,70.9544,98,4
Bangladesh,160,218.438,7.70625,0.4,211.106,7.05,0.325,1001,Arafat Sunny,0,0,0,0,195,3,30,3,20,19,39,136,128,264,0,276,12,1,10,0.5,0,4.7,50,10,3
Bangladesh,160,218.438,7.70625,0.4,211.106,7.05,0.325,1001,Mustafizur Rahman,0,0,0,0,195,3,30,3,20,19,39,136,128,264,0,276,12,1,10,0.5,0,3.75,44.1176,4,3
