Team,Total Matches Played,Runs Scored,Wickets Lost,Got All Out,Runs Conceded,Opponent Wickets Taken,Opponent All Out,Batsman,Player Total Runs,Player Home Runs,Player Non Home Runs,Balls Faced,R0,W0,R1,W1,Current_HR,Current_NHR,Total Runs in Segment,Total HR till Segment,Total NHR till Segment,Total Runs Till Segment,Target,Final Runs Made,Extras,Home,Segment,Home Run Hitting Ability,Milestone Reaching Ability,Batting Average,Strike Rate,Matches Played,ClusterID,Predicted_NHR,Abs_Error
England,221,237.176,7.17647,0.289593,230.633,7.45701,0.384615,IR Bell,0,0,0,0,0,0,0,0,12,15,27,12,15,27,0,271,2,1,1,3.63433,0.246269,35.3806,75.6623,134,4,7.83019,7.16981
Pakistan,211,222.621,7.38389,0.393365,235.517,7.54976,0.336493,Mohammad Hafeez,0,0,0,0,0,0,0,0,14,9,23,14,9,23,272,274,2,0,1,4.04511,0.255639,34.3534,78.0625,133,4,8.08449,0.915509
England,221,237.176,7.17647,0.289593,230.633,7.45701,0.384615,AJ Strauss,0,0,0,0,0,0,0,0,24,3,27,24,3,27,155,155,3,1,1,3.93243,0.27027,33.9054,79.8028,74,4,8.18088,-5.18088
England,221,237.176,7.17647,0.289593,230.633,7.45701,0.384615,ME Trescothick,0,0,0,0,0,0,0,0,4,11,15,4,11,15,258,237,0,1,1,6.625,0.375,49.5,87.4172,8,4,7.57994,3.42006
Sri Lanka,244,223.373,7.09016,0.344262,227.578,7.47541,0.385246,ST Jayasuriya,0,0,0,0,0,0,0,0,12,6,18,12,6,18,0,319,0,0,1,4.91549,0.211268,33.9859,98.4898,71,0,7.37712,-1.37712
Sri Lanka,244,223.373,7.09016,0.344262,227.578,7.47541,0.385246,WU Tharanga,0,0,0,0,0,0,0,0,30,7,37,30,7,37,262,265,1,0,1,3.93985,0.263158,32.9699,71.6035,133,4,8.41404,-1.41404
Sri Lanka,244,223.373,7.09016,0.344262,227.578,7.47541,0.385246,WU Tharanga,0,0,0,0,0,0,0,0,12,7,19,12,7,19,0,318,6,0,1,3.93985,0.263158,32.9699,71.6035,133,4,7.38489,-0.384891
India,259,242.378,7.15058,0.339768,244.568,7.12741,0.30888,R Dravid,0,0,0,0,0,0,0,0,8,6,14,8,6,14,0,217,1,0,1,2.83721,0.255814,29.8605,72.7067,43,4,8.07854,-2.07854
West Indies,176,217.33,7.15909,0.3125,225.278,7.57386,0.380682,CH Gayle,0,0,0,0,0,0,0,0,24,0,24,24,0,24,0,255,3,1,1,4.58621,0.206897,31.1293,89.4255,116,4,6.48576,-6.48576
Pakistan,211,222.621,7.38389,0.393365,235.517,7.54976,0.336493,Mohammad Hafeez,0,0,0,0,0,0,0,0,18,2,20,18,2,20,242,187,1,0,1,4.04511,0.255639,34.3534,78.0625,133,4,4.48841,-2.48841
Ireland,55,219.527,7.65455,0.290909,202.727,7.56364,0.4,JP Bray,0,0,0,0,0,0,0,0,10,5,15,10,5,15,0,221,2,0,1,2.7,0.1,23.4,63.0728,10,1,6.21772,-1.21772
New Zealand,184,233.745,7.39674,0.36413,227.951,7.30435,0.353261,L Vincent,0,0,0,0,0,0,0,0,12,4,16,12,4,16,210,210,3,0,1,3.125,0.25,27.8125,67.5266,16,4,6.96092,-2.96092
Bangladesh,160,218.438,7.70625,0.4,211.106,7.05,0.325,Mushfiqur Rahim,0,0,0,0,0,0,0,0,8,8,16,8,8,16,192,192,8,0,1,2.61111,0.18254,27.7778,75.2526,126,4,7.31618,0.683819
Ireland,55,219.527,7.65455,0.290909,202.727,7.56364,0.4,WTS Porterfield,0,0,0,0,0,0,0,0,4,10,14,4,10,14,133,133,1,0,1,2.6,0.142857,24.6857,56.2866,35,3,8.18534,1.81466
Pakistan,211,222.621,7.38389,0.393365,235.517,7.54976,0.336493,Kamran Akmal,0,0,0,0,0,0,0,0,12,11,23,12,11,23,0,349,2,0,1,3.01124,0.11236,23.0787,81.4433,89,4,7.14441,3.85559
Sri Lanka,244,223.373,7.09016,0.344262,227.578,7.47541,0.385246,ST Jayasuriya,0,0,0,0,0,0,0,0,0,9,9,0,9,9,0,254,10,0,1,4.91549,0.211268,33.9859,98.4898,71,0,7.37712,1.62288
South Africa,190,234.274,7.4,0.373684,232.363,7.33158,0.342105,AB de Villiers,0,0,0,0,0,0,0,0,30,7,37,30,7,37,378,294,3,0,1,5.04969,0.403727,47.2174,98.8428,161,4,9.53136,-2.53136
West Indies,176,217.33,7.15909,0.3125,225.278,7.57386,0.380682,S Chanderpaul,0,0,0,0,0,0,0,0,0,5,5,0,5,5,0,177,2,1,1,3.57143,0.396825,40.8254,68.0783,63,4,6.48576,-1.48576
New Zealand,184,233.745,7.39674,0.36413,227.951,7.30435,0.353261,HJH Marshall,0,0,0,0,0,0,0,0,8,7,15,8,7,15,178,179,1,0,1,1.1,0.1,11.4,69.5122,10,1,7.59425,-0.594251
England,221,237.176,7.17647,0.289593,230.633,7.45701,0.384615,EC Joyce,0,0,0,0,0,0,0,0,8,7,15,8,7,15,0,266,7,0,1,3.08571,0.2,28.3429,68.6505,35,4,7.7801,-0.780101
Ireland,55,219.527,7.65455,0.290909,202.727,7.56364,0.4,WTS Porterfield,0,0,0,0,0,0,0,0,0,7,7,0,7,7,267,218,4,0,1,2.6,0.142857,24.6857,56.2866,35,3,6.91614,0.0838647
Bangladesh,160,218.438,7.70625,0.4,211.106,7.05,0.325,Aftab Ahmed,0,0,0,0,0,0,0,0,10,12,22,10,12,22,0,104,2,0,1,2.44118,0.0882353,19.1471,73.8095,34,1,8.28946,3.71054
Bangladesh,160,218.438,7.70625,0.4,211.106,7.05,0.325,Javed Omar,0,0,0,0,0,0,0,0,8,6,14,8,6,14,0,174,0,0,1,2.66667,0.166667,24.3333,48.0263,6,3,6.77714,-0.777143
Ireland,55,219.527,7.65455,0.290909,202.727,7.56364,0.4,JP Bray,0,0,0,0,0,0,0,0,4,5,9,4,5,9,0,152,0,0,1,2.7,0.1,23.4,63.0728,10,1,6.21772,-1.21772
South Africa,190,234.274,7.4,0.373684,232.363,7.33158,0.342105,AB de Villiers,0,0,0,0,0,0,0,0,12,6,18,12,6,18,153,165,1,0,1,5.04969,0.403727,47.2174,98.8428,161,4,8.85421,-2.85421
Sri Lanka,244,223.373,7.09016,0.344262,227.578,7.47541,0.385246,WU Tharanga,0,0,0,0,0,0,0,0,8,10,18,8,10,18,0,235,1,0,1,3.93985,0.263158,32.9699,71.6035,133,4,7.38489,2.61511
England,221,237.176,7.17647,0.289593,230.633,7.45701,0.384615,MP Vaughan,0,0,0,0,0,0,0,0,4,7,11,4,7,11,236,233,0,0,1,2.6,0.1,20.6,66.4516,10,1,8.37684,-1.37684
Bangladesh,160,218.438,7.70625,0.4,211.106,7.05,0.325,Javed Omar,0,0,0,0,0,0,0,0,8,3,11,8,3,11,0,251,2,0,1,2.66667,0.166667,24.3333,48.0263,6,3,6.77714,-3.77714
England,221,237.176,7.17647,0.289593,230.633,7.45701,0.384615,MP Vaughan,0,0,0,0,0,0,0,0,4,12,16,4,12,16,0,247,2,0,1,2.6,0.1,20.6,66.4516,10,1,8.01958,3.98042
New Zealand,184,233.745,7.39674,0.36413,227.951,7.30435,0.353261,SP Fleming,0,0,0,0,0,0,0,0,0,3,3,0,3,3,0,219,1,0,1,3.875,0.25,30.2917,70.9268,24,4,6.85021,-3.85021
Sri Lanka,244,223.373,7.09016,0.344262,227.578,7.47541,0.385246,WU Tharanga,0,0,0,0,0,0,0,0,8,10,18,8,10,18,220,222,14,0,1,3.93985,0.263158,32.9699,71.6035,133,4,7.75641,2.24359
Sri Lanka,244,223.373,7.09016,0.344262,227.578,7.47541,0.385246,ST Jayasuriya,0,0,0,0,0,0,0,0,8,10,18,8,10,18,220,222,14,0,1,4.91549,0.211268,33.9859,98.4898,71,0,8.03197,1.96803
Sri Lanka,244,223.373,7.09016,0.344262,227.578,7.47541,0.385246,KC Sangakkara,0,0,0,0,0,0,0,0,8,10,18,8,10,18,220,222,14,0,1,4.33659,0.360976,41.9854,80.6276,205,4,7.75641,2.24359
South Africa,190,234.274,7.4,0.373684,232.363,7.33158,0.342105,GC Smith,0,0,0,0,0,0,0,0,0,3,3,0,3,3,0,193,2,0,1,3.97,0.29,33.57,79.6819,100,4,7.85679,-4.85679
Ireland,55,219.527,7.65455,0.290909,202.727,7.56364,0.4,WTS Porterfield,0,0,0,0,0,0,0,0,4,15,19,4,15,19,0,243,4,0,1,2.6,0.142857,24.6857,56.2866,35,3,5.4886,9.5114
Sri Lanka,244,223.373,7.09016,0.344262,227.578,7.47541,0.385246,ST Jayasuriya,0,0,0,0,0,0,0,0,8,9,17,8,9,17,0,226,9,0,1,4.91549,0.211268,33.9859,98.4898,71,0,7.37712,1.62288
Sri Lanka,244,223.373,7.09016,0.344262,227.578,7.47541,0.385246,KC Sangakkara,0,0,0,0,0,0,0,0,8,9,17,8,9,17,0,226,9,0,1,4.33659,0.360976,41.9854,80.6276,205,4,7.38489,1.61511
Ireland,55,219.527,7.65455,0.290909,202.727,7.56364,0.4,WTS Porterfield,0,0,0,0,0,0,0,0,4,6,10,4,6,10,0,77,1,0,1,2.6,0.142857,24.6857,56.2866,35,3,5.4886,0.511405
Australia,228,239.627,7.69737,0.372807,232.079,7.23246,0.337719,AC Gilchrist,0,0,0,0,0,0,0,0,24,6,30,24,6,30,0,348,2,0,1,4.3,0.275,31.425,96.1009,40,0,8.3228,-2.3228
New Zealand,184,233.745,7.39674,0.36413,227.951,7.30435,0.353261,SP Fleming,0,0,0,0,0,0,0,0,14,14,28,14,14,28,349,133,1,0,1,3.875,0.25,30.2917,70.9268,24,4,12.3905,1.6095
New Zealand,184,233.745,7.39674,0.36413,227.951,7.30435,0.353261,LRPL Taylor,0,0,0,0,0,0,0,0,0,6,6,0,6,6,290,208,4,0,1,3.68382,0.301471,36.7206,79.3959,136,4,7.6899,-1.6899
South Africa,190,234.274,7.4,0.373684,232.363,7.33158,0.342105,AB de Villiers,0,0,0,0,0,0,0,0,4,3,7,4,3,7,0,149,1,0,1,5.04969,0.403727,47.2174,98.8428,161,4,7.85679,-4.85679
Sri Lanka,244,223.373,7.09016,0.344262,227.578,7.47541,0.385246,ST Jayasuriya,0,0,0,0,0,0,0,0,12,4,16,12,4,16,282,215,2,0,1,4.91549,0.211268,33.9859,98.4898,71,0,8.38813,-4.38813
South Africa,190,234.274,7.4,0.373684,232.363,7.33158,0.342105,JH Kallis,0,0,0,0,0,0,0,0,8,10,18,8,10,18,0,248,4,1,1,3.58621,0.356322,37.2644,76.4442,87,4,7.38502,2.61498
India,259,242.378,7.15058,0.339768,244.568,7.12741,0.30888,W Jaffer,0,0,0,0,0,0,0,0,8,8,16,8,8,16,249,91,1,0,1,1,0,5,43.4783,2,3,8.16164,-0.161637
India,259,242.378,7.15058,0.339768,244.568,7.12741,0.30888,M Kaif,0,0,0,0,0,0,0,0,8,8,16,8,8,16,249,91,1,0,1,1.77778,0.222222,23.8889,61.4286,9,1,8.16164,-0.161637
India,259,242.378,7.15058,0.339768,244.568,7.12741,0.30888,SR Tendulkar,0,0,0,0,0,0,0,0,8,8,16,8,8,16,249,91,1,0,1,5.89773,0.363636,45.6023,84.5376,88,4,8.16164,-0.161637
South Africa,190,234.274,7.4,0.373684,232.363,7.33158,0.342105,GC Smith,0,0,0,0,0,0,0,0,8,1,9,8,1,9,0,274,1,1,1,3.97,0.29,33.57,79.6819,100,4,7.38502,-6.38502
South Africa,190,234.274,7.4,0.373684,232.363,7.33158,0.342105,GC Smith,0,0,0,0,0,0,0,0,4,3,7,4,3,7,0,243,0,1,1,3.97,0.29,33.57,79.6819,100,4,7.38502,-4.38502
South Africa,190,234.274,7.4,0.373684,232.363,7.33158,0.342105,LE Bosman,0,0,0,0,0,0,0,0,4,3,7,4,3,7,0,243,0,1,1,4.18182,0.181818,27.1818,97.7124,11,0,7.64395,-4.64395
Australia,228,239.627,7.69737,0.372807,232.079,7.23246,0.337719,ML Hayden,0,0,0,0,0,0,0,0,16,10,26,16,10,26,0,289,2,1,1,6.37838,0.378378,50.6757,83.3333,37,4,8.21609,1.78391
New Zealand,184,233.745,7.39674,0.36413,227.951,7.30435,0.353261,BB McCullum,0,0,0,0,0,0,0,0,4,6,10,4,6,10,290,184,0,0,1,3.98611,0.201389,29.9028,98.4004,144,0,7.97173,-1.97173
Australia,228,239.627,7.69737,0.372807,232.079,7.23246,0.337719,ML Hayden,0,0,0,0,0,0,0,0,4,4,8,4,4,8,219,224,4,1,1,6.37838,0.378378,50.6757,83.3333,37,4,8.53244,-4.53244
Australia,228,239.627,7.69737,0.372807,232.079,7.23246,0.337719,MJ Clarke,0,0,0,0,0,0,0,0,4,4,8,4,4,8,219,224,4,1,1,3.10294,0.301471,35.9265,74.0303,136,4,8.53244,-4.53244
New Zealand,184,233.745,7.39674,0.36413,227.951,7.30435,0.353261,L Vincent,0,0,0,0,0,0,0,0,4,8,12,4,8,12,344,335,1,0,1,3.125,0.25,27.8125,67.5266,16,4,9.08558,-1.08558
New Zealand,184,233.745,7.39674,0.36413,227.951,7.30435,0.353261,SP Fleming,0,0,0,0,0,0,0,0,4,13,17,4,13,17,0,290,2,0,1,3.875,0.25,30.2917,70.9268,24,4,6.85021,6.14979
New Zealand,184,233.745,7.39674,0.36413,227.951,7.30435,0.353261,PG Fulton,0,0,0,0,0,0,0,0,4,13,17,4,13,17,0,290,2,0,1,2.75,0.1875,27.4062,67.4615,32,4,6.85021,6.14979
Australia,228,239.627,7.69737,0.372807,232.079,7.23246,0.337719,ML Hayden,0,0,0,0,0,0,0,0,16,10,26,16,10,26,291,291,1,1,1,6.37838,0.378378,50.6757,83.3333,37,4,8.6203,1.3797
Australia,228,239.627,7.69737,0.372807,232.079,7.23246,0.337719,AC Gilchrist,0,0,0,0,0,0,0,0,8,8,16,8,8,16,243,246,16,1,1,4.3,0.275,31.425,96.1009,40,0,8.92652,-0.926517
England,221,237.176,7.17647,0.289593,230.633,7.45701,0.384615,AJ Strauss,0,0,0,0,0,0,0,0,6,7,13,6,7,13,0,110,1,0,1,3.93243,0.27027,33.9054,79.8028,74,4,7.7801,-0.780101
England,221,237.176,7.17647,0.289593,230.633,7.45701,0.384615,MB Loye,0,0,0,0,0,0,0,0,6,7,13,6,7,13,0,110,1,0,1,3.42857,0,20.2857,74.7368,7,1,8.01958,-1.01958
Australia,228,239.627,7.69737,0.372807,232.079,7.23246,0.337719,AC Gilchrist,0,0,0,0,0,0,0,0,16,6,22,16,6,22,111,111,5,1,1,4.3,0.275,31.425,96.1009,40,0,9.75607,-3.75607
England,221,237.176,7.17647,0.289593,230.633,7.45701,0.384615,EC Joyce,0,0,0,0,0,0,0,0,4,9,13,4,9,13,0,292,4,0,1,3.08571,0.2,28.3429,68.6505,35,4,7.7801,1.2199
Australia,228,239.627,7.69737,0.372807,232.079,7.23246,0.337719,ML Hayden,0,0,0,0,0,0,0,0,8,6,14,8,6,14,293,200,5,1,1,6.37838,0.378378,50.6757,83.3333,37,4,8.6203,-2.6203
New Zealand,184,233.745,7.39674,0.36413,227.951,7.30435,0.353261,BB McCullum,0,0,0,0,0,0,0,0,22,3,25,22,3,25,0,205,0,0,1,3.98611,0.201389,29.9028,98.4004,144,0,7.17241,-4.17241
New Zealand,184,233.745,7.39674,0.36413,227.951,7.30435,0.353261,SP Fleming,0,0,0,0,0,0,0,0,4,4,8,4,4,8,0,210,4,0,1,3.875,0.25,30.2917,70.9268,24,4,6.85021,-2.85021
New Zealand,184,233.745,7.39674,0.36413,227.951,7.30435,0.353261,PG Fulton,0,0,0,0,0,0,0,0,4,4,8,4,4,8,0,210,4,0,1,2.75,0.1875,27.4062,67.4615,32,4,6.85021,-2.85021
England,221,237.176,7.17647,0.289593,230.633,7.45701,0.384615,AJ Strauss,0,0,0,0,0,0,0,0,8,9,17,8,9,17,211,120,2,0,1,3.93243,0.27027,33.9054,79.8028,74,4,7.55927,1.44073
New Zealand,184,233.745,7.39674,0.36413,227.951,7.30435,0.353261,L Vincent,0,0,0,0,0,0,0,0,16,7,23,16,7,23,0,318,9,0,1,3.125,0.25,27.8125,67.5266,16,4,6.85021,0.149788
England,221,237.176,7.17647,0.289593,230.633,7.45701,0.384615,IR Bell,0,0,0,0,0,0,0,0,18,7,25,18,7,25,319,260,2,0,1,3.63433,0.246269,35.3806,75.6623,134,4,8.18844,-1.18844
Australia,228,239.627,7.69737,0.372807,232.079,7.23246,0.337719,ML Hayden,0,0,0,0,0,0,0,0,16,7,23,16,7,23,0,252,6,1,1,6.37838,0.378378,50.6757,83.3333,37,4,8.21609,-1.21609
England,221,237.176,7.17647,0.289593,230.633,7.45701,0.384615,IR Bell,0,0,0,0,0,0,0,0,8,6,14,8,6,14,253,253,0,0,1,3.63433,0.246269,35.3806,75.6623,134,4,7.87362,-1.87362
England,221,237.176,7.17647,0.289593,230.633,7.45701,0.384615,MB Loye,0,0,0,0,0,0,0,0,16,3,19,16,3,19,0,246,4,0,1,3.42857,0,20.2857,74.7368,7,1,8.01958,-5.01958
Australia,228,239.627,7.69737,0.372807,232.079,7.23246,0.337719,ML Hayden,0,0,0,0,0,0,0,0,12,17,29,12,17,29,247,152,6,1,1,6.37838,0.378378,50.6757,83.3333,37,4,10.5009,6.49911
Bangladesh,160,218.438,7.70625,0.4,211.106,7.05,0.325,Shahriar Nafees,0,0,0,0,0,0,0,0,4,5,9,4,5,9,303,265,10,0,1,3.40541,0.162162,24.4865,69.1076,37,4,7.59589,-2.59589
Sri Lanka,244,223.373,7.09016,0.344262,227.578,7.47541,0.385246,ST Jayasuriya,0,0,0,0,0,0,0,0,8,7,15,8,7,15,0,285,4,0,1,4.91549,0.211268,33.9859,98.4898,71,0,7.37712,-0.377121
Zimbabwe,142,212.077,7.5,0.380282,227.704,6.97887,0.316901,H Masakadza,0,0,0,0,0,0,0,0,4,6,10,4,6,10,286,141,3,0,1,3.11215,0.186916,26.972,70.0485,107,4,7.00143,-1.00143
Bangladesh,160,218.438,7.70625,0.4,211.106,7.05,0.325,Aftab Ahmed,0,0,0,0,0,0,0,0,8,5,13,8,5,13,0,161,1,0,1,2.44118,0.0882353,19.1471,73.8095,34,1,8.28946,-3.28946
West Indies,176,217.33,7.15909,0.3125,225.278,7.57386,0.380682,CH Gayle,0,0,0,0,0,0,0,0,12,6,18,12,6,18,162,164,2,0,1,4.58621,0.206897,31.1293,89.4255,116,4,7.11262,-1.11262
West Indies,176,217.33,7.15909,0.3125,225.278,7.57386,0.380682,S Chanderpaul,0,0,0,0,0,0,0,0,12,6,18,12,6,18,162,164,2,0,1,3.57143,0.396825,40.8254,68.0783,63,4,7.11262,-1.11262
Zimbabwe,142,212.077,7.5,0.380282,227.704,6.97887,0.316901,CJ Chibhabha,0,0,0,0,0,0,0,0,8,11,19,8,11,19,232,130,1,0,1,2.56716,0.149254,23.5373,64.7373,67,1,6.34064,4.65936
West Indies,176,217.33,7.15909,0.3125,225.278,7.57386,0.380682,WW Hinds,0,0,0,0,0,0,0,0,8,1,9,8,1,9,0,80,6,0,1,1.11111,0,12,38.9892,9,3,6.1107,-5.1107
Sri Lanka,244,223.373,7.09016,0.344262,227.578,7.47541,0.385246,DPMD Jayawardene,0,0,0,0,0,0,0,0,16,6,22,16,6,22,81,83,2,0,1,3.20833,0.244792,31.6979,79.1109,192,4,8.08216,-2.08216
Sri Lanka,244,223.373,7.09016,0.344262,227.578,7.47541,0.385246,ST Jayasuriya,0,0,0,0,0,0,0,0,16,6,22,16,6,22,81,83,2,0,1,4.91549,0.211268,33.9859,98.4898,71,0,8.07436,-2.07436
New Zealand,184,233.745,7.39674,0.36413,227.951,7.30435,0.353261,SP Fleming,0,0,0,0,0,0,0,0,12,7,19,12,7,19,0,195,3,0,1,3.875,0.25,30.2917,70.9268,24,4,6.85021,0.149788
South Africa,190,234.274,7.4,0.373684,232.363,7.33158,0.342105,GC Smith,0,0,0,0,0,0,0,0,4,7,11,4,7,11,196,108,1,0,1,3.97,0.29,33.57,79.6819,100,4,9.04273,-2.04273
South Africa,190,234.274,7.4,0.373684,232.363,7.33158,0.342105,HH Gibbs,0,0,0,0,0,0,0,0,4,7,11,4,7,11,196,108,1,0,1,4.61538,0.307692,35.6923,83.4157,52,4,9.04273,-2.04273
Sri Lanka,244,223.373,7.09016,0.344262,227.578,7.47541,0.385246,ST Jayasuriya,0,0,0,0,0,0,0,0,8,13,21,8,13,21,0,253,2,0,1,4.91549,0.211268,33.9859,98.4898,71,0,7.37712,5.62288
Australia,228,239.627,7.69737,0.372807,232.079,7.23246,0.337719,SR Watson,0,0,0,0,0,0,0,0,12,8,20,12,8,20,235,224,5,0,1,4.71318,0.286822,37.7907,90.0943,129,4,7.74942,0.250583
New Zealand,184,233.745,7.39674,0.36413,227.951,7.30435,0.353261,SP Fleming,0,0,0,0,0,0,0,0,0,5,5,0,5,5,0,165,11,0,1,3.875,0.25,30.2917,70.9268,24,4,6.85021,-1.85021
New Zealand,184,233.745,7.39674,0.36413,227.951,7.30435,0.353261,NJ Astle,0,0,0,0,0,0,0,0,0,5,5,0,5,5,0,165,11,0,1,2.8,0.1,20,67.5676,10,1,7.08969,-2.08969
Sri Lanka,244,223.373,7.09016,0.344262,227.578,7.47541,0.385246,ST Jayasuriya,0,0,0,0,0,0,0,0,4,4,8,4,4,8,220,141,2,0,1,4.91549,0.211268,33.9859,98.4898,71,0,8.03197,-4.03197
Sri Lanka,244,223.373,7.09016,0.344262,227.578,7.47541,0.385246,DPMD Jayawardene,0,0,0,0,0,0,0,0,4,4,8,4,4,8,220,141,2,0,1,3.20833,0.244792,31.6979,79.1109,192,4,7.75641,-3.75641
India,259,242.378,7.15058,0.339768,244.568,7.12741,0.30888,V Sehwag,0,0,0,0,0,0,0,0,12,8,20,12,8,20,0,223,2,1,1,5.88636,0.238636,38.8295,108.649,88,0,7.05053,0.949474
South Africa,190,234.274,7.4,0.373684,232.363,7.33158,0.342105,HH Dippenaar,0,0,0,0,0,0,0,0,4,5,9,4,5,9,0,213,2,0,1,1.8,0.2,22,54.1872,5,3,7.51493,-2.51493
Pakistan,211,222.621,7.38389,0.393365,235.517,7.54976,0.336493,Imran Farhat,0,0,0,0,0,0,0,0,0,9,9,0,9,9,214,89,4,0,1,3.03333,0.266667,27.0333,62.9658,30,4,7.31618,1.68382
England,221,237.176,7.17647,0.289593,230.633,7.45701,0.384615,IR Bell,0,0,0,0,0,0,0,0,12,17,29,12,17,29,273,276,4,0,1,3.63433,0.246269,35.3806,75.6623,134,4,9.31547,7.68453
India,259,242.378,7.15058,0.339768,244.568,7.12741,0.30888,V Sehwag,0,0,0,0,0,0,0,0,16,9,25,16,9,25,0,249,4,1,1,5.88636,0.238636,38.8295,108.649,88,0,7.05053,1.94947
Australia,228,239.627,7.69737,0.372807,232.079,7.23246,0.337719,AC Gilchrist,0,0,0,0,0,0,0,0,8,10,18,8,10,18,250,252,10,0,1,4.3,0.275,31.425,96.1009,40,0,6.73739,3.26261
South Africa,190,234.274,7.4,0.373684,232.363,7.33158,0.342105,GC Smith,0,0,0,0,0,0,0,0,16,9,25,16,9,25,0,258,2,0,1,3.97,0.29,33.57,79.6819,100,4,7.85679,1.14321
Australia,228,239.627,7.69737,0.372807,232.079,7.23246,0.337719,AC Gilchrist,0,0,0,0,0,0,0,0,4,10,14,4,10,14,139,116,3,0,1,4.3,0.275,31.425,96.1009,40,0,8.52569,1.47431
Pakistan,211,222.621,7.38389,0.393365,235.517,7.54976,0.336493,Mohammad Hafeez,0,0,0,0,0,0,0,0,12,18,30,12,18,30,393,228,0,0,1,4.04511,0.255639,34.3534,78.0625,133,4,11.2323,6.76769
Pakistan,211,222.621,7.38389,0.393365,235.517,7.54976,0.336493,Kamran Akmal,0,0,0,0,0,0,0,0,12,18,30,12,18,30,393,228,0,0,1,3.01124,0.11236,23.0787,81.4433,89,4,11.2323,6.76769
South Africa,190,234.274,7.4,0.373684,232.363,7.33158,0.342105,GC Smith,0,0,0,0,0,0,0,0,24,7,31,24,7,31,352,210,0,1,1,3.97,0.29,33.57,79.6819,100,4,10.1911,-3.19105
Pakistan,211,222.621,7.38389,0.393365,235.517,7.54976,0.336493,Imran Nazir,0,0,0,0,0,0,0,0,0,3,3,0,3,3,0,107,0,0,1,4.66667,0.133333,29,96.0265,15,0,7.50431,-4.50431
Pakistan,211,222.621,7.38389,0.393365,235.517,7.54976,0.336493,Mohammad Hafeez,0,0,0,0,0,0,0,0,10,4,14,10,4,14,0,153,5,0,1,4.04511,0.255639,34.3534,78.0625,133,4,7.14441,-3.14441
Pakistan,211,222.621,7.38389,0.393365,235.517,7.54976,0.336493,Younis Khan,0,0,0,0,0,0,0,0,10,4,14,10,4,14,0,153,5,0,1,2.64655,0.215517,28.5,73.2713,116,4,7.14441,-3.14441
Sri Lanka,244,223.373,7.09016,0.344262,227.578,7.47541,0.385246,WU Tharanga,0,0,0,0,0,0,0,0,4,10,14,4,10,14,0,112,0,0,1,3.93985,0.263158,32.9699,71.6035,133,4,7.38489,2.61511
New Zealand,184,233.745,7.39674,0.36413,227.951,7.30435,0.353261,LRPL Taylor,0,0,0,0,0,0,0,0,16,6,22,16,6,22,113,110,6,1,1,3.68382,0.301471,36.7206,79.3959,136,4,9.02051,-3.02051
New Zealand,184,233.745,7.39674,0.36413,227.951,7.30435,0.353261,DL Vettori,0,0,0,0,0,0,0,0,16,6,22,16,6,22,113,110,6,1,1,1.43662,0.028169,15.7606,86.0108,71,0,9.01271,-3.01271
New Zealand,184,233.745,7.39674,0.36413,227.951,7.30435,0.353261,HJH Marshall,0,0,0,0,0,0,0,0,16,1,17,16,1,17,263,73,0,1,1,1.1,0.1,11.4,69.5122,10,1,6.81399,-5.81399
New Zealand,184,233.745,7.39674,0.36413,227.951,7.30435,0.353261,L Vincent,0,0,0,0,0,0,0,0,14,12,26,14,12,26,337,340,1,1,1,3.125,0.25,27.8125,67.5266,16,4,11.528,0.472035
New Zealand,184,233.745,7.39674,0.36413,227.951,7.30435,0.353261,SP Fleming,0,0,0,0,0,0,0,0,14,12,26,14,12,26,337,340,1,1,1,3.875,0.25,30.2917,70.9268,24,4,11.528,0.472035
New Zealand,184,233.745,7.39674,0.36413,227.951,7.30435,0.353261,L Vincent,0,0,0,0,0,0,0,0,16,7,23,16,7,23,347,350,7,1,1,3.125,0.25,27.8125,67.5266,16,4,8.43563,-1.43563
New Zealand,184,233.745,7.39674,0.36413,227.951,7.30435,0.353261,SP Fleming,0,0,0,0,0,0,0,0,16,7,23,16,7,23,347,350,7,1,1,3.875,0.25,30.2917,70.9268,24,4,8.43563,-1.43563
Zimbabwe,142,212.077,7.5,0.380282,227.704,6.97887,0.316901,T Duffin,0,0,0,0,0,0,0,0,0,5,5,0,5,5,0,201,3,0,1,4,0.25,35.75,62.1739,4,4,5.82223,-0.822227
West Indies,176,217.33,7.15909,0.3125,225.278,7.57386,0.380682,RR Sarwan,0,0,0,0,0,0,0,0,24,7,31,24,7,31,310,141,6,0,1,2.8254,0.222222,29.1429,69.1005,63,4,7.03164,-0.031642
Australia,228,239.627,7.69737,0.372807,232.079,7.23246,0.337719,SM Katich,0,0,0,0,0,0,0,0,12,6,18,12,6,18,0,272,2,0,1,2.33333,0,18.6667,50.4505,3,3,5.88322,0.116776
India,259,242.378,7.15058,0.339768,244.568,7.12741,0.30888,SK Raina,0,0,0,0,0,0,0,0,12,5,17,12,5,17,0,162,6,0,1,3.11111,0.216374,28.9064,91.8944,171,0,8.36621,-3.36621
India,259,242.378,7.15058,0.339768,244.568,7.12741,0.30888,R Dravid,0,0,0,0,0,0,0,0,4,12,16,4,12,16,214,195,4,0,1,2.83721,0.255814,29.8605,72.7067,43,4,9.05616,2.94384
Australia,228,239.627,7.69737,0.372807,232.079,7.23246,0.337719,SR Watson,0,0,0,0,0,0,0,0,4,5,9,4,5,9,0,240,2,0,1,4.71318,0.286822,37.7907,90.0943,129,4,7.87937,-2.87937
Australia,228,239.627,7.69737,0.372807,232.079,7.23246,0.337719,SM Katich,0,0,0,0,0,0,0,0,4,5,9,4,5,9,0,240,2,0,1,2.33333,0,18.6667,50.4505,3,3,5.88322,-0.883224
Zimbabwe,142,212.077,7.5,0.380282,227.704,6.97887,0.316901,T Duffin,0,0,0,0,0,0,0,0,4,9,13,4,9,13,419,247,7,0,1,4,0.25,35.75,62.1739,4,4,7.90602,1.09398
West Indies,176,217.33,7.15909,0.3125,225.278,7.57386,0.380682,MN Samuels,0,0,0,0,0,0,0,0,0,4,4,0,4,4,0,151,1,0,1,3.74757,0.23301,31.6214,74.5821,103,4,5.82675,-1.82675
Pakistan,211,222.621,7.38389,0.393365,235.517,7.54976,0.336493,Imran Farhat,0,0,0,0,0,0,0,0,0,4,4,0,4,4,0,209,3,1,1,3.03333,0.266667,27.0333,62.9658,30,4,6.59393,-2.59393
West Indies,176,217.33,7.15909,0.3125,225.278,7.57386,0.380682,LMP Simmons,0,0,0,0,0,0,0,0,16,3,19,16,3,19,210,212,5,0,1,3.3125,0.28125,30.5938,71.4338,64,4,5.45964,-2.45964
West Indies,176,217.33,7.15909,0.3125,225.278,7.57386,0.380682,MN Samuels,0,0,0,0,0,0,0,0,16,3,19,16,3,19,210,212,5,0,1,3.74757,0.23301,31.6214,74.5821,103,4,5.45964,-2.45964
West Indies,176,217.33,7.15909,0.3125,225.278,7.57386,0.380682,S Chanderpaul,0,0,0,0,0,0,0,0,12,10,22,12,10,22,0,238,0,0,1,3.57143,0.396825,40.8254,68.0783,63,4,5.82675,4.17325
Pakistan,211,222.621,7.38389,0.393365,235.517,7.54976,0.336493,Mohammad Hafeez,0,0,0,0,0,0,0,0,12,3,15,12,3,15,239,239,3,0,1,4.04511,0.255639,34.3534,78.0625,133,4,7.05964,-4.05964
West Indies,176,217.33,7.15909,0.3125,225.278,7.57386,0.380682,S Chanderpaul,0,0,0,0,0,0,0,0,4,5,9,4,5,9,226,146,3,0,1,3.57143,0.396825,40.8254,68.0783,63,4,5.48139,-0.481385
England,221,237.176,7.17647,0.289593,230.633,7.45701,0.384615,AN Cook,0,0,0,0,0,0,0,0,8,5,13,8,5,13,290,196,2,1,1,4.17045,0.272727,35.75,75.5524,88,4,8.01028,-3.01028
England,221,237.176,7.17647,0.289593,230.633,7.45701,0.384615,AN Cook,0,0,0,0,0,0,0,0,8,8,16,8,8,16,0,281,2,1,1,4.17045,0.272727,35.75,75.5524,88,4,7.83019,0.169808
India,259,242.378,7.15058,0.339768,244.568,7.12741,0.30888,KD Karthik,0,0,0,0,0,0,0,0,16,2,18,16,2,18,0,212,4,0,1,2.46429,0.107143,21.6786,71.8769,56,1,8.42316,-6.42316
England,221,237.176,7.17647,0.289593,230.633,7.45701,0.384615,MJ Prior,0,0,0,0,0,0,0,0,16,14,30,16,14,30,213,213,1,1,1,2.27083,0.0625,21.6875,76.4879,48,4,7.5607,6.4393
England,221,237.176,7.17647,0.289593,230.633,7.45701,0.384615,AN Cook,0,0,0,0,0,0,0,0,0,12,12,0,12,12,325,242,0,1,1,4.17045,0.272727,35.75,75.5524,88,4,7.82214,4.17786
India,259,242.378,7.15058,0.339768,244.568,7.12741,0.30888,SC Ganguly,0,0,0,0,0,0,0,0,12,9,21,12,9,21,0,187,0,0,1,4.56,0.36,36.8,68.2999,25,4,8.07854,0.921461
England,221,237.176,7.17647,0.289593,230.633,7.45701,0.384615,IR Bell,0,0,0,0,0,0,0,0,0,11,11,0,11,11,188,188,12,1,1,3.63433,0.246269,35.3806,75.6623,134,4,10.6332,0.366767
South Africa,190,234.274,7.4,0.373684,232.363,7.33158,0.342105,LE Bosman,0,0,0,0,0,0,0,0,12,9,21,12,9,21,153,156,3,1,1,4.18182,0.181818,27.1818,97.7124,11,0,8.3767,0.623302
South Africa,190,234.274,7.4,0.373684,232.363,7.33158,0.342105,HH Dippenaar,0,0,0,0,0,0,0,0,12,9,21,12,9,21,153,156,3,1,1,1.8,0.2,22,54.1872,5,3,8.19934,0.800655
Zimbabwe,142,212.077,7.5,0.380282,227.704,6.97887,0.316901,S Matsikenyeri,0,0,0,0,0,0,0,0,4,4,8,4,4,8,0,217,6,0,1,2,0.106383,19.9787,75.7869,47,1,6.44168,-2.44168
Zimbabwe,142,212.077,7.5,0.380282,227.704,6.97887,0.316901,S Matsikenyeri,0,0,0,0,0,0,0,0,4,10,14,4,10,14,221,194,4,0,1,2,0.106383,19.9787,75.7869,47,1,6.87487,3.12513
Zimbabwe,142,212.077,7.5,0.380282,227.704,6.97887,0.316901,TMK Mawoyo,0,0,0,0,0,0,0,0,4,9,13,4,9,13,0,146,4,0,1,0.571429,0,8.28571,34.9398,7,3,6.20731,2.79269
West Indies,176,217.33,7.15909,0.3125,225.278,7.57386,0.380682,MN Samuels,0,0,0,0,0,0,0,0,16,4,20,16,4,20,269,270,15,0,1,3.74757,0.23301,31.6214,74.5821,103,4,6.7574,-2.7574
India,259,242.378,7.15058,0.339768,244.568,7.12741,0.30888,SC Ganguly,0,0,0,0,0,0,0,0,20,8,28,20,8,28,0,341,1,1,1,4.56,0.36,36.8,68.2999,25,4,6.85241,1.14759
Sri Lanka,244,223.373,7.09016,0.344262,227.578,7.47541,0.385246,WU Tharanga,0,0,0,0,0,0,0,0,14,8,22,14,8,22,0,257,4,0,1,3.93985,0.263158,32.9699,71.6035,133,4,7.38489,0.615109
Sri Lanka,244,223.373,7.09016,0.344262,227.578,7.47541,0.385246,MS Atapattu,0,0,0,0,0,0,0,0,14,8,22,14,8,22,0,257,4,0,1,2.63636,0,24.4545,66.9154,11,4,7.38489,0.615109
India,259,242.378,7.15058,0.339768,244.568,7.12741,0.30888,SC Ganguly,0,0,0,0,0,0,0,0,24,3,27,24,3,27,231,233,8,1,1,4.56,0.36,36.8,68.2999,25,4,7.5505,-4.5505
India,259,242.378,7.15058,0.339768,244.568,7.12741,0.30888,G Gambhir,0,0,0,0,0,0,0,0,28,6,34,28,6,34,251,251,1,0,1,3.99145,0.333333,37.4701,84.1944,117,4,8.48141,-2.48141
India,259,242.378,7.15058,0.339768,244.568,7.12741,0.30888,V Sehwag,0,0,0,0,0,0,0,0,28,6,34,28,6,34,251,251,1,0,1,5.88636,0.238636,38.8295,108.649,88,0,7.06856,-1.06856
India,259,242.378,7.15058,0.339768,244.568,7.12741,0.30888,G Gambhir,0,0,0,0,0,0,0,0,12,8,20,12,8,20,0,284,3,0,1,3.99145,0.333333,37.4701,84.1944,117,4,8.07854,-0.0785389
England,221,237.176,7.17647,0.289593,230.633,7.45701,0.384615,P Mustard,0,0,0,0,0,0,0,0,16,9,25,16,9,25,270,150,0,0,1,3.33333,0.111111,23.8889,88.1148,9,0,7.84771,1.15229
England,221,237.176,7.17647,0.289593,230.633,7.45701,0.384615,AN Cook,0,0,0,0,0,0,0,0,4,6,10,4,6,10,0,234,0,0,1,4.17045,0.272727,35.75,75.5524,88,4,7.7801,-1.7801
England,221,237.176,7.17647,0.289593,230.633,7.45701,0.384615,P Mustard,0,0,0,0,0,0,0,0,4,6,10,4,6,10,0,234,0,0,1,3.33333,0.111111,23.8889,88.1148,9,0,8.1023,-2.1023
England,221,237.176,7.17647,0.289593,230.633,7.45701,0.384615,IR Bell,0,0,0,0,0,0,0,0,4,6,10,4,6,10,0,234,0,0,1,3.63433,0.246269,35.3806,75.6623,134,4,7.7801,-1.7801
Sri Lanka,244,223.373,7.09016,0.344262,227.578,7.47541,0.385246,WU Tharanga,0,0,0,0,0,0,0,0,8,10,18,8,10,18,235,169,1,1,1,3.93985,0.263158,32.9699,71.6035,133,4,8.00041,1.99959
Sri Lanka,244,223.373,7.09016,0.344262,227.578,7.47541,0.385246,ST Jayasuriya,0,0,0,0,0,0,0,0,4,1,5,4,1,5,0,211,4,1,1,4.91549,0.211268,33.9859,98.4898,71,0,7.84505,-6.84505
Sri Lanka,244,223.373,7.09016,0.344262,227.578,7.47541,0.385246,MDK Perera,0,0,0,0,0,0,0,0,14,16,30,14,16,30,0,211,3,1,1,1,0,11,54.321,4,3,7.11251,8.88749
England,221,237.176,7.17647,0.289593,230.633,7.45701,0.384615,IR Bell,0,0,0,0,0,0,0,0,0,6,6,0,6,6,212,104,1,0,1,3.63433,0.246269,35.3806,75.6623,134,4,7.85438,-1.85438
Australia,228,239.627,7.69737,0.372807,232.079,7.23246,0.337719,ML Hayden,0,0,0,0,0,0,0,0,26,24,50,26,24,50,255,255,1,1,1,6.37838,0.378378,50.6757,83.3333,37,4,8.18996,15.81
New Zealand,184,233.745,7.39674,0.36413,227.951,7.30435,0.353261,BB McCullum,0,0,0,0,0,0,0,0,4,5,9,4,5,9,283,168,0,0,1,3.98611,0.201389,29.9028,98.4004,144,0,7.66399,-2.66399
Sri Lanka,244,223.373,7.09016,0.344262,227.578,7.47541,0.385246,ST Jayasuriya,0,0,0,0,0,0,0,0,8,9,17,8,9,17,254,125,1,0,1,4.91549,0.211268,33.9859,98.4898,71,0,7.00118,1.99882
Australia,228,239.627,7.69737,0.372807,232.079,7.23246,0.337719,AC Gilchrist,0,0,0,0,0,0,0,0,20,10,30,20,10,30,0,159,7,1,1,4.3,0.275,31.425,96.1009,40,0,8.37367,1.62633
India,259,242.378,7.15058,0.339768,244.568,7.12741,0.30888,SR Tendulkar,0,0,0,0,0,0,0,0,20,9,29,20,9,29,160,160,1,0,1,5.89773,0.363636,45.6023,84.5376,88,4,8.66104,0.338957
Sri Lanka,244,223.373,7.09016,0.344262,227.578,7.47541,0.385246,TM Dilshan,0,0,0,0,0,0,0,0,20,8,28,20,8,28,237,173,8,0,1,4.60199,0.273632,38.3632,86.0219,201,4,8.14498,-0.144983
India,259,242.378,7.15058,0.339768,244.568,7.12741,0.30888,IK Pathan,0,0,0,0,0,0,0,0,12,8,20,12,8,20,204,153,1,0,1,1.875,0.025,16.85,78.2811,40,1,8.76105,-0.761054
Sri Lanka,244,223.373,7.09016,0.344262,227.578,7.47541,0.385246,TM Dilshan,0,0,0,0,0,0,0,0,4,3,7,4,3,7,0,238,0,0,1,4.60199,0.273632,38.3632,86.0219,201,4,7.38489,-4.38489
Australia,228,239.627,7.69737,0.372807,232.079,7.23246,0.337719,AC Gilchrist,0,0,0,0,0,0,0,0,4,8,12,4,8,12,0,184,0,1,1,4.3,0.275,31.425,96.1009,40,0,8.37367,-0.373667
Sri Lanka,244,223.373,7.09016,0.344262,227.578,7.47541,0.385246,KC Sangakkara,0,0,0,0,0,0,0,0,0,8,8,0,8,8,185,77,0,0,1,4.33659,0.360976,41.9854,80.6276,205,4,8.96515,-0.965145
Sri Lanka,244,223.373,7.09016,0.344262,227.578,7.47541,0.385246,DPMD Jayawardene,0,0,0,0,0,0,0,0,0,8,8,0,8,8,185,77,0,0,1,3.20833,0.244792,31.6979,79.1109,192,4,8.96515,-0.965145
India,259,242.378,7.15058,0.339768,244.568,7.12741,0.30888,SR Tendulkar,0,0,0,0,0,0,0,0,16,8,24,16,8,24,318,299,2,0,1,5.89773,0.363636,45.6023,84.5376,88,4,8.59897,-0.598969
Sri Lanka,244,223.373,7.09016,0.344262,227.578,7.47541,0.385246,ST Jayasuriya,0,0,0,0,0,0,0,0,4,8,12,4,8,12,0,221,0,0,1,4.91549,0.211268,33.9859,98.4898,71,0,7.37712,0.622879
Sri Lanka,244,223.373,7.09016,0.344262,227.578,7.47541,0.385246,KC Sangakkara,0,0,0,0,0,0,0,0,4,8,12,4,8,12,0,221,0,0,1,4.33659,0.360976,41.9854,80.6276,205,4,7.38489,0.615109
Australia,228,239.627,7.69737,0.372807,232.079,7.23246,0.337719,MJ Clarke,0,0,0,0,0,0,0,0,12,9,21,12,9,21,0,239,2,1,1,3.10294,0.301471,35.9265,74.0303,136,4,8.21609,0.783907
India,259,242.378,7.15058,0.339768,244.568,7.12741,0.30888,RV Uthappa,0,0,0,0,0,0,0,0,0,13,13,0,13,13,0,258,1,0,1,3,0.117647,22.1471,89.0071,34,0,8.36621,4.63379
Australia,228,239.627,7.69737,0.372807,232.079,7.23246,0.337719,ML Hayden,0,0,0,0,0,0,0,0,4,9,13,4,9,13,259,249,0,1,1,6.37838,0.378378,50.6757,83.3333,37,4,8.18996,0.810038
South Africa,190,234.274,7.4,0.373684,232.363,7.33158,0.342105,MN van Wyk,0,0,0,0,0,0,0,0,0,5,5,0,5,5,0,226,2,0,1,3.33333,0.266667,27.2,66.9951,15,4,7.85679,-2.85679
India,259,242.378,7.15058,0.339768,244.568,7.12741,0.30888,SR Tendulkar,0,0,0,0,0,0,0,0,16,4,20,16,4,20,227,227,1,0,1,5.89773,0.363636,45.6023,84.5376,88,4,7.27324,-3.27324
India,259,242.378,7.15058,0.339768,244.568,7.12741,0.30888,SC Ganguly,0,0,0,0,0,0,0,0,12,8,20,12,8,20,149,152,2,0,1,4.56,0.36,36.8,68.2999,25,4,8.31538,-0.315384
Sri Lanka,244,223.373,7.09016,0.344262,227.578,7.47541,0.385246,ST Jayasuriya,0,0,0,0,0,0,0,0,12,9,21,12,9,21,138,141,6,1,1,4.91549,0.211268,33.9859,98.4898,71,0,8.6654,0.334596
Bangladesh,160,218.438,7.70625,0.4,211.106,7.05,0.325,Mushfiqur Rahim,0,0,0,0,0,0,0,0,4,6,10,4,6,10,197,157,14,0,1,2.61111,0.18254,27.7778,75.2526,126,4,7.31618,-1.31618
England,221,237.176,7.17647,0.289593,230.633,7.45701,0.384615,IR Bell,0,0,0,0,0,0,0,0,18,5,23,18,5,23,0,307,4,1,1,3.63433,0.246269,35.3806,75.6623,134,4,7.83019,-2.83019
New Zealand,184,233.745,7.39674,0.36413,227.951,7.30435,0.353261,BB McCullum,0,0,0,0,0,0,0,0,18,12,30,18,12,30,308,193,4,0,1,3.98611,0.201389,29.9028,98.4004,144,0,8.11107,3.88893
New Zealand,184,233.745,7.39674,0.36413,227.951,7.30435,0.353261,JM How,0,0,0,0,0,0,0,0,8,5,13,8,5,13,246,246,1,0,1,3.34615,0.192308,29.9231,64.9416,26,4,7.80792,-2.80792
England,221,237.176,7.17647,0.289593,230.633,7.45701,0.384615,MJ Prior,0,0,0,0,0,0,0,0,12,13,25,12,13,25,0,275,2,1,1,2.27083,0.0625,21.6875,76.4879,48,4,7.83019,5.16981
South Africa,190,234.274,7.4,0.373684,232.363,7.33158,0.342105,HH Gibbs,0,0,0,0,0,0,0,0,8,14,22,8,14,22,276,255,3,0,1,4.61538,0.307692,35.6923,83.4157,52,4,8.66309,5.33691
South Africa,190,234.274,7.4,0.373684,232.363,7.33158,0.342105,GC Smith,0,0,0,0,0,0,0,0,8,14,22,8,14,22,276,255,3,0,1,3.97,0.29,33.57,79.6819,100,4,8.66309,5.33691
South Africa,190,234.274,7.4,0.373684,232.363,7.33158,0.342105,JH Kallis,0,0,0,0,0,0,0,0,12,8,20,12,8,20,0,83,1,0,1,3.58621,0.356322,37.2644,76.4442,87,4,7.85679,0.143212
England,221,237.176,7.17647,0.289593,230.633,7.45701,0.384615,IR Bell,0,0,0,0,0,0,0,0,8,9,17,8,9,17,84,85,4,1,1,3.63433,0.246269,35.3806,75.6623,134,4,9.92699,-0.926992
South Africa,190,234.274,7.4,0.373684,232.363,7.33158,0.342105,HH Gibbs,0,0,0,0,0,0,0,0,0,9,9,0,9,9,297,170,1,0,1,4.61538,0.307692,35.6923,83.4157,52,4,9.27275,-0.272745
South Africa,190,234.274,7.4,0.373684,232.363,7.33158,0.342105,HH Gibbs,0,0,0,0,0,0,0,0,24,7,31,24,7,31,0,183,5,0,1,4.61538,0.307692,35.6923,83.4157,52,4,7.85679,-0.856788
India,259,242.378,7.15058,0.339768,244.568,7.12741,0.30888,RV Uthappa,0,0,0,0,0,0,0,0,4,9,13,4,9,13,291,243,2,1,1,3,0.117647,22.1471,89.0071,34,0,7.01615,1.98385
Australia,228,239.627,7.69737,0.372807,232.079,7.23246,0.337719,MJ Clarke,0,0,0,0,0,0,0,0,26,7,33,26,7,33,0,317,1,0,1,3.10294,0.301471,35.9265,74.0303,136,4,7.87937,-0.879366
Australia,228,239.627,7.69737,0.372807,232.079,7.23246,0.337719,RT Ponting,0,0,0,0,0,0,0,0,4,10,14,4,10,14,0,193,10,0,1,4.17431,0.33945,38.1009,80.8606,109,4,7.87937,2.12063
India,259,242.378,7.15058,0.339768,244.568,7.12741,0.30888,Yuvraj Singh,0,0,0,0,0,0,0,0,8,1,9,8,1,9,194,195,7,1,1,4.05833,0.258333,32.525,83.8093,120,4,5.86998,-4.86998
Pakistan,211,222.621,7.38389,0.393365,235.517,7.54976,0.336493,Salman Butt,0,0,0,0,0,0,0,0,16,4,20,16,4,20,0,239,2,0,1,5.4359,0.384615,42.3846,78.8645,39,4,7.14441,-3.14441
Pakistan,211,222.621,7.38389,0.393365,235.517,7.54976,0.336493,Kamran Akmal,0,0,0,0,0,0,0,0,16,4,20,16,4,20,0,239,2,0,1,3.01124,0.11236,23.0787,81.4433,89,4,7.14441,-3.14441
Pakistan,211,222.621,7.38389,0.393365,235.517,7.54976,0.336493,Salman Butt,0,0,0,0,0,0,0,0,12,9,21,12,9,21,322,322,13,0,1,5.4359,0.384615,42.3846,78.8645,39,4,8.14583,0.854166
India,259,242.378,7.15058,0.339768,244.568,7.12741,0.30888,RV Uthappa,0,0,0,0,0,0,0,0,16,5,21,16,5,21,307,275,3,1,1,3,0.117647,22.1471,89.0071,34,0,7.01615,-2.01615
New Zealand,184,233.745,7.39674,0.36413,227.951,7.30435,0.353261,BB McCullum,0,0,0,0,0,0,0,0,8,10,18,8,10,18,210,210,0,0,1,3.98611,0.201389,29.9028,98.4004,144,0,7.53159,2.46841
New Zealand,184,233.745,7.39674,0.36413,227.951,7.30435,0.353261,BB McCullum,0,0,0,0,0,0,0,0,4,8,12,4,8,12,0,238,4,0,1,3.98611,0.201389,29.9028,98.4004,144,0,7.17241,0.827588
West Indies,176,217.33,7.15909,0.3125,225.278,7.57386,0.380682,DS Smith,0,0,0,0,0,0,0,0,4,11,15,4,11,15,0,175,6,0,1,2.61765,0.147059,23.5588,71.2,34,4,5.82675,5.17325
West Indies,176,217.33,7.15909,0.3125,225.278,7.57386,0.380682,RS Morton,0,0,0,0,0,0,0,0,4,7,11,4,7,11,256,169,2,0,1,2.2963,0.222222,28.8889,67.0103,27,4,7.9253,-0.925297
West Indies,176,217.33,7.15909,0.3125,225.278,7.57386,0.380682,BA Parchment,0,0,0,0,0,0,0,0,12,5,17,12,5,17,0,252,1,0,1,2.33333,0,17.8333,54.0404,6,3,6.1107,-1.1107
South Africa,190,234.274,7.4,0.373684,232.363,7.33158,0.342105,HH Gibbs,0,0,0,0,0,0,0,0,12,4,16,12,4,16,264,266,2,1,1,4.61538,0.307692,35.6923,83.4157,52,4,7.65828,-3.65828
Pakistan,211,222.621,7.38389,0.393365,235.517,7.54976,0.336493,Mohammad Hafeez,0,0,0,0,0,0,0,0,12,8,20,12,8,20,295,249,0,1,1,4.04511,0.255639,34.3534,78.0625,133,4,7.52252,0.477476
South Africa,190,234.274,7.4,0.373684,232.363,7.33158,0.342105,AB de Villiers,0,0,0,0,0,0,0,0,8,11,19,8,11,19,266,240,5,0,1,5.04969,0.403727,47.2174,98.8428,161,4,8.31314,2.68686
Pakistan,211,222.621,7.38389,0.393365,235.517,7.54976,0.336493,Younis Khan,0,0,0,0,0,0,0,0,0,6,6,0,6,6,0,230,1,1,1,2.64655,0.215517,28.5,73.2713,116,4,6.59393,-0.593931
South Africa,190,234.274,7.4,0.373684,232.363,7.33158,0.342105,HH Gibbs,0,0,0,0,0,0,0,0,12,16,28,12,16,28,231,233,1,0,1,4.61538,0.307692,35.6923,83.4157,52,4,8.25529,7.74471
Pakistan,211,222.621,7.38389,0.393365,235.517,7.54976,0.336493,Imran Nazir,0,0,0,0,0,0,0,0,28,2,30,28,2,30,234,219,1,1,1,4.66667,0.133333,29,96.0265,15,0,7.57557,-5.57557
New Zealand,184,233.745,7.39674,0.36413,227.951,7.30435,0.353261,BB McCullum,0,0,0,0,0,0,0,0,8,8,16,8,8,16,0,335,5,1,1,3.98611,0.201389,29.9028,98.4004,144,0,6.7086,1.2914
Bangladesh,160,218.438,7.70625,0.4,211.106,7.05,0.325,Tamim Iqbal,0,0,0,0,0,0,0,0,4,3,7,4,3,7,0,93,0,0,1,4.05344,0.274809,31.8015,76.8068,131,4,7.85483,-4.85483
Bangladesh,160,218.438,7.70625,0.4,211.106,7.05,0.325,Junaid Siddique,0,0,0,0,0,0,0,0,4,3,7,4,3,7,0,93,0,0,1,2.16279,0.116279,20.0233,68.225,43,1,8.28946,-5.28946
Bangladesh,160,218.438,7.70625,0.4,211.106,7.05,0.325,Mohammad Ashraful,0,0,0,0,0,0,0,0,4,3,7,4,3,7,0,93,0,0,1,2.17722,0.113924,19.4557,63.9085,79,1,8.28946,-5.28946
England,221,237.176,7.17647,0.289593,230.633,7.45701,0.384615,AN Cook,0,0,0,0,0,0,0,0,0,9,9,0,9,9,0,130,3,0,1,4.17045,0.272727,35.75,75.5524,88,4,7.7801,1.2199
England,221,237.176,7.17647,0.289593,230.633,7.45701,0.384615,P Mustard,0,0,0,0,0,0,0,0,0,9,9,0,9,9,0,130,3,0,1,3.33333,0.111111,23.8889,88.1148,9,0,8.1023,0.897698
England,221,237.176,7.17647,0.289593,230.633,7.45701,0.384615,P Mustard,0,0,0,0,0,0,0,0,20,5,25,20,5,25,0,340,1,0,1,3.33333,0.111111,23.8889,88.1148,9,0,8.1023,-3.1023
New Zealand,184,233.745,7.39674,0.36413,227.951,7.30435,0.353261,BB McCullum,0,0,0,0,0,0,0,0,18,16,34,18,16,34,341,340,2,1,1,3.98611,0.201389,29.9028,98.4004,144,0,13.3759,2.62407
England,221,237.176,7.17647,0.289593,230.633,7.45701,0.384615,P Mustard,0,0,0,0,0,0,0,0,0,8,8,0,8,8,0,242,1,0,1,3.33333,0.111111,23.8889,88.1148,9,0,8.1023,-0.102302
Zimbabwe,142,212.077,7.5,0.380282,227.704,6.97887,0.316901,V Sibanda,0,0,0,0,0,0,0,0,12,4,16,12,4,16,0,206,5,1,1,2.9697,0.181818,23.5152,63.5545,66,1,6.12263,-2.12263
Zimbabwe,142,212.077,7.5,0.380282,227.704,6.97887,0.316901,H Masakadza,0,0,0,0,0,0,0,0,8,2,10,8,2,10,0,247,0,1,1,3.11215,0.186916,26.972,70.0485,107,4,6.31573,-4.31573
South Africa,190,234.274,7.4,0.373684,232.363,7.33158,0.342105,GC Smith,0,0,0,0,0,0,0,0,8,9,17,8,9,17,0,323,4,0,1,3.97,0.29,33.57,79.6819,100,4,7.85679,1.14321
West Indies,176,217.33,7.15909,0.3125,225.278,7.57386,0.380682,S Chanderpaul,0,0,0,0,0,0,0,0,4,7,11,4,7,11,275,244,1,0,1,3.57143,0.396825,40.8254,68.0783,63,4,6.7574,0.242604
West Indies,176,217.33,7.15909,0.3125,225.278,7.57386,0.380682,BA Parchment,0,0,0,0,0,0,0,0,4,9,13,4,9,13,233,234,3,0,1,2.33333,0,17.8333,54.0404,6,3,5.86996,3.13004
Sri Lanka,244,223.373,7.09016,0.344262,227.578,7.47541,0.385246,WU Tharanga,0,0,0,0,0,0,0,0,8,4,12,8,4,12,0,235,1,0,1,3.93985,0.263158,32.9699,71.6035,133,4,7.38489,-3.38489
West Indies,176,217.33,7.15909,0.3125,225.278,7.57386,0.380682,CH Gayle,0,0,0,0,0,0,0,0,8,6,14,8,6,14,236,236,0,1,1,4.58621,0.206897,31.1293,89.4255,116,4,6.21279,-0.212791
West Indies,176,217.33,7.15909,0.3125,225.278,7.57386,0.380682,DS Smith,0,0,0,0,0,0,0,0,8,6,14,8,6,14,236,236,0,1,1,2.61765,0.147059,23.5588,71.2,34,4,6.21279,-0.212791
West Indies,176,217.33,7.15909,0.3125,225.278,7.57386,0.380682,CH Gayle,0,0,0,0,0,0,0,0,4,10,14,4,10,14,113,125,1,1,1,4.58621,0.206897,31.1293,89.4255,116,4,7.97506,2.02494
Australia,228,239.627,7.69737,0.372807,232.079,7.23246,0.337719,SE Marsh,0,0,0,0,0,0,0,0,16,13,29,16,13,29,0,273,2,0,1,3.66667,0.291667,35.5417,74.7918,48,4,7.87937,5.12063
West Indies,176,217.33,7.15909,0.3125,225.278,7.57386,0.380682,CH Gayle,0,0,0,0,0,0,0,0,4,8,12,4,8,12,274,189,1,1,1,4.58621,0.206897,31.1293,89.4255,116,4,7.0325,0.967497
West Indies,176,217.33,7.15909,0.3125,225.278,7.57386,0.380682,RR Sarwan,0,0,0,0,0,0,0,0,4,8,12,4,8,12,274,189,1,1,1,2.8254,0.222222,29.1429,69.1005,63,4,7.0325,0.967497
West Indies,176,217.33,7.15909,0.3125,225.278,7.57386,0.380682,ADS Fletcher,0,0,0,0,0,0,0,0,4,2,6,4,2,6,214,140,2,1,1,1.8125,0.125,13.5,62.6087,16,1,6.63302,-4.63302
Australia,228,239.627,7.69737,0.372807,232.079,7.23246,0.337719,SE Marsh,0,0,0,0,0,0,0,0,20,6,26,20,6,26,0,282,5,0,1,3.66667,0.291667,35.5417,74.7918,48,4,7.87937,-1.87937
West Indies,176,217.33,7.15909,0.3125,225.278,7.57386,0.380682,XM Marshall,0,0,0,0,0,0,0,0,20,7,27,20,7,27,283,281,2,1,1,1.5,0,10.5,58.3333,8,3,6.49499,0.505009
Bangladesh,160,218.438,7.70625,0.4,211.106,7.05,0.325,Junaid Siddique,0,0,0,0,0,0,0,0,12,8,20,12,8,20,0,178,1,1,1,2.16279,0.116279,20.0233,68.225,43,1,5.00096,2.99904
South Africa,190,234.274,7.4,0.373684,232.363,7.33158,0.342105,HH Gibbs,0,0,0,0,0,0,0,0,8,6,14,8,6,14,179,180,2,0,1,4.61538,0.307692,35.6923,83.4157,52,4,8.43911,-2.43911
Bangladesh,160,218.438,7.70625,0.4,211.106,7.05,0.325,Shahriar Nafees,0,0,0,0,0,0,0,0,12,3,15,12,3,15,0,173,2,1,1,3.40541,0.162162,24.4865,69.1076,37,4,6.38578,-3.38578
Bangladesh,160,218.438,7.70625,0.4,211.106,7.05,0.325,Tamim Iqbal,0,0,0,0,0,0,0,0,4,4,8,4,4,8,0,143,3,1,1,4.05344,0.274809,31.8015,76.8068,131,4,6.38578,-2.38578
Bangladesh,160,218.438,7.70625,0.4,211.106,7.05,0.325,Shahriar Nafees,0,0,0,0,0,0,0,0,4,4,8,4,4,8,0,143,3,1,1,3.40541,0.162162,24.4865,69.1076,37,4,6.38578,-2.38578
Zimbabwe,142,212.077,7.5,0.380282,227.704,6.97887,0.316901,C Zhuwao,0,0,0,0,0,0,0,0,38,2,40,38,2,40,0,303,3,0,1,3,0,16,72.7273,1,1,6.44168,-4.44168
Ireland,55,219.527,7.65455,0.290909,202.727,7.56364,0.4,GC Wilson,0,0,0,0,0,0,0,0,8,4,12,8,4,12,304,147,4,0,1,2.22727,0.227273,22,78.1906,22,4,7.11814,-3.11814
Zimbabwe,142,212.077,7.5,0.380282,227.704,6.97887,0.316901,H Masakadza,0,0,0,0,0,0,0,0,8,10,18,8,10,18,348,243,7,0,1,3.11215,0.186916,26.972,70.0485,107,4,6.96011,3.03989
Pakistan,211,222.621,7.38389,0.393365,235.517,7.54976,0.336493,Nasir Jamshed,0,0,0,0,0,0,0,0,4,2,6,4,2,6,0,272,2,1,1,3.63043,0.23913,30.2174,73.8184,46,4,6.59393,-4.59393
Zimbabwe,142,212.077,7.5,0.380282,227.704,6.97887,0.316901,SC Williams,0,0,0,0,0,0,0,0,0,6,6,0,6,6,0,244,6,0,1,2.56923,0.276923,28.5385,80.7927,65,4,5.82223,0.177773
Zimbabwe,142,212.077,7.5,0.380282,227.704,6.97887,0.316901,H Masakadza,0,0,0,0,0,0,0,0,4,12,16,4,12,16,0,181,7,0,1,3.11215,0.186916,26.972,70.0485,107,4,5.82223,6.17777
Bangladesh,160,218.438,7.70625,0.4,211.106,7.05,0.325,Mohammad Ashraful,0,0,0,0,0,0,0,0,8,7,15,8,7,15,358,226,0,0,1,2.17722,0.113924,19.4557,63.9085,79,1,6.18773,0.812267
India,259,242.378,7.15058,0.339768,244.568,7.12741,0.30888,RV Uthappa,0,0,0,0,0,0,0,0,12,12,24,12,12,24,284,284,2,0,1,3,0.117647,22.1471,89.0071,34,0,8.38413,3.61587
Sri Lanka,244,223.373,7.09016,0.344262,227.578,7.47541,0.385246,KC Sangakkara,0,0,0,0,0,0,0,0,12,9,21,12,9,21,0,302,4,0,1,4.33659,0.360976,41.9854,80.6276,205,4,7.38489,1.61511
Sri Lanka,244,223.373,7.09016,0.344262,227.578,7.47541,0.385246,DPMD Jayawardene,0,0,0,0,0,0,0,0,12,9,21,12,9,21,0,302,4,0,1,3.20833,0.244792,31.6979,79.1109,192,4,7.38489,1.61511
Bangladesh,160,218.438,7.70625,0.4,211.106,7.05,0.325,Mohammad Ashraful,0,0,0,0,0,0,0,0,4,6,10,4,6,10,333,174,0,0,1,2.17722,0.113924,19.4557,63.9085,79,1,6.98016,-0.980164
Pakistan,211,222.621,7.38389,0.393365,235.517,7.54976,0.336493,Salman Butt,0,0,0,0,0,0,0,0,24,11,35,24,11,35,309,309,0,0,1,5.4359,0.384615,42.3846,78.8645,39,4,7.59589,3.40411
Sri Lanka,244,223.373,7.09016,0.344262,227.578,7.47541,0.385246,KC Sangakkara,0,0,0,0,0,0,0,0,4,9,13,4,9,13,0,308,6,0,1,4.33659,0.360976,41.9854,80.6276,205,4,7.38489,1.61511
Bangladesh,160,218.438,7.70625,0.4,211.106,7.05,0.325,Nazimuddin,0,0,0,0,0,0,0,0,4,17,21,4,17,21,0,115,2,0,1,2,0,14.5,62.2318,10,1,8.28946,8.71054
Sri Lanka,244,223.373,7.09016,0.344262,227.578,7.47541,0.385246,KC Sangakkara,0,0,0,0,0,0,0,0,16,7,23,16,7,23,0,273,0,0,1,4.33659,0.360976,41.9854,80.6276,205,4,7.38489,-0.384891
India,259,242.378,7.15058,0.339768,244.568,7.12741,0.30888,G Gambhir,0,0,0,0,0,0,0,0,24,10,34,24,10,34,274,173,2,0,1,3.99145,0.333333,37.4701,84.1944,117,4,8.41005,1.58995
Bangladesh,160,218.438,7.70625,0.4,211.106,7.05,0.325,Tamim Iqbal,0,0,0,0,0,0,0,0,12,6,18,12,6,18,255,74,1,0,1,4.05344,0.274809,31.8015,76.8068,131,4,8.09637,-2.09637
Bangladesh,160,218.438,7.70625,0.4,211.106,7.05,0.325,Junaid Siddique,0,0,0,0,0,0,0,0,0,8,8,0,8,8,0,117,5,0,1,2.16279,0.116279,20.0233,68.225,43,1,8.28946,-0.289459
Australia,228,239.627,7.69737,0.372807,232.079,7.23246,0.337719,SR Watson,0,0,0,0,0,0,0,0,8,10,18,8,10,18,118,118,6,1,1,4.71318,0.286822,37.7907,90.0943,129,4,9.22148,0.778523
Bangladesh,160,218.438,7.70625,0.4,211.106,7.05,0.325,Junaid Siddique,0,0,0,0,0,0,0,0,4,8,12,4,8,12,199,125,1,0,1,2.16279,0.116279,20.0233,68.225,43,1,7.38264,0.617363
India,259,242.378,7.15058,0.339768,244.568,7.12741,0.30888,SK Raina,0,0,0,0,0,0,0,0,0,8,8,0,8,8,0,146,1,0,1,3.11111,0.216374,28.9064,91.8944,171,0,8.36621,-0.366213
Sri Lanka,244,223.373,7.09016,0.344262,227.578,7.47541,0.385246,KC Sangakkara,0,0,0,0,0,0,0,0,8,9,17,8,9,17,147,147,1,1,1,4.33659,0.360976,41.9854,80.6276,205,4,8.6732,0.326796
Sri Lanka,244,223.373,7.09016,0.344262,227.578,7.47541,0.385246,ST Jayasuriya,0,0,0,0,0,0,0,0,4,4,8,4,4,8,0,142,0,1,1,4.91549,0.211268,33.9859,98.4898,71,0,7.84505,-3.84505
India,259,242.378,7.15058,0.339768,244.568,7.12741,0.30888,IK Pathan,0,0,0,0,0,0,0,0,8,6,14,8,6,14,143,143,3,0,1,1.875,0.025,16.85,78.2811,40,1,8.31538,-2.31538
India,259,242.378,7.15058,0.339768,244.568,7.12741,0.30888,V Kohli,0,0,0,0,0,0,0,0,8,6,14,8,6,14,143,143,3,0,1,4.66456,0.379747,44.9937,88.3325,158,4,8.31538,-2.31538
India,259,242.378,7.15058,0.339768,244.568,7.12741,0.30888,V Kohli,0,0,0,0,0,0,0,0,8,11,19,8,11,19,0,237,6,0,1,4.66456,0.379747,44.9937,88.3325,158,4,8.07854,2.92146
Sri Lanka,244,223.373,7.09016,0.344262,227.578,7.47541,0.385246,ML Udawatte,0,0,0,0,0,0,0,0,4,3,7,4,3,7,0,227,0,1,1,2.33333,0,17.1667,62.0482,6,1,7.66222,-4.66222
Pakistan,211,222.621,7.38389,0.393365,235.517,7.54976,0.336493,Salman Butt,0,0,0,0,0,0,0,0,24,13,37,24,13,37,226,160,4,1,1,5.4359,0.384615,42.3846,78.8645,39,4,8.28872,4.71128
Pakistan,211,222.621,7.38389,0.393365,235.517,7.54976,0.336493,Salman Butt,0,0,0,0,0,0,0,0,4,10,14,4,10,14,0,308,1,1,1,5.4359,0.384615,42.3846,78.8645,39,4,6.59393,3.40607
Bangladesh,160,218.438,7.70625,0.4,211.106,7.05,0.325,Shahriar Nafees,0,0,0,0,0,0,0,0,8,5,13,8,5,13,309,285,4,0,1,3.40541,0.162162,24.4865,69.1076,37,4,7.59589,-2.59589
Bangladesh,160,218.438,7.70625,0.4,211.106,7.05,0.325,Tamim Iqbal,0,0,0,0,0,0,0,0,4,7,11,4,7,11,330,179,1,0,1,4.05344,0.274809,31.8015,76.8068,131,4,7.56662,-0.566623
England,221,237.176,7.17647,0.289593,230.633,7.45701,0.384615,RS Bopara,0,0,0,0,0,0,0,0,12,7,19,12,7,19,261,256,4,1,1,2.22115,0.144231,25.1538,75.9361,104,4,7.57994,-0.579944
England,221,237.176,7.17647,0.289593,230.633,7.45701,0.384615,RS Bopara,0,0,0,0,0,0,0,0,8,6,14,8,6,14,250,210,1,1,1,2.22115,0.144231,25.1538,75.9361,104,4,8.00125,-2.00125
Australia,228,239.627,7.69737,0.372807,232.079,7.23246,0.337719,SR Watson,0,0,0,0,0,0,0,0,4,10,14,4,10,14,229,230,2,0,1,4.71318,0.286822,37.7907,90.0943,129,4,7.74942,2.25058
England,221,237.176,7.17647,0.289593,230.633,7.45701,0.384615,JL Denly,0,0,0,0,0,0,0,0,20,7,27,20,7,27,0,220,2,1,1,3.55556,0.222222,29.3333,63.1579,9,4,7.83019,-0.830192
Australia,228,239.627,7.69737,0.372807,232.079,7.23246,0.337719,TD Paine,0,0,0,0,0,0,0,0,12,7,19,12,7,19,221,221,1,0,1,3.3913,0.217391,27.6522,65.7704,23,4,8.14975,-1.14975
Australia,228,239.627,7.69737,0.372807,232.079,7.23246,0.337719,TD Paine,0,0,0,0,0,0,0,0,8,5,13,8,5,13,0,296,6,0,1,3.3913,0.217391,27.6522,65.7704,23,4,7.87937,-2.87937
Australia,228,239.627,7.69737,0.372807,232.079,7.23246,0.337719,RT Ponting,0,0,0,0,0,0,0,0,8,5,13,8,5,13,0,296,6,0,1,4.17431,0.33945,38.1009,80.8606,109,4,7.87937,-2.87937
Australia,228,239.627,7.69737,0.372807,232.079,7.23246,0.337719,RT Ponting,0,0,0,0,0,0,0,0,16,4,20,16,4,20,0,176,1,0,1,4.17431,0.33945,38.1009,80.8606,109,4,7.87937,-3.87937
England,221,237.176,7.17647,0.289593,230.633,7.45701,0.384615,AJ Strauss,0,0,0,0,0,0,0,0,4,9,13,4,9,13,177,177,11,1,1,3.93243,0.27027,33.9054,79.8028,74,4,7.9569,1.0431
England,221,237.176,7.17647,0.289593,230.633,7.45701,0.384615,JL Denly,0,0,0,0,0,0,0,0,4,9,13,4,9,13,177,177,11,1,1,3.55556,0.222222,29.3333,63.1579,9,4,7.9569,1.0431
South Africa,190,234.274,7.4,0.373684,232.363,7.33158,0.342105,GC Smith,0,0,0,0,0,0,0,0,12,8,20,12,8,20,287,145,2,1,1,3.97,0.29,33.57,79.6819,100,4,8.00822,-0.00821877
South Africa,190,234.274,7.4,0.373684,232.363,7.33158,0.342105,HH Gibbs,0,0,0,0,0,0,0,0,12,8,20,12,8,20,287,145,2,1,1,4.61538,0.307692,35.6923,83.4157,52,4,8.00822,-0.00821877
South Africa,190,234.274,7.4,0.373684,232.363,7.33158,0.342105,GC Smith,0,0,0,0,0,0,0,0,4,11,15,4,11,15,0,317,2,1,1,3.97,0.29,33.57,79.6819,100,4,7.38502,3.61498
South Africa,190,234.274,7.4,0.373684,232.363,7.33158,0.342105,HH Gibbs,0,0,0,0,0,0,0,0,4,11,15,4,11,15,0,317,2,1,1,4.61538,0.307692,35.6923,83.4157,52,4,7.38502,3.61498
Australia,228,239.627,7.69737,0.372807,232.079,7.23246,0.337719,BJ Haddin,0,0,0,0,0,0,0,0,16,12,28,16,12,28,318,256,2,0,1,3.14737,0.147368,26.7789,81.382,95,4,8.34613,3.65387
South Africa,190,234.274,7.4,0.373684,232.363,7.33158,0.342105,GC Smith,0,0,0,0,0,0,0,0,14,12,26,14,12,26,304,256,1,1,1,3.97,0.29,33.57,79.6819,100,4,7.86456,4.13544
Australia,228,239.627,7.69737,0.372807,232.079,7.23246,0.337719,DA Warner,0,0,0,0,0,0,0,0,12,5,17,12,5,17,0,249,4,1,1,4.20312,0.265625,35.2031,87.7336,64,4,8.21609,-3.21609
Australia,228,239.627,7.69737,0.372807,232.079,7.23246,0.337719,SE Marsh,0,0,0,0,0,0,0,0,24,5,29,24,5,29,0,222,3,1,1,3.66667,0.291667,35.5417,74.7918,48,4,8.21609,-3.21609
South Africa,190,234.274,7.4,0.373684,232.363,7.33158,0.342105,HM Amla,0,0,0,0,0,0,0,0,12,11,23,12,11,23,0,288,5,0,1,5.20168,0.403361,48.7899,86.9292,119,4,7.85679,3.14321
Australia,228,239.627,7.69737,0.372807,232.079,7.23246,0.337719,DA Warner,0,0,0,0,0,0,0,0,8,6,14,8,6,14,0,181,0,1,1,4.20312,0.265625,35.2031,87.7336,64,4,8.21609,-2.21609
New Zealand,184,233.745,7.39674,0.36413,227.951,7.30435,0.353261,PG Fulton,0,0,0,0,0,0,0,0,8,2,10,8,2,10,182,182,3,0,1,2.75,0.1875,27.4062,67.4615,32,4,7.59425,-5.59425
Australia,228,239.627,7.69737,0.372807,232.079,7.23246,0.337719,MJ Clarke,0,0,0,0,0,0,0,0,0,9,9,0,9,9,0,225,0,1,1,3.10294,0.301471,35.9265,74.0303,136,4,8.21609,0.783907
Australia,228,239.627,7.69737,0.372807,232.079,7.23246,0.337719,BJ Haddin,0,0,0,0,0,0,0,0,0,9,9,0,9,9,0,225,0,1,1,3.14737,0.147368,26.7789,81.382,95,4,8.21609,0.783907
New Zealand,184,233.745,7.39674,0.36413,227.951,7.30435,0.353261,PG Fulton,0,0,0,0,0,0,0,0,8,4,12,8,4,12,302,269,0,0,1,2.75,0.1875,27.4062,67.4615,32,4,6.96452,-2.96452
New Zealand,184,233.745,7.39674,0.36413,227.951,7.30435,0.353261,MJ Guptill,0,0,0,0,0,0,0,0,0,11,11,0,11,11,0,244,0,0,1,4.8087,0.313043,38.1217,82.7482,115,4,6.85021,4.14979
West Indies,176,217.33,7.15909,0.3125,225.278,7.57386,0.380682,CH Gayle,0,0,0,0,0,0,0,0,4,5,9,4,5,9,271,244,1,1,1,4.58621,0.206897,31.1293,89.4255,116,4,7.0325,-2.0325
West Indies,176,217.33,7.15909,0.3125,225.278,7.57386,0.380682,RR Sarwan,0,0,0,0,0,0,0,0,4,5,9,4,5,9,271,244,1,1,1,2.8254,0.222222,29.1429,69.1005,63,4,7.0325,-2.0325
West Indies,176,217.33,7.15909,0.3125,225.278,7.57386,0.380682,CH Gayle,0,0,0,0,0,0,0,0,16,7,23,16,7,23,0,264,1,1,1,4.58621,0.206897,31.1293,89.4255,116,4,6.48576,0.514236
West Indies,176,217.33,7.15909,0.3125,225.278,7.57386,0.380682,LMP Simmons,0,0,0,0,0,0,0,0,16,7,23,16,7,23,0,264,1,1,1,3.3125,0.28125,30.5938,71.4338,64,4,6.48576,0.514236
England,221,237.176,7.17647,0.289593,230.633,7.45701,0.384615,AJ Strauss,0,0,0,0,0,0,0,0,4,6,10,4,6,10,0,117,5,0,1,3.93243,0.27027,33.9054,79.8028,74,4,7.7801,-1.7801
West Indies,176,217.33,7.15909,0.3125,225.278,7.57386,0.380682,LMP Simmons,0,0,0,0,0,0,0,0,20,9,29,20,9,29,173,146,2,1,1,3.3125,0.28125,30.5938,71.4338,64,4,8.6106,0.389399
England,221,237.176,7.17647,0.289593,230.633,7.45701,0.384615,KP Pietersen,0,0,0,0,0,0,0,0,8,9,17,8,9,17,388,229,0,0,1,3.69892,0.236559,33.4946,82.2117,93,4,8.13316,0.866842
England,221,237.176,7.17647,0.289593,230.633,7.45701,0.384615,OA Shah,0,0,0,0,0,0,0,0,12,7,19,12,7,19,293,238,0,0,1,3.13043,0.23913,32.6739,81.1994,46,4,8.83323,-1.83323
England,221,237.176,7.17647,0.289593,230.633,7.45701,0.384615,IR Bell,0,0,0,0,0,0,0,0,12,2,14,12,2,14,0,240,0,0,1,3.63433,0.246269,35.3806,75.6623,134,4,7.7801,-5.7801
India,259,242.378,7.15058,0.339768,244.568,7.12741,0.30888,G Gambhir,0,0,0,0,0,0,0,0,20,5,25,20,5,25,241,198,1,1,1,3.99145,0.333333,37.4701,84.1944,117,4,7.94457,-2.94457
England,221,237.176,7.17647,0.289593,230.633,7.45701,0.384615,OA Shah,0,0,0,0,0,0,0,0,12,6,18,12,6,18,167,178,1,0,1,3.13043,0.23913,32.6739,81.1994,46,4,8.47456,-2.47456
India,259,242.378,7.15058,0.339768,244.568,7.12741,0.30888,V Kohli,0,0,0,0,0,0,0,0,4,15,19,4,15,19,0,258,2,0,1,4.66456,0.379747,44.9937,88.3325,158,4,8.07854,6.92146
India,259,242.378,7.15058,0.339768,244.568,7.12741,0.30888,SR Tendulkar,0,0,0,0,0,0,0,0,12,13,25,12,13,25,0,392,4,0,1,5.89773,0.363636,45.6023,84.5376,88,4,8.07854,4.92146
New Zealand,184,233.745,7.39674,0.36413,227.951,7.30435,0.353261,BB McCullum,0,0,0,0,0,0,0,0,28,6,34,28,6,34,393,334,0,1,1,3.98611,0.201389,29.9028,98.4004,144,0,7.62133,-1.62133
West Indies,176,217.33,7.15909,0.3125,225.278,7.57386,0.380682,XM Marshall,0,0,0,0,0,0,0,0,12,5,17,12,5,17,0,128,2,0,1,1.5,0,10.5,58.3333,8,3,6.1107,-1.1107
West Indies,176,217.33,7.15909,0.3125,225.278,7.57386,0.380682,CH Gayle,0,0,0,0,0,0,0,0,4,2,6,4,2,6,233,208,8,0,1,4.58621,0.206897,31.1293,89.4255,116,4,5.86996,-3.86996
Sri Lanka,244,223.373,7.09016,0.344262,227.578,7.47541,0.385246,WU Tharanga,0,0,0,0,0,0,0,0,6,11,17,6,11,17,128,130,2,0,1,3.93985,0.263158,32.9699,71.6035,133,4,8.77963,2.22037
Sri Lanka,244,223.373,7.09016,0.344262,227.578,7.47541,0.385246,ML Udawatte,0,0,0,0,0,0,0,0,4,6,10,4,6,10,68,68,3,0,1,2.33333,0,17.1667,62.0482,6,1,6.83493,-0.834926
Sri Lanka,244,223.373,7.09016,0.344262,227.578,7.47541,0.385246,ML Udawatte,0,0,0,0,0,0,0,0,4,9,13,4,9,13,0,171,5,0,1,2.33333,0,17.1667,62.0482,6,1,7.2944,1.7056
Sri Lanka,244,223.373,7.09016,0.344262,227.578,7.47541,0.385246,DPMD Jayawardene,0,0,0,0,0,0,0,0,4,2,6,4,2,6,0,152,2,0,1,3.20833,0.244792,31.6979,79.1109,192,4,7.38489,-5.38489
Zimbabwe,142,212.077,7.5,0.380282,227.704,6.97887,0.316901,V Sibanda,0,0,0,0,0,0,0,0,0,14,14,0,14,14,153,133,11,1,1,2.9697,0.181818,23.5152,63.5545,66,1,10.2188,3.78121
India,259,242.378,7.15058,0.339768,244.568,7.12741,0.30888,RG Sharma,0,0,0,0,0,0,0,0,4,7,11,4,7,11,0,188,2,0,1,3.82836,0.268657,35.9179,83.083,134,4,8.07854,-1.07854
India,259,242.378,7.15058,0.339768,244.568,7.12741,0.30888,G Gambhir,0,0,0,0,0,0,0,0,4,7,11,4,7,11,0,188,2,0,1,3.99145,0.333333,37.4701,84.1944,117,4,8.07854,-1.07854
West Indies,176,217.33,7.15909,0.3125,225.278,7.57386,0.380682,CH Gayle,0,0,0,0,0,0,0,0,28,9,37,28,9,37,0,186,0,1,1,4.58621,0.206897,31.1293,89.4255,116,4,6.48576,2.51424
Bangladesh,160,218.438,7.70625,0.4,211.106,7.05,0.325,Junaid Siddique,0,0,0,0,0,0,0,0,8,2,10,8,2,10,206,167,1,1,1,2.16279,0.116279,20.0233,68.225,43,1,7.82583,-5.82583
Bangladesh,160,218.438,7.70625,0.4,211.106,7.05,0.325,Tamim Iqbal,0,0,0,0,0,0,0,0,12,6,18,12,6,18,148,151,1,1,1,4.05344,0.274809,31.8015,76.8068,131,4,7.15414,-1.15414
Bangladesh,160,218.438,7.70625,0.4,211.106,7.05,0.325,Mushfiqur Rahim,0,0,0,0,0,0,0,0,12,6,18,12,6,18,148,151,1,1,1,2.61111,0.18254,27.7778,75.2526,126,4,7.15414,-1.15414
Bangladesh,160,218.438,7.70625,0.4,211.106,7.05,0.325,Mehrab Hossain jnr,0,0,0,0,0,0,0,0,4,4,8,4,4,8,120,121,10,1,1,1.7,0.1,18.3,42.4594,10,3,4.96763,-0.967628
West Indies,176,217.33,7.15909,0.3125,225.278,7.57386,0.380682,RS Morton,0,0,0,0,0,0,0,0,20,8,28,20,8,28,329,270,1,0,1,2.2963,0.222222,28.8889,67.0103,27,4,7.58159,0.418414
West Indies,176,217.33,7.15909,0.3125,225.278,7.57386,0.380682,RR Sarwan,0,0,0,0,0,0,0,0,20,8,28,20,8,28,329,270,1,0,1,2.8254,0.222222,29.1429,69.1005,63,4,7.58159,0.418414
Ireland,55,219.527,7.65455,0.290909,202.727,7.56364,0.4,NJ O'Brien,0,0,0,0,0,0,0,0,16,13,29,16,13,29,204,112,4,1,1,2.55882,0.176471,25.5882,69.378,34,4,6.55272,6.44728
Ireland,55,219.527,7.65455,0.290909,202.727,7.56364,0.4,PR Stirling,0,0,0,0,0,0,0,0,16,13,29,16,13,29,204,112,4,1,1,3.47826,0.173913,24.2174,88.1329,23,0,7.49133,5.50867
Ireland,55,219.527,7.65455,0.290909,202.727,7.56364,0.4,AC Botha,0,0,0,0,0,0,0,0,16,13,29,16,13,29,204,112,4,1,1,1.25,0.0833333,14.3333,53.75,12,3,6.55272,6.44728
Sri Lanka,244,223.373,7.09016,0.344262,227.578,7.47541,0.385246,TM Dilshan,0,0,0,0,0,0,0,0,16,12,28,16,12,28,0,219,2,0,1,4.60199,0.273632,38.3632,86.0219,201,4,7.38489,4.61511
Sri Lanka,244,223.373,7.09016,0.344262,227.578,7.47541,0.385246,ST Jayasuriya,0,0,0,0,0,0,0,0,16,12,28,16,12,28,0,219,2,0,1,4.91549,0.211268,33.9859,98.4898,71,0,7.37712,4.62288
Sri Lanka,244,223.373,7.09016,0.344262,227.578,7.47541,0.385246,TM Dilshan,0,0,0,0,0,0,0,0,32,3,35,32,3,35,0,290,4,0,1,4.60199,0.273632,38.3632,86.0219,201,4,7.38489,-4.38489
Pakistan,211,222.621,7.38389,0.393365,235.517,7.54976,0.336493,Khurram Manzoor,0,0,0,0,0,0,0,0,12,6,18,12,6,18,291,161,1,0,1,3.33333,0.5,33.6667,62.5387,6,4,7.52252,-1.52252
Pakistan,211,222.621,7.38389,0.393365,235.517,7.54976,0.336493,Salman Butt,0,0,0,0,0,0,0,0,12,6,18,12,6,18,291,161,1,0,1,5.4359,0.384615,42.3846,78.8645,39,4,7.52252,-1.52252
Pakistan,211,222.621,7.38389,0.393365,235.517,7.54976,0.336493,Shoaib Malik,0,0,0,0,0,0,0,0,12,6,18,12,6,18,291,161,1,0,1,2.77551,0.193878,28.7041,81.4418,98,4,7.52252,-1.52252
Pakistan,211,222.621,7.38389,0.393365,235.517,7.54976,0.336493,Kamran Akmal,0,0,0,0,0,0,0,0,4,6,10,4,6,10,310,75,1,1,1,3.01124,0.11236,23.0787,81.4433,89,4,7.59589,-1.59589
India,259,242.378,7.15058,0.339768,244.568,7.12741,0.30888,SR Tendulkar,0,0,0,0,0,0,0,0,4,14,18,4,14,18,247,247,1,0,1,5.89773,0.363636,45.6023,84.5376,88,4,9.46758,4.53242
Sri Lanka,244,223.373,7.09016,0.344262,227.578,7.47541,0.385246,ST Jayasuriya,0,0,0,0,0,0,0,0,12,13,25,12,13,25,364,216,3,1,1,4.91549,0.211268,33.9859,98.4898,71,0,12.6853,0.314745
Sri Lanka,244,223.373,7.09016,0.344262,227.578,7.47541,0.385246,KC Sangakkara,0,0,0,0,0,0,0,0,12,13,25,12,13,25,364,216,3,1,1,4.33659,0.360976,41.9854,80.6276,205,4,12.198,0.801957
India,259,242.378,7.15058,0.339768,244.568,7.12741,0.30888,G Gambhir,0,0,0,0,0,0,0,0,12,8,20,12,8,20,321,252,2,0,1,3.99145,0.333333,37.4701,84.1944,117,4,8.59897,-0.598969
India,259,242.378,7.15058,0.339768,244.568,7.12741,0.30888,SK Raina,0,0,0,0,0,0,0,0,12,8,20,12,8,20,321,252,2,0,1,3.11111,0.216374,28.9064,91.8944,171,0,9.61483,-1.61483
England,221,237.176,7.17647,0.289593,230.633,7.45701,0.384615,IJL Trott,0,0,0,0,0,0,0,0,12,7,19,12,7,19,251,252,0,0,1,3.3871,0.403226,43.7903,75.2494,62,4,8.29493,-1.29493
England,221,237.176,7.17647,0.289593,230.633,7.45701,0.384615,AJ Strauss,0,0,0,0,0,0,0,0,30,10,40,30,10,40,355,242,1,0,1,3.93243,0.27027,33.9054,79.8028,74,4,8.79293,1.20707
South Africa,190,234.274,7.4,0.373684,232.363,7.33158,0.342105,HM Amla,0,0,0,0,0,0,0,0,12,6,18,12,6,18,0,119,2,1,1,5.20168,0.403361,48.7899,86.9292,119,4,7.38502,-1.38502
Pakistan,211,222.621,7.38389,0.393365,235.517,7.54976,0.336493,Kamran Akmal,0,0,0,0,0,0,0,0,8,3,11,8,3,11,169,171,0,0,1,3.01124,0.11236,23.0787,81.4433,89,4,7.1199,-4.1199
Pakistan,211,222.621,7.38389,0.393365,235.517,7.54976,0.336493,Salman Butt,0,0,0,0,0,0,0,0,8,4,12,8,4,12,0,207,1,0,1,5.4359,0.384615,42.3846,78.8645,39,4,7.14441,-3.14441
Australia,228,239.627,7.69737,0.372807,232.079,7.23246,0.337719,BJ Haddin,0,0,0,0,0,0,0,0,8,10,18,8,10,18,198,200,0,0,1,3.14737,0.147368,26.7789,81.382,95,4,8.53685,1.46315
Australia,228,239.627,7.69737,0.372807,232.079,7.23246,0.337719,MJ Clarke,0,0,0,0,0,0,0,0,8,10,18,8,10,18,198,200,0,0,1,3.10294,0.301471,35.9265,74.0303,136,4,8.53685,1.46315
Pakistan,211,222.621,7.38389,0.393365,235.517,7.54976,0.336493,Ahmed Shehzad,0,0,0,0,0,0,0,0,0,4,4,0,4,4,251,254,4,0,1,3.67143,0.242857,33.2714,70.8118,70,4,8.09637,-4.09637
West Indies,176,217.33,7.15909,0.3125,225.278,7.57386,0.380682,DS Smith,0,0,0,0,0,0,0,0,4,7,11,4,7,11,247,194,1,1,1,2.61765,0.147059,23.5588,71.2,34,4,7.68766,-0.687665
Bangladesh,160,218.438,7.70625,0.4,211.106,7.05,0.325,Tamim Iqbal,0,0,0,0,0,0,0,0,8,12,20,8,12,20,275,276,0,0,1,4.05344,0.274809,31.8015,76.8068,131,4,8.08449,3.91551
West Indies,176,217.33,7.15909,0.3125,225.278,7.57386,0.380682,DS Smith,0,0,0,0,0,0,0,0,24,3,27,24,3,27,0,248,3,1,1,2.61765,0.147059,23.5588,71.2,34,4,6.48576,-3.48576
Bangladesh,160,218.438,7.70625,0.4,211.106,7.05,0.325,Junaid Siddique,0,0,0,0,0,0,0,0,28,6,34,28,6,34,249,249,0,0,1,2.16279,0.116279,20.0233,68.225,43,1,7.84305,-1.84305
Sri Lanka,244,223.373,7.09016,0.344262,227.578,7.47541,0.385246,WU Tharanga,0,0,0,0,0,0,0,0,4,8,12,4,8,12,0,232,3,1,1,3.93985,0.263158,32.9699,71.6035,133,4,7.59431,0.405685
Sri Lanka,244,223.373,7.09016,0.344262,227.578,7.47541,0.385246,ST Jayasuriya,0,0,0,0,0,0,0,0,4,8,12,4,8,12,0,232,3,1,1,4.91549,0.211268,33.9859,98.4898,71,0,7.84505,0.154953
Pakistan,211,222.621,7.38389,0.393365,235.517,7.54976,0.336493,Kamran Akmal,0,0,0,0,0,0,0,0,20,5,25,20,5,25,233,196,0,0,1,3.01124,0.11236,23.0787,81.4433,89,4,6.66557,-1.66557
Pakistan,211,222.621,7.38389,0.393365,235.517,7.54976,0.336493,Imran Nazir,0,0,0,0,0,0,0,0,8,9,17,8,9,17,0,321,3,0,1,4.66667,0.133333,29,96.0265,15,0,7.50431,1.49569
Sri Lanka,244,223.373,7.09016,0.344262,227.578,7.47541,0.385246,DPMD Jayawardene,0,0,0,0,0,0,0,0,22,8,30,22,8,30,322,175,0,1,1,3.20833,0.244792,31.6979,79.1109,192,4,10.145,-2.14496
Sri Lanka,244,223.373,7.09016,0.344262,227.578,7.47541,0.385246,DPMD Jayawardene,0,0,0,0,0,0,0,0,16,7,23,16,7,23,280,147,3,1,1,3.20833,0.244792,31.6979,79.1109,192,4,8.26947,-1.26947
New Zealand,184,233.745,7.39674,0.36413,227.951,7.30435,0.353261,GD Elliott,0,0,0,0,0,0,0,0,0,7,7,0,7,7,217,119,0,0,1,2.67188,0.203125,29.4375,79.7629,64,4,7.25603,-0.256029
India,259,242.378,7.15058,0.339768,244.568,7.12741,0.30888,KD Karthik,0,0,0,0,0,0,0,0,16,9,25,16,9,25,308,168,5,0,1,2.46429,0.107143,21.6786,71.8769,56,1,9.01971,-0.0197058
New Zealand,184,233.745,7.39674,0.36413,227.951,7.30435,0.353261,LRPL Taylor,0,0,0,0,0,0,0,0,8,5,13,8,5,13,0,155,1,0,1,3.68382,0.301471,36.7206,79.3959,136,4,6.85021,-1.85021
India,259,242.378,7.15058,0.339768,244.568,7.12741,0.30888,SR Tendulkar,0,0,0,0,0,0,0,0,0,15,15,0,15,15,156,156,1,0,1,5.89773,0.363636,45.6023,84.5376,88,4,8.66104,6.33896
Pakistan,211,222.621,7.38389,0.393365,235.517,7.54976,0.336493,Salman Butt,0,0,0,0,0,0,0,0,16,8,24,16,8,24,0,274,3,0,1,5.4359,0.384615,42.3846,78.8645,39,4,7.14441,0.85559
Australia,228,239.627,7.69737,0.372807,232.079,7.23246,0.337719,SR Watson,0,0,0,0,0,0,0,0,4,12,16,4,12,16,275,275,6,1,1,4.71318,0.286822,37.7907,90.0943,129,4,8.5399,3.4601
Australia,228,239.627,7.69737,0.372807,232.079,7.23246,0.337719,SE Marsh,0,0,0,0,0,0,0,0,4,12,16,4,12,16,275,275,6,1,1,3.66667,0.291667,35.5417,74.7918,48,4,8.5399,3.4601
Australia,228,239.627,7.69737,0.372807,232.079,7.23246,0.337719,SE Marsh,0,0,0,0,0,0,0,0,8,12,20,8,12,20,213,213,1,1,1,3.66667,0.291667,35.5417,74.7918,48,4,8.53244,3.46756
Australia,228,239.627,7.69737,0.372807,232.079,7.23246,0.337719,BJ Haddin,0,0,0,0,0,0,0,0,8,12,20,8,12,20,213,213,1,1,1,3.14737,0.147368,26.7789,81.382,95,4,8.53244,3.46756
Zimbabwe,142,212.077,7.5,0.380282,227.704,6.97887,0.316901,H Masakadza,0,0,0,0,0,0,0,0,16,13,29,16,13,29,321,271,0,1,1,3.11215,0.186916,26.972,70.0485,107,4,7.70353,5.29647
Zimbabwe,142,212.077,7.5,0.380282,227.704,6.97887,0.316901,CK Coventry,0,0,0,0,0,0,0,0,16,13,29,16,13,29,321,271,0,1,1,3.33333,0.166667,29.3889,90.273,18,4,7.70353,5.29647
Zimbabwe,142,212.077,7.5,0.380282,227.704,6.97887,0.316901,MA Vermeulen,0,0,0,0,0,0,0,0,16,8,24,16,8,24,0,323,3,1,1,1.85714,0.142857,20.2857,68.2692,7,1,6.12263,1.87737
Bangladesh,160,218.438,7.70625,0.4,211.106,7.05,0.325,Tamim Iqbal,0,0,0,0,0,0,0,0,12,9,21,12,9,21,324,254,1,0,1,4.05344,0.274809,31.8015,76.8068,131,4,7.56662,1.43338
Zimbabwe,142,212.077,7.5,0.380282,227.704,6.97887,0.316901,V Sibanda,0,0,0,0,0,0,0,0,8,8,16,8,8,16,0,209,5,1,1,2.9697,0.181818,23.5152,63.5545,66,1,6.12263,1.87737
Zimbabwe,142,212.077,7.5,0.380282,227.704,6.97887,0.316901,CK Coventry,0,0,0,0,0,0,0,0,8,8,16,8,8,16,0,209,5,1,1,3.33333,0.166667,29.3889,90.273,18,4,6.31573,1.68427
Bangladesh,160,218.438,7.70625,0.4,211.106,7.05,0.325,Mushfiqur Rahim,0,0,0,0,0,0,0,0,4,5,9,4,5,9,210,212,6,0,1,2.61111,0.18254,27.7778,75.2526,126,4,7.31618,-2.31618
South Africa,190,234.274,7.4,0.373684,232.363,7.33158,0.342105,GC Smith,0,0,0,0,0,0,0,0,8,10,18,8,10,18,320,206,0,1,1,3.97,0.29,33.57,79.6819,100,4,7.23291,2.76709
South Africa,190,234.274,7.4,0.373684,232.363,7.33158,0.342105,JH Kallis,0,0,0,0,0,0,0,0,8,10,18,8,10,18,320,206,0,1,1,3.58621,0.356322,37.2644,76.4442,87,4,7.23291,2.76709
West Indies,176,217.33,7.15909,0.3125,225.278,7.57386,0.380682,TM Dowlin,0,0,0,0,0,0,0,0,4,9,13,4,9,13,0,133,1,0,1,2.1,0.2,22.7,62.7072,10,1,6.19764,2.80236
Pakistan,211,222.621,7.38389,0.393365,235.517,7.54976,0.336493,Shoaib Malik,0,0,0,0,0,0,0,0,14,6,20,14,6,20,134,134,1,0,1,2.77551,0.193878,28.7041,81.4418,98,4,6.93537,-0.93537
Sri Lanka,244,223.373,7.09016,0.344262,227.578,7.47541,0.385246,TM Dilshan,0,0,0,0,0,0,0,0,4,8,12,4,8,12,0,212,5,0,1,4.60199,0.273632,38.3632,86.0219,201,4,7.38489,0.615109
Sri Lanka,244,223.373,7.09016,0.344262,227.578,7.47541,0.385246,KC Sangakkara,0,0,0,0,0,0,0,0,4,8,12,4,8,12,0,212,5,0,1,4.33659,0.360976,41.9854,80.6276,205,4,7.38489,0.615109
Australia,228,239.627,7.69737,0.372807,232.079,7.23246,0.337719,SR Watson,0,0,0,0,0,0,0,0,0,13,13,0,13,13,0,275,5,0,1,4.71318,0.286822,37.7907,90.0943,129,4,7.87937,5.12063
India,259,242.378,7.15058,0.339768,244.568,7.12741,0.30888,SR Tendulkar,0,0,0,0,0,0,0,0,16,9,25,16,9,25,303,248,3,0,1,5.89773,0.363636,45.6023,84.5376,88,4,9.01971,-0.0197058
New Zealand,184,233.745,7.39674,0.36413,227.951,7.30435,0.353261,JD Ryder,0,0,0,0,0,0,0,0,12,10,22,12,10,22,0,315,4,0,1,4.88571,0.257143,34.4,97.2536,35,0,7.17241,2.82759
Sri Lanka,244,223.373,7.09016,0.344262,227.578,7.47541,0.385246,ST Jayasuriya,0,0,0,0,0,0,0,0,38,7,45,38,7,45,316,277,1,0,1,4.91549,0.211268,33.9859,98.4898,71,0,7.25262,-0.252625
England,221,237.176,7.17647,0.289593,230.633,7.45701,0.384615,AJ Strauss,0,0,0,0,0,0,0,0,20,5,25,20,5,25,0,323,2,0,1,3.93243,0.27027,33.9054,79.8028,74,4,7.7801,-2.7801
South Africa,190,234.274,7.4,0.373684,232.363,7.33158,0.342105,HH Gibbs,0,0,0,0,0,0,0,0,18,9,27,18,9,27,324,301,2,1,1,4.61538,0.307692,35.6923,83.4157,52,4,8.46683,0.533169
England,221,237.176,7.17647,0.289593,230.633,7.45701,0.384615,PD Collingwood,0,0,0,0,0,0,0,0,4,7,11,4,7,11,0,146,2,0,1,2.62366,0.193548,30.5161,76.8065,93,4,7.7801,-0.780101
West Indies,176,217.33,7.15909,0.3125,225.278,7.57386,0.380682,ADS Fletcher,0,0,0,0,0,0,0,0,8,5,13,8,5,13,0,129,0,0,1,1.8125,0.125,13.5,62.6087,16,1,6.19764,-1.19764
Australia,228,239.627,7.69737,0.372807,232.079,7.23246,0.337719,SR Watson,0,0,0,0,0,0,0,0,16,3,19,16,3,19,0,292,3,0,1,4.71318,0.286822,37.7907,90.0943,129,4,7.87937,-4.87937
India,259,242.378,7.15058,0.339768,244.568,7.12741,0.30888,G Gambhir,0,0,0,0,0,0,0,0,20,3,23,20,3,23,293,288,6,1,1,3.99145,0.333333,37.4701,84.1944,117,4,7.83557,-4.83557
India,259,242.378,7.15058,0.339768,244.568,7.12741,0.30888,SR Tendulkar,0,0,0,0,0,0,0,0,24,4,28,24,4,28,0,354,4,1,1,5.89773,0.363636,45.6023,84.5376,88,4,6.85241,-2.85241
India,259,242.378,7.15058,0.339768,244.568,7.12741,0.30888,V Sehwag,0,0,0,0,0,0,0,0,32,6,38,32,6,38,251,226,2,1,1,5.88636,0.238636,38.8295,108.649,88,0,6.41369,-0.413689
India,259,242.378,7.15058,0.339768,244.568,7.12741,0.30888,SR Tendulkar,0,0,0,0,0,0,0,0,18,4,22,18,4,22,0,170,1,1,1,5.89773,0.363636,45.6023,84.5376,88,4,6.85241,-2.85241
Australia,228,239.627,7.69737,0.372807,232.079,7.23246,0.337719,RT Ponting,0,0,0,0,0,0,0,0,24,3,27,24,3,27,171,172,1,0,1,4.17431,0.33945,38.1009,80.8606,109,4,6.27975,-3.27975
Bangladesh,160,218.438,7.70625,0.4,211.106,7.05,0.325,Junaid Siddique,0,0,0,0,0,0,0,0,4,4,8,4,4,8,0,186,0,1,1,2.16279,0.116279,20.0233,68.225,43,1,5.00096,-1.00096
Bangladesh,160,218.438,7.70625,0.4,211.106,7.05,0.325,Mohammad Ashraful,0,0,0,0,0,0,0,0,4,4,8,4,4,8,0,186,0,1,1,2.17722,0.113924,19.4557,63.9085,79,1,5.00096,-1.00096
Zimbabwe,142,212.077,7.5,0.380282,227.704,6.97887,0.316901,MA Vermeulen,0,0,0,0,0,0,0,0,8,3,11,8,3,11,0,221,0,0,1,1.85714,0.142857,20.2857,68.2692,7,1,6.44168,-3.44168
New Zealand,184,233.745,7.39674,0.36413,227.951,7.30435,0.353261,PJ Ingram,0,0,0,0,0,0,0,0,0,5,5,0,5,5,0,336,1,1,1,4.28571,0.142857,27.5714,80.7531,7,4,6.8371,-1.8371
Bangladesh,160,218.438,7.70625,0.4,211.106,7.05,0.325,Tamim Iqbal,0,0,0,0,0,0,0,0,4,7,11,4,7,11,0,183,1,0,1,4.05344,0.274809,31.8015,76.8068,131,4,7.85483,-0.854825
New Zealand,184,233.745,7.39674,0.36413,227.951,7.30435,0.353261,BB McCullum,0,0,0,0,0,0,0,0,22,13,35,22,13,35,184,185,1,1,1,3.98611,0.201389,29.9028,98.4004,144,0,8.05883,4.94117
Bangladesh,160,218.438,7.70625,0.4,211.106,7.05,0.325,Tamim Iqbal,0,0,0,0,0,0,0,0,20,7,27,20,7,27,0,241,6,0,1,4.05344,0.274809,31.8015,76.8068,131,4,7.85483,-0.854825
New Zealand,184,233.745,7.39674,0.36413,227.951,7.30435,0.353261,BB McCullum,0,0,0,0,0,0,0,0,24,9,33,24,9,33,242,244,4,1,1,3.98611,0.201389,29.9028,98.4004,144,0,9.13947,-0.139473
New Zealand,184,233.745,7.39674,0.36413,227.951,7.30435,0.353261,PJ Ingram,0,0,0,0,0,0,0,0,24,9,33,24,9,33,242,244,4,1,1,4.28571,0.142857,27.5714,80.7531,7,4,8.86392,0.136085
Australia,228,239.627,7.69737,0.372807,232.079,7.23246,0.337719,BJ Haddin,0,0,0,0,0,0,0,0,4,9,13,4,9,13,0,273,1,0,1,3.14737,0.147368,26.7789,81.382,95,4,7.87937,1.12063
Australia,228,239.627,7.69737,0.372807,232.079,7.23246,0.337719,BJ Haddin,0,0,0,0,0,0,0,0,16,6,22,16,6,22,239,202,2,0,1,3.14737,0.147368,26.7789,81.382,95,4,8.14348,-2.14348
New Zealand,184,233.745,7.39674,0.36413,227.951,7.30435,0.353261,LRPL Taylor,0,0,0,0,0,0,0,0,6,5,11,6,5,11,0,241,14,1,1,3.68382,0.301471,36.7206,79.3959,136,4,6.8371,-1.8371
Australia,228,239.627,7.69737,0.372807,232.079,7.23246,0.337719,SR Watson,0,0,0,0,0,0,0,0,6,10,16,6,10,16,0,231,4,0,1,4.71318,0.286822,37.7907,90.0943,129,4,7.87937,2.12063
England,221,237.176,7.17647,0.289593,230.633,7.45701,0.384615,AJ Strauss,0,0,0,0,0,0,0,0,16,5,21,16,5,21,268,268,2,1,1,3.93243,0.27027,33.9054,79.8028,74,4,7.57994,-2.57994
England,221,237.176,7.17647,0.289593,230.633,7.45701,0.384615,KP Pietersen,0,0,0,0,0,0,0,0,16,5,21,16,5,21,268,268,2,1,1,3.69892,0.236559,33.4946,82.2117,93,4,7.57994,-2.57994
England,221,237.176,7.17647,0.289593,230.633,7.45701,0.384615,AJ Strauss,0,0,0,0,0,0,0,0,12,6,18,12,6,18,291,212,3,1,1,3.93243,0.27027,33.9054,79.8028,74,4,8.01028,-2.01028
England,221,237.176,7.17647,0.289593,230.633,7.45701,0.384615,C Kieswetter,0,0,0,0,0,0,0,0,12,6,18,12,6,18,291,212,3,1,1,3.43243,0.135135,26.4324,88.0288,37,4,8.01028,-2.01028
Bangladesh,160,218.438,7.70625,0.4,211.106,7.05,0.325,Tamim Iqbal,0,0,0,0,0,0,0,0,20,14,34,20,14,34,0,250,3,0,1,4.05344,0.274809,31.8015,76.8068,131,4,7.85483,6.14517
England,221,237.176,7.17647,0.289593,230.633,7.45701,0.384615,C Kieswetter,0,0,0,0,0,0,0,0,16,7,23,16,7,23,251,251,3,1,1,3.43243,0.135135,26.4324,88.0288,37,4,8.00125,-1.00125
England,221,237.176,7.17647,0.289593,230.633,7.45701,0.384615,AJ Strauss,0,0,0,0,0,0,0,0,10,9,19,10,9,19,237,231,0,1,1,3.93243,0.27027,33.9054,79.8028,74,4,8.08316,0.916836
England,221,237.176,7.17647,0.289593,230.633,7.45701,0.384615,IJL Trott,0,0,0,0,0,0,0,0,18,9,27,18,9,27,0,347,0,1,1,3.3871,0.403226,43.7903,75.2494,62,4,7.83019,1.16981
Bangladesh,160,218.438,7.70625,0.4,211.106,7.05,0.325,Junaid Siddique,0,0,0,0,0,0,0,0,20,4,24,20,4,24,348,203,0,0,1,2.16279,0.116279,20.0233,68.225,43,1,5.26994,-1.26994
Bangladesh,160,218.438,7.70625,0.4,211.106,7.05,0.325,Imrul Kayes,0,0,0,0,0,0,0,0,4,7,11,4,7,11,0,260,3,1,1,3,0.207547,26.2642,63.6488,53,4,6.38578,0.614223
England,221,237.176,7.17647,0.289593,230.633,7.45701,0.384615,AN Cook,0,0,0,0,0,0,0,0,16,8,24,16,8,24,261,261,0,0,1,4.17045,0.272727,35.75,75.5524,88,4,7.87362,0.126376
England,221,237.176,7.17647,0.289593,230.633,7.45701,0.384615,C Kieswetter,0,0,0,0,0,0,0,0,16,8,24,16,8,24,261,261,0,0,1,3.43243,0.135135,26.4324,88.0288,37,4,7.87362,0.126376
England,221,237.176,7.17647,0.289593,230.633,7.45701,0.384615,KP Pietersen,0,0,0,0,0,0,0,0,16,8,24,16,8,24,261,261,0,0,1,3.69892,0.236559,33.4946,82.2117,93,4,7.87362,0.126376
Pakistan,211,222.621,7.38389,0.393365,235.517,7.54976,0.336493,Kamran Akmal,0,0,0,0,0,0,0,0,24,4,28,24,4,28,0,294,3,0,1,3.01124,0.11236,23.0787,81.4433,89,4,7.14441,-3.14441
Pakistan,211,222.621,7.38389,0.393365,235.517,7.54976,0.336493,Kamran Akmal,0,0,0,0,0,0,0,0,4,7,11,4,7,11,0,241,2,0,1,3.01124,0.11236,23.0787,81.4433,89,4,7.14441,-0.14441
Pakistan,211,222.621,7.38389,0.393365,235.517,7.54976,0.336493,Mohammad Yousuf,0,0,0,0,0,0,0,0,4,7,11,4,7,11,0,241,2,0,1,3.27586,0.275862,36.7931,73.9176,58,4,7.14441,-0.14441
England,221,237.176,7.17647,0.289593,230.633,7.45701,0.384615,AJ Strauss,0,0,0,0,0,0,0,0,20,8,28,20,8,28,242,218,0,1,1,3.93243,0.27027,33.9054,79.8028,74,4,8.11927,-0.119274
England,221,237.176,7.17647,0.289593,230.633,7.45701,0.384615,SM Davies,0,0,0,0,0,0,0,0,20,8,28,20,8,28,242,218,0,1,1,4.5,0.125,30.125,100.837,8,0,8.39483,-0.394832
Pakistan,211,222.621,7.38389,0.393365,235.517,7.54976,0.336493,Mohammad Hafeez,0,0,0,0,0,0,0,0,12,5,17,12,5,17,0,265,1,0,1,4.04511,0.255639,34.3534,78.0625,133,4,7.14441,-2.14441
England,221,237.176,7.17647,0.289593,230.633,7.45701,0.384615,AJ Strauss,0,0,0,0,0,0,0,0,28,6,34,28,6,34,266,227,2,1,1,3.93243,0.27027,33.9054,79.8028,74,4,7.57994,-1.57994
Pakistan,211,222.621,7.38389,0.393365,235.517,7.54976,0.336493,Younis Khan,0,0,0,0,0,0,0,0,4,9,13,4,9,13,0,287,2,0,1,2.64655,0.215517,28.5,73.2713,116,4,7.14441,1.85559
New Zealand,184,233.745,7.39674,0.36413,227.951,7.30435,0.353261,AJ Redmond,0,0,0,0,0,0,0,0,8,4,12,8,4,12,288,149,4,0,1,3.16667,0.166667,25.3333,57.1429,6,3,7.6899,-3.6899
New Zealand,184,233.745,7.39674,0.36413,227.951,7.30435,0.353261,BB McCullum,0,0,0,0,0,0,0,0,12,9,21,12,9,21,0,303,4,0,1,3.98611,0.201389,29.9028,98.4004,144,0,7.17241,1.82759
Pakistan,211,222.621,7.38389,0.393365,235.517,7.54976,0.336493,Khalid Latif,0,0,0,0,0,0,0,0,8,7,15,8,7,15,304,239,1,0,1,2.6,0.2,29.4,63.0901,5,4,7.59589,-0.595889
India,259,242.378,7.15058,0.339768,244.568,7.12741,0.30888,V Sehwag,0,0,0,0,0,0,0,0,16,3,19,16,3,19,0,414,0,1,1,5.88636,0.238636,38.8295,108.649,88,0,7.05053,-4.05053
Sri Lanka,244,223.373,7.09016,0.344262,227.578,7.47541,0.385246,TM Dilshan,0,0,0,0,0,0,0,0,20,9,29,20,9,29,302,302,2,0,1,4.60199,0.273632,38.3632,86.0219,201,4,4.64337,4.35663
India,259,242.378,7.15058,0.339768,244.568,7.12741,0.30888,SR Tendulkar,0,0,0,0,0,0,0,0,20,7,27,20,7,27,240,243,0,1,1,5.89773,0.363636,45.6023,84.5376,88,4,7.94457,-0.944568
India,259,242.378,7.15058,0.339768,244.568,7.12741,0.30888,SR Tendulkar,0,0,0,0,0,0,0,0,20,3,23,20,3,23,316,317,14,1,1,5.89773,0.363636,45.6023,84.5376,88,4,5.5294,-2.5294
India,259,242.378,7.15058,0.339768,244.568,7.12741,0.30888,V Sehwag,0,0,0,0,0,0,0,0,24,12,36,24,12,36,0,370,2,0,1,5.88636,0.238636,38.8295,108.649,88,0,8.36621,3.63379
Bangladesh,160,218.438,7.70625,0.4,211.106,7.05,0.325,Imrul Kayes,0,0,0,0,0,0,0,0,28,8,36,28,8,36,371,283,15,1,1,3,0.207547,26.2642,63.6488,53,4,6.54477,1.45523
Zimbabwe,142,212.077,7.5,0.380282,227.704,6.97887,0.316901,BRM Taylor,0,0,0,0,0,0,0,0,10,10,20,10,10,20,263,171,2,0,1,3.3,0.26,33.56,76.3421,100,4,7.87237,2.12763
South Africa,190,234.274,7.4,0.373684,232.363,7.33158,0.342105,GC Smith,0,0,0,0,0,0,0,0,8,11,19,8,11,19,223,223,1,0,1,3.97,0.29,33.57,79.6819,100,4,9.26171,1.73829
England,221,237.176,7.17647,0.289593,230.633,7.45701,0.384615,KP Pietersen,0,0,0,0,0,0,0,0,16,11,27,16,11,27,339,338,1,0,1,3.69892,0.236559,33.4946,82.2117,93,4,10.4971,0.502916
Ireland,55,219.527,7.65455,0.290909,202.727,7.56364,0.4,PR Stirling,0,0,0,0,0,0,0,0,18,4,22,18,4,22,328,329,4,0,1,3.47826,0.173913,24.2174,88.1329,23,0,8.97583,-4.97583
Bangladesh,160,218.438,7.70625,0.4,211.106,7.05,0.325,Tamim Iqbal,0,0,0,0,0,0,0,0,12,12,24,12,12,24,0,58,1,1,1,4.05344,0.274809,31.8015,76.8068,131,4,6.38578,5.61422
Zimbabwe,142,212.077,7.5,0.380282,227.704,6.97887,0.316901,T Taibu,0,0,0,0,0,0,0,0,8,7,15,8,7,15,0,162,2,0,1,2.36364,0.254545,29.4,71.0145,55,4,5.82223,1.17777
Ireland,55,219.527,7.65455,0.290909,202.727,7.56364,0.4,PR Stirling,0,0,0,0,0,0,0,0,8,1,9,8,1,9,0,207,2,0,1,3.47826,0.173913,24.2174,88.1329,23,0,5.25076,-4.25076
England,221,237.176,7.17647,0.289593,230.633,7.45701,0.384615,AJ Strauss,0,0,0,0,0,0,0,0,4,8,12,4,8,12,0,171,3,0,1,3.93243,0.27027,33.9054,79.8028,74,4,7.7801,0.219899
England,221,237.176,7.17647,0.289593,230.633,7.45701,0.384615,IJL Trott,0,0,0,0,0,0,0,0,4,8,12,4,8,12,0,171,3,0,1,3.3871,0.403226,43.7903,75.2494,62,4,7.7801,0.219899
England,221,237.176,7.17647,0.289593,230.633,7.45701,0.384615,IR Bell,0,0,0,0,0,0,0,0,4,8,12,4,8,12,0,171,3,0,1,3.63433,0.246269,35.3806,75.6623,134,4,7.7801,0.219899
Zimbabwe,142,212.077,7.5,0.380282,227.704,6.97887,0.316901,RW Chakabva,0,0,0,0,0,0,0,0,12,15,27,12,15,27,328,188,9,0,1,0.846154,0,13.2692,51.3393,26,3,6.82497,8.17503
West Indies,176,217.33,7.15909,0.3125,225.278,7.57386,0.380682,S Chanderpaul,0,0,0,0,0,0,0,0,8,3,11,8,3,11,0,275,0,0,1,3.57143,0.396825,40.8254,68.0783,63,4,5.82675,-2.82675
England,221,237.176,7.17647,0.289593,230.633,7.45701,0.384615,AJ Strauss,0,0,0,0,0,0,0,0,12,6,18,12,6,18,0,243,0,0,1,3.93243,0.27027,33.9054,79.8028,74,4,7.7801,-1.7801
England,221,237.176,7.17647,0.289593,230.633,7.45701,0.384615,MJ Prior,0,0,0,0,0,0,0,0,12,6,18,12,6,18,0,243,0,0,1,2.27083,0.0625,21.6875,76.4879,48,4,7.7801,-1.7801
Australia,228,239.627,7.69737,0.372807,232.079,7.23246,0.337719,SR Watson,0,0,0,0,0,0,0,0,4,7,11,4,7,11,0,176,1,0,1,4.71318,0.286822,37.7907,90.0943,129,4,7.87937,-0.879366
Bangladesh,160,218.438,7.70625,0.4,211.106,7.05,0.325,Junaid Siddique,0,0,0,0,0,0,0,0,8,1,9,8,1,9,285,78,5,1,1,2.16279,0.116279,20.0233,68.225,43,1,6.84917,-5.84917
India,259,242.378,7.15058,0.339768,244.568,7.12741,0.30888,G Gambhir,0,0,0,0,0,0,0,0,12,11,23,12,11,23,0,268,5,1,1,3.99145,0.333333,37.4701,84.1944,117,4,6.85241,4.14759
Pakistan,211,222.621,7.38389,0.393365,235.517,7.54976,0.336493,Mohammad Hafeez,0,0,0,0,0,0,0,0,24,14,38,24,14,38,113,113,5,0,1,4.04511,0.255639,34.3534,78.0625,133,4,6.93537,7.06463
Australia,228,239.627,7.69737,0.372807,232.079,7.23246,0.337719,BJ Haddin,0,0,0,0,0,0,0,0,12,6,18,12,6,18,0,260,1,0,1,3.14737,0.147368,26.7789,81.382,95,4,7.87937,-1.87937
New Zealand,184,233.745,7.39674,0.36413,227.951,7.30435,0.353261,MJ Guptill,0,0,0,0,0,0,0,0,16,4,20,16,4,20,0,217,0,0,1,4.8087,0.313043,38.1217,82.7482,115,4,6.85021,-2.85021
New Zealand,184,233.745,7.39674,0.36413,227.951,7.30435,0.353261,BB McCullum,0,0,0,0,0,0,0,0,16,4,20,16,4,20,0,217,0,0,1,3.98611,0.201389,29.9028,98.4004,144,0,7.17241,-3.17241
India,259,242.378,7.15058,0.339768,244.568,7.12741,0.30888,SR Tendulkar,0,0,0,0,0,0,0,0,12,14,26,12,14,26,275,277,1,1,1,5.89773,0.363636,45.6023,84.5376,88,4,7.75518,6.24482
Sri Lanka,244,223.373,7.09016,0.344262,227.578,7.47541,0.385246,WU Tharanga,0,0,0,0,0,0,0,0,24,5,29,24,5,29,261,261,10,0,1,3.93985,0.263158,32.9699,71.6035,133,4,8.41404,-3.41404
Bangladesh,160,218.438,7.70625,0.4,211.106,7.05,0.325,Imrul Kayes,0,0,0,0,0,0,0,0,18,9,27,18,9,27,0,296,1,1,1,3,0.207547,26.2642,63.6488,53,4,6.38578,2.61422
Sri Lanka,244,223.373,7.09016,0.344262,227.578,7.47541,0.385246,WU Tharanga,0,0,0,0,0,0,0,0,28,8,36,28,8,36,250,252,0,0,1,3.93985,0.263158,32.9699,71.6035,133,4,8.06307,-0.0630722
Sri Lanka,244,223.373,7.09016,0.344262,227.578,7.47541,0.385246,TM Dilshan,0,0,0,0,0,0,0,0,36,2,38,36,2,38,0,213,0,0,1,4.60199,0.273632,38.3632,86.0219,201,4,7.38489,-5.38489
India,259,242.378,7.15058,0.339768,244.568,7.12741,0.30888,KD Karthik,0,0,0,0,0,0,0,0,12,19,31,12,19,31,248,249,5,0,1,2.46429,0.107143,21.6786,71.8769,56,1,8.16164,10.8384
Sri Lanka,244,223.373,7.09016,0.344262,227.578,7.47541,0.385246,TM Dilshan,0,0,0,0,0,0,0,0,20,8,28,20,8,28,246,249,1,0,1,4.60199,0.273632,38.3632,86.0219,201,4,8.18109,-0.181093
Zimbabwe,142,212.077,7.5,0.380282,227.704,6.97887,0.316901,V Sibanda,0,0,0,0,0,0,0,0,10,3,13,10,3,13,0,206,6,0,1,2.9697,0.181818,23.5152,63.5545,66,1,6.44168,-3.44168
West Indies,176,217.33,7.15909,0.3125,225.278,7.57386,0.380682,AB Barath,0,0,0,0,0,0,0,0,18,9,27,18,9,27,207,208,0,1,1,2.76923,0.0769231,21.6154,56.4257,13,3,5.96997,3.03003
West Indies,176,217.33,7.15909,0.3125,225.278,7.57386,0.380682,CH Gayle,0,0,0,0,0,0,0,0,0,11,11,0,11,11,0,245,0,1,1,4.58621,0.206897,31.1293,89.4255,116,4,6.48576,4.51424
Zimbabwe,142,212.077,7.5,0.380282,227.704,6.97887,0.316901,V Sibanda,0,0,0,0,0,0,0,0,12,6,18,12,6,18,246,104,1,0,1,2.9697,0.181818,23.5152,63.5545,66,1,6.07046,-0.0704632
Zimbabwe,142,212.077,7.5,0.380282,227.704,6.97887,0.316901,BRM Taylor,0,0,0,0,0,0,0,0,12,6,18,12,6,18,246,104,1,0,1,3.3,0.26,33.56,76.3421,100,4,6.00401,-0.00400734
West Indies,176,217.33,7.15909,0.3125,225.278,7.57386,0.380682,CH Gayle,0,0,0,0,0,0,0,0,12,7,19,12,7,19,301,283,0,1,1,4.58621,0.206897,31.1293,89.4255,116,4,7.0794,-0.0794034
West Indies,176,217.33,7.15909,0.3125,225.278,7.57386,0.380682,DM Richards,0,0,0,0,0,0,0,0,8,11,19,8,11,19,225,157,4,1,1,3.42857,0.285714,25.5714,68.8462,7,4,5.82422,5.17578
West Indies,176,217.33,7.15909,0.3125,225.278,7.57386,0.380682,DM Richards,0,0,0,0,0,0,0,0,18,9,27,18,9,27,0,303,1,1,1,3.42857,0.285714,25.5714,68.8462,7,4,6.48576,2.51424
West Indies,176,217.33,7.15909,0.3125,225.278,7.57386,0.380682,S Chanderpaul,0,0,0,0,0,0,0,0,14,8,22,14,8,22,0,252,1,1,1,3.57143,0.396825,40.8254,68.0783,63,4,6.48576,1.51424
India,259,242.378,7.15058,0.339768,244.568,7.12741,0.30888,SR Tendulkar,0,0,0,0,0,0,0,0,18,5,23,18,5,23,0,298,3,1,1,5.89773,0.363636,45.6023,84.5376,88,4,6.85241,-1.85241
India,259,242.378,7.15058,0.339768,244.568,7.12741,0.30888,V Sehwag,0,0,0,0,0,0,0,0,20,11,31,20,11,31,0,401,0,1,1,5.88636,0.238636,38.8295,108.649,88,0,7.05053,3.94947
South Africa,190,234.274,7.4,0.373684,232.363,7.33158,0.342105,HH Gibbs,0,0,0,0,0,0,0,0,34,8,42,34,8,42,402,248,1,0,1,4.61538,0.307692,35.6923,83.4157,52,4,8.12941,-0.129405
South Africa,190,234.274,7.4,0.373684,232.363,7.33158,0.342105,LE Bosman,0,0,0,0,0,0,0,0,12,9,21,12,9,21,0,365,1,0,1,4.18182,0.181818,27.1818,97.7124,11,0,8.3337,0.6663
Australia,228,239.627,7.69737,0.372807,232.079,7.23246,0.337719,RT Ponting,0,0,0,0,0,0,0,0,12,13,25,12,13,25,214,210,3,1,1,4.17431,0.33945,38.1009,80.8606,109,4,8.53244,4.46756
Sri Lanka,244,223.373,7.09016,0.344262,227.578,7.47541,0.385246,LPC Silva,0,0,0,0,0,0,0,0,8,5,13,8,5,13,0,115,6,0,1,2.55556,0.244444,26.0222,69.4543,45,4,7.38489,-2.38489
Australia,228,239.627,7.69737,0.372807,232.079,7.23246,0.337719,BJ Haddin,0,0,0,0,0,0,0,0,8,20,28,8,20,28,116,119,6,1,1,3.14737,0.147368,26.7789,81.382,95,4,9.22148,10.7785
England,221,237.176,7.17647,0.289593,230.633,7.45701,0.384615,SM Davies,0,0,0,0,0,0,0,0,12,14,26,12,14,26,0,294,3,0,1,4.5,0.125,30.125,100.837,8,0,8.1023,5.8977
Australia,228,239.627,7.69737,0.372807,232.079,7.23246,0.337719,BJ Haddin,0,0,0,0,0,0,0,0,20,12,32,20,12,32,295,297,0,1,1,3.14737,0.147368,26.7789,81.382,95,4,8.6203,3.3797
Australia,228,239.627,7.69737,0.372807,232.079,7.23246,0.337719,MJ Clarke,0,0,0,0,0,0,0,0,4,6,10,4,6,10,0,230,1,1,1,3.10294,0.301471,35.9265,74.0303,136,4,8.21609,-2.21609
England,221,237.176,7.17647,0.289593,230.633,7.45701,0.384615,IJL Trott,0,0,0,0,0,0,0,0,4,13,17,4,13,17,0,214,1,0,1,3.3871,0.403226,43.7903,75.2494,62,4,7.7801,5.2199
Australia,228,239.627,7.69737,0.372807,232.079,7.23246,0.337719,MJ Clarke,0,0,0,0,0,0,0,0,20,6,26,20,6,26,215,215,3,1,1,3.10294,0.301471,35.9265,74.0303,136,4,8.53244,-2.53244
England,221,237.176,7.17647,0.289593,230.633,7.45701,0.384615,MJ Prior,0,0,0,0,0,0,0,0,16,11,27,16,11,27,0,299,5,0,1,2.27083,0.0625,21.6875,76.4879,48,4,7.7801,3.2199
Australia,228,239.627,7.69737,0.372807,232.079,7.23246,0.337719,BJ Haddin,0,0,0,0,0,0,0,0,12,9,21,12,9,21,0,249,4,1,1,3.14737,0.147368,26.7789,81.382,95,4,8.21609,0.783907
England,221,237.176,7.17647,0.289593,230.633,7.45701,0.384615,AJ Strauss,0,0,0,0,0,0,0,0,8,13,21,8,13,21,0,333,1,0,1,3.93243,0.27027,33.9054,79.8028,74,4,7.7801,5.2199
England,221,237.176,7.17647,0.289593,230.633,7.45701,0.384615,MJ Prior,0,0,0,0,0,0,0,0,8,13,21,8,13,21,0,333,1,0,1,2.27083,0.0625,21.6875,76.4879,48,4,7.7801,5.2199
Australia,228,239.627,7.69737,0.372807,232.079,7.23246,0.337719,CJ Ferguson,0,0,0,0,0,0,0,0,4,10,14,4,10,14,0,279,4,1,1,2.47826,0.173913,26.3478,80.4781,23,4,8.21609,1.78391
England,221,237.176,7.17647,0.289593,230.633,7.45701,0.384615,KP Pietersen,0,0,0,0,0,0,0,0,8,11,19,8,11,19,280,222,10,0,1,3.69892,0.236559,33.4946,82.2117,93,4,8.22357,2.77643
India,259,242.378,7.15058,0.339768,244.568,7.12741,0.30888,KD Karthik,0,0,0,0,0,0,0,0,12,8,20,12,8,20,0,285,22,0,1,2.46429,0.107143,21.6786,71.8769,56,1,8.42316,-0.423162
Zimbabwe,142,212.077,7.5,0.380282,227.704,6.97887,0.316901,H Masakadza,0,0,0,0,0,0,0,0,12,12,24,12,12,24,286,289,0,1,1,3.11215,0.186916,26.972,70.0485,107,4,7.00143,4.99857
Sri Lanka,244,223.373,7.09016,0.344262,227.578,7.47541,0.385246,TT Samaraweera,0,0,0,0,0,0,0,0,0,10,10,0,10,10,0,242,0,0,1,2.19231,0.0769231,23.4231,73.8182,26,4,7.38489,2.61511
India,259,242.378,7.15058,0.339768,244.568,7.12741,0.30888,M Vijay,0,0,0,0,0,0,0,0,8,10,18,8,10,18,243,243,2,0,1,2.25,0.0625,21.1875,65.6977,16,1,8.59944,1.40056
Zimbabwe,142,212.077,7.5,0.380282,227.704,6.97887,0.316901,BRM Taylor,0,0,0,0,0,0,0,0,4,12,16,4,12,16,0,118,2,1,1,3.3,0.26,33.56,76.3421,100,4,6.31573,5.68427
Sri Lanka,244,223.373,7.09016,0.344262,227.578,7.47541,0.385246,WU Tharanga,0,0,0,0,0,0,0,0,24,8,32,24,8,32,119,119,5,0,1,3.93985,0.263158,32.9699,71.6035,133,4,7.99591,0.00409174
India,259,242.378,7.15058,0.339768,244.568,7.12741,0.30888,KD Karthik,0,0,0,0,0,0,0,0,4,5,9,4,5,9,0,194,4,0,1,2.46429,0.107143,21.6786,71.8769,56,1,8.42316,-3.42316
India,259,242.378,7.15058,0.339768,244.568,7.12741,0.30888,M Vijay,0,0,0,0,0,0,0,0,4,5,9,4,5,9,0,194,4,0,1,2.25,0.0625,21.1875,65.6977,16,1,8.42316,-3.42316
India,259,242.378,7.15058,0.339768,244.568,7.12741,0.30888,G Gambhir,0,0,0,0,0,0,0,0,16,9,25,16,9,25,168,168,10,0,1,3.99145,0.333333,37.4701,84.1944,117,4,8.66104,0.338957
Sri Lanka,244,223.373,7.09016,0.344262,227.578,7.47541,0.385246,TM Dilshan,0,0,0,0,0,0,0,0,34,14,48,34,14,48,0,312,1,1,1,4.60199,0.273632,38.3632,86.0219,201,4,7.59431,6.40569
Bangladesh,160,218.438,7.70625,0.4,211.106,7.05,0.325,Tamim Iqbal,0,0,0,0,0,0,0,0,12,4,16,12,4,16,386,246,1,0,1,4.05344,0.274809,31.8015,76.8068,131,4,5.49593,-1.49593
India,259,242.378,7.15058,0.339768,244.568,7.12741,0.30888,G Gambhir,0,0,0,0,0,0,0,0,8,8,16,8,8,16,0,209,2,0,1,3.99145,0.333333,37.4701,84.1944,117,4,8.07854,-0.0785389
New Zealand,184,233.745,7.39674,0.36413,227.951,7.30435,0.353261,PJ Ingram,0,0,0,0,0,0,0,0,16,10,26,16,10,26,0,288,1,0,1,4.28571,0.142857,27.5714,80.7531,7,4,6.85021,3.14979
Sri Lanka,244,223.373,7.09016,0.344262,227.578,7.47541,0.385246,TM Dilshan,0,0,0,0,0,0,0,0,8,10,18,8,10,18,0,170,2,1,1,4.60199,0.273632,38.3632,86.0219,201,4,7.59431,2.40569
Sri Lanka,244,223.373,7.09016,0.344262,227.578,7.47541,0.385246,KC Sangakkara,0,0,0,0,0,0,0,0,12,7,19,12,7,19,193,195,1,1,1,4.33659,0.360976,41.9854,80.6276,205,4,7.31673,-0.316735
India,259,242.378,7.15058,0.339768,244.568,7.12741,0.30888,V Kohli,0,0,0,0,0,0,0,0,16,9,25,16,9,25,0,223,2,0,1,4.66456,0.379747,44.9937,88.3325,158,4,8.07854,0.921461
India,259,242.378,7.15058,0.339768,244.568,7.12741,0.30888,V Sehwag,0,0,0,0,0,0,0,0,8,12,20,8,12,20,0,103,0,0,1,5.88636,0.238636,38.8295,108.649,88,0,8.36621,3.63379
Sri Lanka,244,223.373,7.09016,0.344262,227.578,7.47541,0.385246,TM Dilshan,0,0,0,0,0,0,0,0,28,6,34,28,6,34,104,104,2,1,1,4.60199,0.273632,38.3632,86.0219,201,4,8.08216,-2.08216
India,259,242.378,7.15058,0.339768,244.568,7.12741,0.30888,V Kohli,0,0,0,0,0,0,0,0,24,7,31,24,7,31,300,225,3,0,1,4.66456,0.379747,44.9937,88.3325,158,4,9.01971,-2.01971
South Africa,190,234.274,7.4,0.373684,232.363,7.33158,0.342105,CA Ingram,0,0,0,0,0,0,0,0,20,5,25,20,5,25,0,286,0,0,1,3,0.178571,27.1786,81.3904,28,4,7.85679,-2.85679
Pakistan,211,222.621,7.38389,0.393365,235.517,7.54976,0.336493,Mohammad Hafeez,0,0,0,0,0,0,0,0,0,9,9,0,9,9,229,226,2,0,1,4.04511,0.255639,34.3534,78.0625,133,4,5.88292,3.11708
South Africa,190,234.274,7.4,0.373684,232.363,7.33158,0.342105,GC Smith,0,0,0,0,0,0,0,0,12,11,23,12,11,23,0,274,1,0,1,3.97,0.29,33.57,79.6819,100,4,7.85679,3.14321
Pakistan,211,222.621,7.38389,0.393365,235.517,7.54976,0.336493,Mohammad Hafeez,0,0,0,0,0,0,0,0,4,26,30,4,26,30,275,275,2,0,1,4.04511,0.255639,34.3534,78.0625,133,4,8.08449,17.9155
Pakistan,211,222.621,7.38389,0.393365,235.517,7.54976,0.336493,Mohammad Hafeez,0,0,0,0,0,0,0,0,20,6,26,20,6,26,318,260,1,0,1,4.04511,0.255639,34.3534,78.0625,133,4,7.69303,-1.69303
South Africa,190,234.274,7.4,0.373684,232.363,7.33158,0.342105,HM Amla,0,0,0,0,0,0,0,0,32,8,40,32,8,40,0,351,3,1,1,5.20168,0.403361,48.7899,86.9292,119,4,7.38502,0.614983
South Africa,190,234.274,7.4,0.373684,232.363,7.33158,0.342105,GC Smith,0,0,0,0,0,0,0,0,32,8,40,32,8,40,0,351,3,1,1,3.97,0.29,33.57,79.6819,100,4,7.38502,0.614983
South Africa,190,234.274,7.4,0.373684,232.363,7.33158,0.342105,GC Smith,0,0,0,0,0,0,0,0,12,12,24,12,12,24,269,273,2,1,1,3.97,0.29,33.57,79.6819,100,4,7.65828,4.34172
Zimbabwe,142,212.077,7.5,0.380282,227.704,6.97887,0.316901,CJ Chibhabha,0,0,0,0,0,0,0,0,14,9,23,14,9,23,400,127,0,0,1,2.56716,0.149254,23.5373,64.7373,67,1,8.00303,0.996969
India,259,242.378,7.15058,0.339768,244.568,7.12741,0.30888,M Vijay,0,0,0,0,0,0,0,0,8,4,12,8,4,12,0,190,0,0,1,2.25,0.0625,21.1875,65.6977,16,1,8.42316,-4.42316
South Africa,190,234.274,7.4,0.373684,232.363,7.33158,0.342105,GC Smith,0,0,0,0,0,0,0,0,12,11,23,12,11,23,0,220,0,1,1,3.97,0.29,33.57,79.6819,100,4,7.38502,3.61498
South Africa,190,234.274,7.4,0.373684,232.363,7.33158,0.342105,HM Amla,0,0,0,0,0,0,0,0,12,11,23,12,11,23,0,220,0,1,1,5.20168,0.403361,48.7899,86.9292,119,4,7.38502,3.61498
India,259,242.378,7.15058,0.339768,244.568,7.12741,0.30888,RG Sharma,0,0,0,0,0,0,0,0,4,8,12,4,8,12,221,223,2,0,1,3.82836,0.268657,35.9179,83.083,134,4,9.05616,-1.05616
India,259,242.378,7.15058,0.339768,244.568,7.12741,0.30888,V Kohli,0,0,0,0,0,0,0,0,4,8,12,4,8,12,221,223,2,0,1,4.66456,0.379747,44.9937,88.3325,158,4,9.05616,-1.05616
South Africa,190,234.274,7.4,0.373684,232.363,7.33158,0.342105,HM Amla,0,0,0,0,0,0,0,0,4,5,9,4,5,9,0,265,1,1,1,5.20168,0.403361,48.7899,86.9292,119,4,7.38502,-2.38502
India,259,242.378,7.15058,0.339768,244.568,7.12741,0.30888,V Kohli,0,0,0,0,0,0,0,0,16,3,19,16,3,19,266,142,0,0,1,4.66456,0.379747,44.9937,88.3325,158,4,8.06011,-5.06011
South Africa,190,234.274,7.4,0.373684,232.363,7.33158,0.342105,HM Amla,0,0,0,0,0,0,0,0,20,7,27,20,7,27,0,250,5,1,1,5.20168,0.403361,48.7899,86.9292,119,4,7.38502,-0.385017
Australia,228,239.627,7.69737,0.372807,232.079,7.23246,0.337719,SE Marsh,0,0,0,0,0,0,0,0,4,3,7,4,3,7,0,289,5,0,1,3.66667,0.291667,35.5417,74.7918,48,4,7.87937,-4.87937
West Indies,176,217.33,7.15909,0.3125,225.278,7.57386,0.380682,CH Gayle,0,0,0,0,0,0,0,0,12,5,17,12,5,17,278,251,0,0,1,4.58621,0.206897,31.1293,89.4255,116,4,6.7574,-1.7574
India,259,242.378,7.15058,0.339768,244.568,7.12741,0.30888,G Gambhir,0,0,0,0,0,0,0,0,8,10,18,8,10,18,259,259,0,1,1,3.99145,0.333333,37.4701,84.1944,117,4,7.40524,2.59476
India,259,242.378,7.15058,0.339768,244.568,7.12741,0.30888,PA Patel,0,0,0,0,0,0,0,0,12,5,17,12,5,17,316,321,1,1,1,2.65217,0.130435,22.1304,79.4072,23,4,5.5294,-0.529402
New Zealand,184,233.745,7.39674,0.36413,227.951,7.30435,0.353261,MJ Guptill,0,0,0,0,0,0,0,0,18,18,36,18,18,36,125,125,3,1,1,4.8087,0.313043,38.1217,82.7482,115,4,9.02051,8.97949
New Zealand,184,233.745,7.39674,0.36413,227.951,7.30435,0.353261,JD Ryder,0,0,0,0,0,0,0,0,18,18,36,18,18,36,125,125,3,1,1,4.88571,0.257143,34.4,97.2536,35,0,9.01271,8.98729
Pakistan,211,222.621,7.38389,0.393365,235.517,7.54976,0.336493,Ahmed Shehzad,0,0,0,0,0,0,0,0,4,9,13,4,9,13,0,293,0,0,1,3.67143,0.242857,33.2714,70.8118,70,4,7.14441,1.85559
Pakistan,211,222.621,7.38389,0.393365,235.517,7.54976,0.336493,Kamran Akmal,0,0,0,0,0,0,0,0,4,9,13,4,9,13,0,293,0,0,1,3.01124,0.11236,23.0787,81.4433,89,4,7.14441,1.85559
Pakistan,211,222.621,7.38389,0.393365,235.517,7.54976,0.336493,Younis Khan,0,0,0,0,0,0,0,0,4,9,13,4,9,13,0,293,0,0,1,2.64655,0.215517,28.5,73.2713,116,4,7.14441,1.85559
New Zealand,184,233.745,7.39674,0.36413,227.951,7.30435,0.353261,MJ Guptill,0,0,0,0,0,0,0,0,20,6,26,20,6,26,294,250,0,1,1,4.8087,0.313043,38.1217,82.7482,115,4,6.81399,-0.813993
New Zealand,184,233.745,7.39674,0.36413,227.951,7.30435,0.353261,JM How,0,0,0,0,0,0,0,0,16,4,20,16,4,20,0,262,5,1,1,3.34615,0.192308,29.9231,64.9416,26,4,6.8371,-2.8371
Pakistan,211,222.621,7.38389,0.393365,235.517,7.54976,0.336493,Mohammad Hafeez,0,0,0,0,0,0,0,0,8,3,11,8,3,11,0,268,0,0,1,4.04511,0.255639,34.3534,78.0625,133,4,7.14441,-4.14441
New Zealand,184,233.745,7.39674,0.36413,227.951,7.30435,0.353261,MJ Guptill,0,0,0,0,0,0,0,0,8,6,14,8,6,14,269,227,5,1,1,4.8087,0.313043,38.1217,82.7482,115,4,6.81399,-0.813993
Pakistan,211,222.621,7.38389,0.393365,235.517,7.54976,0.336493,Ahmed Shehzad,0,0,0,0,0,0,0,0,18,9,27,18,9,27,312,254,1,0,1,3.67143,0.242857,33.2714,70.8118,70,4,7.58392,1.41608
England,221,237.176,7.17647,0.289593,230.633,7.45701,0.384615,C Kieswetter,0,0,0,0,0,0,0,0,16,10,26,16,10,26,0,229,3,1,1,3.43243,0.135135,26.4324,88.0288,37,4,7.83019,2.16981
Sri Lanka,244,223.373,7.09016,0.344262,227.578,7.47541,0.385246,DPMD Jayawardene,0,0,0,0,0,0,0,0,20,9,29,20,9,29,247,249,1,0,1,3.20833,0.244792,31.6979,79.1109,192,4,9.04924,-0.0492373
Sri Lanka,244,223.373,7.09016,0.344262,227.578,7.47541,0.385246,KC Sangakkara,0,0,0,0,0,0,0,0,8,14,22,8,14,22,269,252,0,0,1,4.33659,0.360976,41.9854,80.6276,205,4,8.41404,5.58596
India,259,242.378,7.15058,0.339768,244.568,7.12741,0.30888,AM Rahane,0,0,0,0,0,0,0,0,0,5,5,0,5,5,0,234,4,0,1,3.55738,0.262295,32.2295,78.0159,61,4,8.07854,-3.07854
India,259,242.378,7.15058,0.339768,244.568,7.12741,0.30888,AM Rahane,0,0,0,0,0,0,0,0,0,12,12,0,12,12,0,304,7,0,1,3.55738,0.262295,32.2295,78.0159,61,4,8.07854,3.92146
England,221,237.176,7.17647,0.289593,230.633,7.45701,0.384615,C Kieswetter,0,0,0,0,0,0,0,0,20,9,29,20,9,29,305,241,0,1,1,3.43243,0.135135,26.4324,88.0288,37,4,7.78623,1.21377
Bangladesh,160,218.438,7.70625,0.4,211.106,7.05,0.325,Shahriar Nafees,0,0,0,0,0,0,0,0,16,3,19,16,3,19,0,228,0,1,1,3.40541,0.162162,24.4865,69.1076,37,4,6.38578,-3.38578
New Zealand,184,233.745,7.39674,0.36413,227.951,7.30435,0.353261,JD Ryder,0,0,0,0,0,0,0,0,24,15,39,24,15,39,229,200,0,0,1,4.88571,0.257143,34.4,97.2536,35,0,7.92016,7.07984
Bangladesh,160,218.438,7.70625,0.4,211.106,7.05,0.325,Shahriar Nafees,0,0,0,0,0,0,0,0,20,14,34,20,14,34,174,177,1,1,1,3.40541,0.162162,24.4865,69.1076,37,4,8.75436,5.24564
Bangladesh,160,218.438,7.70625,0.4,211.106,7.05,0.325,Imrul Kayes,0,0,0,0,0,0,0,0,16,9,25,16,9,25,0,241,2,1,1,3,0.207547,26.2642,63.6488,53,4,6.38578,2.61422
Bangladesh,160,218.438,7.70625,0.4,211.106,7.05,0.325,Junaid Siddique,0,0,0,0,0,0,0,0,16,9,25,16,9,25,0,241,2,1,1,2.16279,0.116279,20.0233,68.225,43,1,5.00096,3.99904
New Zealand,184,233.745,7.39674,0.36413,227.951,7.30435,0.353261,KS Williamson,0,0,0,0,0,0,0,0,0,11,11,0,11,11,175,171,4,0,1,4.31707,0.390244,43.0488,82.8833,82,4,7.59425,3.40575
Zimbabwe,142,212.077,7.5,0.380282,227.704,6.97887,0.316901,CJ Chibhabha,0,0,0,0,0,0,0,0,16,6,22,16,6,22,0,209,6,0,1,2.56716,0.149254,23.5373,64.7373,67,1,6.44168,-0.441683
Bangladesh,160,218.438,7.70625,0.4,211.106,7.05,0.325,Tamim Iqbal,0,0,0,0,0,0,0,0,8,3,11,8,3,11,0,246,4,1,1,4.05344,0.274809,31.8015,76.8068,131,4,6.38578,-3.38578
Pakistan,211,222.621,7.38389,0.393365,235.517,7.54976,0.336493,Mohammad Hafeez,0,0,0,0,0,0,0,0,28,7,35,28,7,35,222,222,0,0,1,4.04511,0.255639,34.3534,78.0625,133,4,7.84552,-0.845519
West Indies,176,217.33,7.15909,0.3125,225.278,7.57386,0.380682,LMP Simmons,0,0,0,0,0,0,0,0,10,9,19,10,9,19,0,220,4,1,1,3.3125,0.28125,30.5938,71.4338,64,4,6.48576,2.51424
Pakistan,211,222.621,7.38389,0.393365,235.517,7.54976,0.336493,Ahmed Shehzad,0,0,0,0,0,0,0,0,8,6,14,8,6,14,172,177,5,0,1,3.67143,0.242857,33.2714,70.8118,70,4,7.43073,-1.43073
Pakistan,211,222.621,7.38389,0.393365,235.517,7.54976,0.336493,Asad Shafiq,0,0,0,0,0,0,0,0,8,8,16,8,8,16,0,248,0,0,1,2.07843,0.176471,24.7843,67.1269,51,4,7.14441,0.85559
Pakistan,211,222.621,7.38389,0.393365,235.517,7.54976,0.336493,Mohammad Hafeez,0,0,0,0,0,0,0,0,8,9,17,8,9,17,0,139,1,0,1,4.04511,0.255639,34.3534,78.0625,133,4,7.14441,1.85559
West Indies,176,217.33,7.15909,0.3125,225.278,7.57386,0.380682,LMP Simmons,0,0,0,0,0,0,0,0,8,5,13,8,5,13,0,214,8,1,1,3.3125,0.28125,30.5938,71.4338,64,4,6.48576,-1.48576
India,259,242.378,7.15058,0.339768,244.568,7.12741,0.30888,PA Patel,0,0,0,0,0,0,0,0,4,11,15,4,11,15,0,251,2,0,1,2.65217,0.130435,22.1304,79.4072,23,4,8.07854,2.92146
West Indies,176,217.33,7.15909,0.3125,225.278,7.57386,0.380682,RR Sarwan,0,0,0,0,0,0,0,0,0,9,9,0,9,9,252,255,3,1,1,2.8254,0.222222,29.1429,69.1005,63,4,7.40482,1.59518
Australia,228,239.627,7.69737,0.372807,232.079,7.23246,0.337719,BJ Haddin,0,0,0,0,0,0,0,0,12,12,24,12,12,24,0,270,0,0,1,3.14737,0.147368,26.7789,81.382,95,4,7.87937,4.12063
Australia,228,239.627,7.69737,0.372807,232.079,7.23246,0.337719,RT Ponting,0,0,0,0,0,0,0,0,12,12,24,12,12,24,0,270,0,0,1,4.17431,0.33945,38.1009,80.8606,109,4,7.87937,4.12063
Bangladesh,160,218.438,7.70625,0.4,211.106,7.05,0.325,Raqibul Hasan,0,0,0,0,0,0,0,0,8,6,14,8,6,14,271,210,1,1,1,1.85106,0.12766,23.2766,59.2312,47,1,7.4082,-1.4082
Australia,228,239.627,7.69737,0.372807,232.079,7.23246,0.337719,BJ Haddin,0,0,0,0,0,0,0,0,26,7,33,26,7,33,230,232,1,0,1,3.14737,0.147368,26.7789,81.382,95,4,7.74942,-0.749417
Bangladesh,160,218.438,7.70625,0.4,211.106,7.05,0.325,Tamim Iqbal,0,0,0,0,0,0,0,0,38,4,42,38,4,42,362,295,1,1,1,4.05344,0.274809,31.8015,76.8068,131,4,5.29031,-1.29031
Australia,228,239.627,7.69737,0.372807,232.079,7.23246,0.337719,RT Ponting,0,0,0,0,0,0,0,0,32,4,36,32,4,36,0,183,1,0,1,4.17431,0.33945,38.1009,80.8606,109,4,7.87937,-3.87937
South Africa,190,234.274,7.4,0.373684,232.363,7.33158,0.342105,JH Kallis,0,0,0,0,0,0,0,0,14,6,20,14,6,20,184,129,1,1,1,3.58621,0.356322,37.2644,76.4442,87,4,7.73291,-1.73291
South Africa,190,234.274,7.4,0.373684,232.363,7.33158,0.342105,HM Amla,0,0,0,0,0,0,0,0,22,7,29,22,7,29,0,303,2,1,1,5.20168,0.403361,48.7899,86.9292,119,4,7.38502,-0.385017
South Africa,190,234.274,7.4,0.373684,232.363,7.33158,0.342105,JH Kallis,0,0,0,0,0,0,0,0,22,7,29,22,7,29,0,303,2,1,1,3.58621,0.356322,37.2644,76.4442,87,4,7.38502,-0.385017
Australia,228,239.627,7.69737,0.372807,232.079,7.23246,0.337719,DA Warner,0,0,0,0,0,0,0,0,16,9,25,16,9,25,223,227,2,0,1,4.20312,0.265625,35.2031,87.7336,64,4,8.14975,0.850246
South Africa,190,234.274,7.4,0.373684,232.363,7.33158,0.342105,GC Smith,0,0,0,0,0,0,0,0,0,16,16,0,16,16,0,301,2,1,1,3.97,0.29,33.57,79.6819,100,4,7.38502,8.61498
South Africa,190,234.274,7.4,0.373684,232.363,7.33158,0.342105,HM Amla,0,0,0,0,0,0,0,0,10,10,20,10,10,20,237,237,1,1,1,5.20168,0.403361,48.7899,86.9292,119,4,7.60042,2.39958
South Africa,190,234.274,7.4,0.373684,232.363,7.33158,0.342105,CA Ingram,0,0,0,0,0,0,0,0,4,9,13,4,9,13,267,179,1,1,1,3,0.178571,27.1786,81.3904,28,4,7.65828,1.34172
Sri Lanka,244,223.373,7.09016,0.344262,227.578,7.47541,0.385246,TM Dilshan,0,0,0,0,0,0,0,0,22,8,30,22,8,30,300,304,1,0,1,4.60199,0.273632,38.3632,86.0219,201,4,6.79601,1.20399
Australia,228,239.627,7.69737,0.372807,232.079,7.23246,0.337719,SR Watson,0,0,0,0,0,0,0,0,20,11,31,20,11,31,192,192,0,0,1,4.71318,0.286822,37.7907,90.0943,129,4,8.53685,2.46315
Sri Lanka,244,223.373,7.09016,0.344262,227.578,7.47541,0.385246,TM Dilshan,0,0,0,0,0,0,0,0,20,7,27,20,7,27,0,208,1,1,1,4.60199,0.273632,38.3632,86.0219,201,4,7.59431,-0.594315
Australia,228,239.627,7.69737,0.372807,232.079,7.23246,0.337719,SR Watson,0,0,0,0,0,0,0,0,12,6,18,12,6,18,209,211,3,0,1,4.71318,0.286822,37.7907,90.0943,129,4,8.14975,-2.14975
Australia,228,239.627,7.69737,0.372807,232.079,7.23246,0.337719,SR Watson,0,0,0,0,0,0,0,0,8,3,11,8,3,11,287,208,4,0,1,4.71318,0.286822,37.7907,90.0943,129,4,8.15721,-5.15721
Australia,228,239.627,7.69737,0.372807,232.079,7.23246,0.337719,BJ Haddin,0,0,0,0,0,0,0,0,8,3,11,8,3,11,287,208,4,0,1,3.14737,0.147368,26.7789,81.382,95,4,8.15721,-5.15721
Sri Lanka,244,223.373,7.09016,0.344262,227.578,7.47541,0.385246,WU Tharanga,0,0,0,0,0,0,0,0,12,7,19,12,7,19,0,132,0,1,1,3.93985,0.263158,32.9699,71.6035,133,4,7.59431,-0.594315
Australia,228,239.627,7.69737,0.372807,232.079,7.23246,0.337719,SR Watson,0,0,0,0,0,0,0,0,16,3,19,16,3,19,133,133,0,0,1,4.71318,0.286822,37.7907,90.0943,129,4,6.86409,-3.86409
Australia,228,239.627,7.69737,0.372807,232.079,7.23246,0.337719,SE Marsh,0,0,0,0,0,0,0,0,12,5,17,12,5,17,0,211,6,0,1,3.66667,0.291667,35.5417,74.7918,48,4,7.87937,-2.87937
Australia,228,239.627,7.69737,0.372807,232.079,7.23246,0.337719,DA Warner,0,0,0,0,0,0,0,0,4,10,14,4,10,14,0,216,1,1,1,4.20312,0.265625,35.2031,87.7336,64,4,8.21609,1.78391
India,259,242.378,7.15058,0.339768,244.568,7.12741,0.30888,V Kohli,0,0,0,0,0,0,0,0,0,13,13,0,13,13,217,151,5,0,1,4.66456,0.379747,44.9937,88.3325,158,4,9.05616,3.94384
Sri Lanka,244,223.373,7.09016,0.344262,227.578,7.47541,0.385246,WU Tharanga,0,0,0,0,0,0,0,0,12,8,20,12,8,20,0,233,0,0,1,3.93985,0.263158,32.9699,71.6035,133,4,7.38489,0.615109
India,259,242.378,7.15058,0.339768,244.568,7.12741,0.30888,V Sehwag,0,0,0,0,0,0,0,0,20,7,27,20,7,27,234,234,1,0,1,5.88636,0.238636,38.8295,108.649,88,0,8.48093,-1.48093
Australia,228,239.627,7.69737,0.372807,232.079,7.23246,0.337719,DA Warner,0,0,0,0,0,0,0,0,16,9,25,16,9,25,0,231,2,1,1,4.20312,0.265625,35.2031,87.7336,64,4,8.21609,0.783907
Australia,228,239.627,7.69737,0.372807,232.079,7.23246,0.337719,MS Wade,0,0,0,0,0,0,0,0,16,9,25,16,9,25,0,231,2,1,1,1.86275,0.117647,20.3333,78.2642,51,1,8.86464,0.135357
Sri Lanka,244,223.373,7.09016,0.344262,227.578,7.47541,0.385246,KC Sangakkara,0,0,0,0,0,0,0,0,12,4,16,12,4,16,232,226,0,0,1,4.33659,0.360976,41.9854,80.6276,205,4,8.14498,-4.14498
Sri Lanka,244,223.373,7.09016,0.344262,227.578,7.47541,0.385246,TM Dilshan,0,0,0,0,0,0,0,0,8,7,15,8,7,15,0,236,2,0,1,4.60199,0.273632,38.3632,86.0219,201,4,7.38489,-0.384891
India,259,242.378,7.15058,0.339768,244.568,7.12741,0.30888,G Gambhir,0,0,0,0,0,0,0,0,4,9,13,4,9,13,289,178,2,0,1,3.99145,0.333333,37.4701,84.1944,117,4,8.41005,0.589952
Sri Lanka,244,223.373,7.09016,0.344262,227.578,7.47541,0.385246,DPMD Jayawardene,0,0,0,0,0,0,0,0,8,13,21,8,13,21,0,289,1,0,1,3.20833,0.244792,31.6979,79.1109,192,4,7.38489,5.61511
Australia,228,239.627,7.69737,0.372807,232.079,7.23246,0.337719,PJ Forrest,0,0,0,0,0,0,0,0,4,5,9,4,5,9,0,252,1,1,1,2.71429,0.285714,26.2143,63.6049,14,4,8.21609,-3.21609
Sri Lanka,244,223.373,7.09016,0.344262,227.578,7.47541,0.385246,DPMD Jayawardene,0,0,0,0,0,0,0,0,12,4,16,12,4,16,0,238,1,0,1,3.20833,0.244792,31.6979,79.1109,192,4,7.38489,-3.38489
Australia,228,239.627,7.69737,0.372807,232.079,7.23246,0.337719,PJ Forrest,0,0,0,0,0,0,0,0,12,12,24,12,12,24,239,229,2,1,1,2.71429,0.285714,26.2143,63.6049,14,4,8.52617,3.47383
Sri Lanka,244,223.373,7.09016,0.344262,227.578,7.47541,0.385246,DPMD Jayawardene,0,0,0,0,0,0,0,0,24,11,35,24,11,35,322,306,4,0,1,3.20833,0.244792,31.6979,79.1109,192,4,10.2895,0.710467
Australia,228,239.627,7.69737,0.372807,232.079,7.23246,0.337719,MS Wade,0,0,0,0,0,0,0,0,8,11,19,8,11,19,0,271,4,1,1,1.86275,0.117647,20.3333,78.2642,51,1,8.86464,2.13536
Australia,228,239.627,7.69737,0.372807,232.079,7.23246,0.337719,DA Warner,0,0,0,0,0,0,0,0,8,11,19,8,11,19,0,271,4,1,1,4.20312,0.265625,35.2031,87.7336,64,4,8.21609,2.78391
Sri Lanka,244,223.373,7.09016,0.344262,227.578,7.47541,0.385246,TM Dilshan,0,0,0,0,0,0,0,0,20,9,29,20,9,29,272,274,13,0,1,4.60199,0.273632,38.3632,86.0219,201,4,8.41404,0.585957
New Zealand,184,233.745,7.39674,0.36413,227.951,7.30435,0.353261,BB McCullum,0,0,0,0,0,0,0,0,16,9,25,16,9,25,0,248,2,1,1,3.98611,0.201389,29.9028,98.4004,144,0,6.7086,2.2914
Zimbabwe,142,212.077,7.5,0.380282,227.704,6.97887,0.316901,H Masakadza,0,0,0,0,0,0,0,0,0,11,11,0,11,11,373,231,1,0,1,3.11215,0.186916,26.972,70.0485,107,4,10.5113,0.488662
Zimbabwe,142,212.077,7.5,0.380282,227.704,6.97887,0.316901,S Matsikenyeri,0,0,0,0,0,0,0,0,0,11,11,0,11,11,373,231,1,0,1,2,0.106383,19.9787,75.7869,47,1,8.59418,2.40582
South Africa,190,234.274,7.4,0.373684,232.363,7.33158,0.342105,HM Amla,0,0,0,0,0,0,0,0,8,11,19,8,11,19,254,254,0,0,1,5.20168,0.403361,48.7899,86.9292,119,4,8.31314,2.68686
South Africa,190,234.274,7.4,0.373684,232.363,7.33158,0.342105,GC Smith,0,0,0,0,0,0,0,0,8,11,19,8,11,19,254,254,0,0,1,3.97,0.29,33.57,79.6819,100,4,8.31314,2.68686
New Zealand,184,233.745,7.39674,0.36413,227.951,7.30435,0.353261,MJ Guptill,0,0,0,0,0,0,0,0,4,9,13,4,9,13,0,206,1,1,1,4.8087,0.313043,38.1217,82.7482,115,4,6.8371,2.1629
India,259,242.378,7.15058,0.339768,244.568,7.12741,0.30888,PA Patel,0,0,0,0,0,0,0,0,4,10,14,4,10,14,0,300,5,1,1,2.65217,0.130435,22.1304,79.4072,23,4,6.85241,3.14759
England,221,237.176,7.17647,0.289593,230.633,7.45701,0.384615,KP Pietersen,0,0,0,0,0,0,0,0,20,9,29,20,9,29,301,174,0,0,1,3.69892,0.236559,33.4946,82.2117,93,4,8.83323,0.166775
India,259,242.378,7.15058,0.339768,244.568,7.12741,0.30888,PA Patel,0,0,0,0,0,0,0,0,8,5,13,8,5,13,238,238,1,1,1,2.65217,0.130435,22.1304,79.4072,23,4,7.5505,-2.5505
Zimbabwe,142,212.077,7.5,0.380282,227.704,6.97887,0.316901,H Masakadza,0,0,0,0,0,0,0,0,4,4,8,4,4,8,189,191,0,1,1,3.11215,0.186916,26.972,70.0485,107,4,6.31109,-2.31109
Bangladesh,160,218.438,7.70625,0.4,211.106,7.05,0.325,Tamim Iqbal,0,0,0,0,0,0,0,0,4,11,15,4,11,15,0,253,1,0,1,4.05344,0.274809,31.8015,76.8068,131,4,7.85483,3.14517
Zimbabwe,142,212.077,7.5,0.380282,227.704,6.97887,0.316901,CJ Chibhabha,0,0,0,0,0,0,0,0,4,6,10,4,6,10,0,225,4,1,1,2.56716,0.149254,23.5373,64.7373,67,1,6.12263,-0.122631
Zimbabwe,142,212.077,7.5,0.380282,227.704,6.97887,0.316901,CJ Chibhabha,0,0,0,0,0,0,0,0,4,3,7,4,3,7,0,231,0,1,1,2.56716,0.149254,23.5373,64.7373,67,1,6.12263,-3.12263
New Zealand,184,233.745,7.39674,0.36413,227.951,7.30435,0.353261,MJ Guptill,0,0,0,0,0,0,0,0,20,19,39,20,19,39,232,232,4,0,1,4.8087,0.313043,38.1217,82.7482,115,4,7.6446,11.3554
Zimbabwe,142,212.077,7.5,0.380282,227.704,6.97887,0.316901,BRM Taylor,0,0,0,0,0,0,0,0,14,6,20,14,6,20,329,329,0,1,1,3.3,0.26,33.56,76.3421,100,4,6.82497,-0.824965
Pakistan,211,222.621,7.38389,0.393365,235.517,7.54976,0.336493,Imran Farhat,0,0,0,0,0,0,0,0,12,9,21,12,9,21,132,132,9,0,1,3.03333,0.266667,27.0333,62.9658,30,4,6.93537,2.06463
Pakistan,211,222.621,7.38389,0.393365,235.517,7.54976,0.336493,Younis Khan,0,0,0,0,0,0,0,0,12,8,20,12,8,20,236,210,3,0,1,2.64655,0.215517,28.5,73.2713,116,4,6.66557,1.33443
Pakistan,211,222.621,7.38389,0.393365,235.517,7.54976,0.336493,Imran Farhat,0,0,0,0,0,0,0,0,12,4,16,12,4,16,0,200,2,0,1,3.03333,0.266667,27.0333,62.9658,30,4,7.14441,-3.14441
Sri Lanka,244,223.373,7.09016,0.344262,227.578,7.47541,0.385246,KC Sangakkara,0,0,0,0,0,0,0,0,4,12,16,4,12,16,0,218,4,0,1,4.33659,0.360976,41.9854,80.6276,205,4,7.38489,4.61511
England,221,237.176,7.17647,0.289593,230.633,7.45701,0.384615,KP Pietersen,0,0,0,0,0,0,0,0,8,11,19,8,11,19,0,260,5,0,1,3.69892,0.236559,33.4946,82.2117,93,4,7.7801,3.2199
Pakistan,211,222.621,7.38389,0.393365,235.517,7.54976,0.336493,Asad Shafiq,0,0,0,0,0,0,0,0,12,6,18,12,6,18,261,130,2,0,1,2.07843,0.176471,24.7843,67.1269,51,4,8.09637,-2.09637
England,221,237.176,7.17647,0.289593,230.633,7.45701,0.384615,AN Cook,0,0,0,0,0,0,0,0,8,4,12,8,4,12,0,250,7,0,1,4.17045,0.272727,35.75,75.5524,88,4,7.7801,-3.7801
England,221,237.176,7.17647,0.289593,230.633,7.45701,0.384615,KP Pietersen,0,0,0,0,0,0,0,0,8,4,12,8,4,12,0,250,7,0,1,3.69892,0.236559,33.4946,82.2117,93,4,7.7801,-3.7801
West Indies,176,217.33,7.15909,0.3125,225.278,7.57386,0.380682,LMP Simmons,0,0,0,0,0,0,0,0,0,10,10,0,10,10,0,298,1,0,1,3.3125,0.28125,30.5938,71.4338,64,4,5.82675,4.17325
Bangladesh,160,218.438,7.70625,0.4,211.106,7.05,0.325,Mushfiqur Rahim,0,0,0,0,0,0,0,0,16,2,18,16,2,18,0,220,0,1,1,2.61111,0.18254,27.7778,75.2526,126,4,6.38578,-4.38578
West Indies,176,217.33,7.15909,0.3125,225.278,7.57386,0.380682,DP Hyatt,0,0,0,0,0,0,0,0,0,7,7,0,7,7,0,61,1,0,1,1.55556,0,12.4444,59.2593,9,3,6.1107,0.889296
England,221,237.176,7.17647,0.289593,230.633,7.45701,0.384615,AN Cook,0,0,0,0,0,0,0,0,4,8,12,4,8,12,0,288,4,1,1,4.17045,0.272727,35.75,75.5524,88,4,7.83019,0.169808
England,221,237.176,7.17647,0.289593,230.633,7.45701,0.384615,IR Bell,0,0,0,0,0,0,0,0,4,8,12,4,8,12,0,288,4,1,1,3.63433,0.246269,35.3806,75.6623,134,4,7.83019,0.169808
England,221,237.176,7.17647,0.289593,230.633,7.45701,0.384615,AN Cook,0,0,0,0,0,0,0,0,16,5,21,16,5,21,239,239,2,1,1,4.17045,0.272727,35.75,75.5524,88,4,8.11927,-3.11927
England,221,237.176,7.17647,0.289593,230.633,7.45701,0.384615,AN Cook,0,0,0,0,0,0,0,0,0,7,7,0,7,7,0,272,4,1,1,4.17045,0.272727,35.75,75.5524,88,4,7.83019,-0.830192
Australia,228,239.627,7.69737,0.372807,232.079,7.23246,0.337719,SR Watson,0,0,0,0,0,0,0,0,0,14,14,0,14,14,273,257,1,0,1,4.71318,0.286822,37.7907,90.0943,129,4,9.24912,4.75088
England,221,237.176,7.17647,0.289593,230.633,7.45701,0.384615,IJL Trott,0,0,0,0,0,0,0,0,8,11,19,8,11,19,146,138,1,1,1,3.3871,0.403226,43.7903,75.2494,62,4,8.18088,2.81912
England,221,237.176,7.17647,0.289593,230.633,7.45701,0.384615,IJL Trott,0,0,0,0,0,0,0,0,12,3,15,12,3,15,212,212,2,1,1,3.3871,0.403226,43.7903,75.2494,62,4,7.5607,-4.5607
South Africa,190,234.274,7.4,0.373684,232.363,7.33158,0.342105,HM Amla,0,0,0,0,0,0,0,0,8,8,16,8,8,16,0,220,1,0,1,5.20168,0.403361,48.7899,86.9292,119,4,7.85679,0.143212
England,221,237.176,7.17647,0.289593,230.633,7.45701,0.384615,IR Bell,0,0,0,0,0,0,0,0,20,3,23,20,3,23,0,182,1,1,1,3.63433,0.246269,35.3806,75.6623,134,4,7.83019,-4.83019
India,259,242.378,7.15058,0.339768,244.568,7.12741,0.30888,G Gambhir,0,0,0,0,0,0,0,0,8,7,15,8,7,15,0,304,2,0,1,3.99145,0.333333,37.4701,84.1944,117,4,8.07854,-1.07854
Pakistan,211,222.621,7.38389,0.393365,235.517,7.54976,0.336493,Mohammad Hafeez,0,0,0,0,0,0,0,0,4,7,11,4,7,11,189,189,0,0,1,4.04511,0.255639,34.3534,78.0625,133,4,7.31618,-0.316181
Pakistan,211,222.621,7.38389,0.393365,235.517,7.54976,0.336493,Nasir Jamshed,0,0,0,0,0,0,0,0,20,6,26,20,6,26,0,329,1,0,1,3.63043,0.23913,30.2174,73.8184,46,4,7.14441,-1.14441
Sri Lanka,244,223.373,7.09016,0.344262,227.578,7.47541,0.385246,KC Sangakkara,0,0,0,0,0,0,0,0,12,8,20,12,8,20,0,232,0,0,1,4.33659,0.360976,41.9854,80.6276,205,4,7.38489,0.615109
Bangladesh,160,218.438,7.70625,0.4,211.106,7.05,0.325,Tamim Iqbal,0,0,0,0,0,0,0,0,12,7,19,12,7,19,233,212,6,1,1,4.05344,0.274809,31.8015,76.8068,131,4,7.10877,-0.10877
Pakistan,211,222.621,7.38389,0.393365,235.517,7.54976,0.336493,Nasir Jamshed,0,0,0,0,0,0,0,0,12,5,17,12,5,17,0,236,2,0,1,3.63043,0.23913,30.2174,73.8184,46,4,7.14441,-2.14441
Pakistan,211,222.621,7.38389,0.393365,235.517,7.54976,0.336493,Younis Khan,0,0,0,0,0,0,0,0,12,5,17,12,5,17,0,236,2,0,1,2.64655,0.215517,28.5,73.2713,116,4,7.14441,-2.14441
Bangladesh,160,218.438,7.70625,0.4,211.106,7.05,0.325,Tamim Iqbal,0,0,0,0,0,0,0,0,8,6,14,8,6,14,237,234,0,1,1,4.05344,0.274809,31.8015,76.8068,131,4,7.10877,-1.10877
West Indies,176,217.33,7.15909,0.3125,225.278,7.57386,0.380682,LMP Simmons,0,0,0,0,0,0,0,0,12,6,18,12,6,18,0,211,1,0,1,3.3125,0.28125,30.5938,71.4338,64,4,5.82675,0.173253
India,259,242.378,7.15058,0.339768,244.568,7.12741,0.30888,G Gambhir,0,0,0,0,0,0,0,0,24,10,34,24,10,34,212,213,8,1,1,3.99145,0.333333,37.4701,84.1944,117,4,8.40129,1.59871
West Indies,176,217.33,7.15909,0.3125,225.278,7.57386,0.380682,LMP Simmons,0,0,0,0,0,0,0,0,4,3,7,4,3,7,0,260,0,0,1,3.3125,0.28125,30.5938,71.4338,64,4,5.82675,-2.82675
West Indies,176,217.33,7.15909,0.3125,225.278,7.57386,0.380682,MN Samuels,0,0,0,0,0,0,0,0,4,3,7,4,3,7,0,260,0,0,1,3.74757,0.23301,31.6214,74.5821,103,4,5.82675,-2.82675
India,259,242.378,7.15058,0.339768,244.568,7.12741,0.30888,AM Rahane,0,0,0,0,0,0,0,0,4,14,18,4,14,18,0,267,1,1,1,3.55738,0.262295,32.2295,78.0159,61,4,6.85241,7.14759
India,259,242.378,7.15058,0.339768,244.568,7.12741,0.30888,MK Tiwary,0,0,0,0,0,0,0,0,4,14,18,4,14,18,0,267,1,1,1,2.7,0.2,28.2,72.3077,10,4,6.85241,7.14759
Pakistan,211,222.621,7.38389,0.393365,235.517,7.54976,0.336493,Mohammad Hafeez,0,0,0,0,0,0,0,0,16,2,18,16,2,18,92,93,2,0,1,4.04511,0.255639,34.3534,78.0625,133,4,5.28132,-3.28132
Pakistan,211,222.621,7.38389,0.393365,235.517,7.54976,0.336493,Mohammad Hafeez,0,0,0,0,0,0,0,0,12,1,13,12,1,13,0,262,5,0,1,4.04511,0.255639,34.3534,78.0625,133,4,7.14441,-6.14441
Pakistan,211,222.621,7.38389,0.393365,235.517,7.54976,0.336493,Imran Farhat,0,0,0,0,0,0,0,0,12,1,13,12,1,13,0,262,5,0,1,3.03333,0.266667,27.0333,62.9658,30,4,7.14441,-6.14441
Pakistan,211,222.621,7.38389,0.393365,235.517,7.54976,0.336493,Mohammad Hafeez,0,0,0,0,0,0,0,0,8,5,13,8,5,13,0,177,5,0,1,4.04511,0.255639,34.3534,78.0625,133,4,7.14441,-2.14441
Bangladesh,160,218.438,7.70625,0.4,211.106,7.05,0.325,Mahmudullah,0,0,0,0,0,0,0,0,4,9,13,4,9,13,178,119,3,1,1,2.26531,0.153061,24.4286,70.9544,98,4,8.37617,0.623827
Australia,228,239.627,7.69737,0.372807,232.079,7.23246,0.337719,DA Warner,0,0,0,0,0,0,0,0,16,7,23,16,7,23,0,204,2,0,1,4.20312,0.265625,35.2031,87.7336,64,4,7.87937,-0.879366
West Indies,176,217.33,7.15909,0.3125,225.278,7.57386,0.380682,J Charles,0,0,0,0,0,0,0,0,16,4,20,16,4,20,205,140,1,1,1,3.82353,0.147059,28.2353,81.2183,34,4,5.96997,-1.96997
West Indies,176,217.33,7.15909,0.3125,225.278,7.57386,0.380682,MN Samuels,0,0,0,0,0,0,0,0,16,4,20,16,4,20,205,140,1,1,1,3.74757,0.23301,31.6214,74.5821,103,4,5.96997,-1.96997
West Indies,176,217.33,7.15909,0.3125,225.278,7.57386,0.380682,KOA Powell,0,0,0,0,0,0,0,0,8,8,16,8,8,16,155,163,0,1,1,3.59259,0.222222,26.4815,80.6088,27,4,8.50339,-0.503388
Australia,228,239.627,7.69737,0.372807,232.079,7.23246,0.337719,SR Watson,0,0,0,0,0,0,0,0,20,13,33,20,13,33,0,220,0,0,1,4.71318,0.286822,37.7907,90.0943,129,4,7.87937,5.12063
Australia,228,239.627,7.69737,0.372807,232.079,7.23246,0.337719,DA Warner,0,0,0,0,0,0,0,0,20,13,33,20,13,33,0,220,0,0,1,4.20312,0.265625,35.2031,87.7336,64,4,7.87937,5.12063
Australia,228,239.627,7.69737,0.372807,232.079,7.23246,0.337719,SR Watson,0,0,0,0,0,0,0,0,18,11,29,18,11,29,0,281,1,0,1,4.71318,0.286822,37.7907,90.0943,129,4,7.87937,3.12063
West Indies,176,217.33,7.15909,0.3125,225.278,7.57386,0.380682,J Charles,0,0,0,0,0,0,0,0,4,1,5,4,1,5,282,251,2,1,1,3.82353,0.147059,28.2353,81.2183,34,4,5.29499,-4.29499
West Indies,176,217.33,7.15909,0.3125,225.278,7.57386,0.380682,AB Barath,0,0,0,0,0,0,0,0,4,1,5,4,1,5,282,251,2,1,1,2.76923,0.0769231,21.6154,56.4257,13,3,5.29499,-4.29499
New Zealand,184,233.745,7.39674,0.36413,227.951,7.30435,0.353261,MJ Guptill,0,0,0,0,0,0,0,0,4,8,12,4,8,12,0,190,3,0,1,4.8087,0.313043,38.1217,82.7482,115,4,6.85021,1.14979
West Indies,176,217.33,7.15909,0.3125,225.278,7.57386,0.380682,LMP Simmons,0,0,0,0,0,0,0,0,4,4,8,4,4,8,191,136,6,1,1,3.3125,0.28125,30.5938,71.4338,64,4,5.02944,-1.02944
West Indies,176,217.33,7.15909,0.3125,225.278,7.57386,0.380682,DR Smith,0,0,0,0,0,0,0,0,4,4,8,4,4,8,191,136,6,1,1,2.5,0.12,17.96,84.5574,50,1,5.39739,-1.39739
New Zealand,184,233.745,7.39674,0.36413,227.951,7.30435,0.353261,RJ Nicol,0,0,0,0,0,0,0,0,12,7,19,12,7,19,316,260,1,0,1,3.3,0.2,29.25,73.4003,20,4,7.92638,-0.926383
Pakistan,211,222.621,7.38389,0.393365,235.517,7.54976,0.336493,Mohammad Hafeez,0,0,0,0,0,0,0,0,20,6,26,20,6,26,281,204,0,0,1,4.04511,0.255639,34.3534,78.0625,133,4,8.08449,-2.08449
Pakistan,211,222.621,7.38389,0.393365,235.517,7.54976,0.336493,Mohammad Hafeez,0,0,0,0,0,0,0,0,8,5,13,8,5,13,244,199,4,0,1,4.04511,0.255639,34.3534,78.0625,133,4,6.18778,-1.18778
Pakistan,211,222.621,7.38389,0.393365,235.517,7.54976,0.336493,Azhar Ali,0,0,0,0,0,0,0,0,8,5,13,8,5,13,244,199,4,0,1,3.83333,0.3,38.5333,73.6775,30,4,6.18778,-1.18778
Sri Lanka,244,223.373,7.09016,0.344262,227.578,7.47541,0.385246,TM Dilshan,0,0,0,0,0,0,0,0,4,8,12,4,8,12,248,248,6,1,1,4.60199,0.273632,38.3632,86.0219,201,4,7.59873,0.401274
Sri Lanka,244,223.373,7.09016,0.344262,227.578,7.47541,0.385246,WU Tharanga,0,0,0,0,0,0,0,0,4,10,14,4,10,14,0,286,5,1,1,3.93985,0.263158,32.9699,71.6035,133,4,7.59431,2.40569
Sri Lanka,244,223.373,7.09016,0.344262,227.578,7.47541,0.385246,TM Dilshan,0,0,0,0,0,0,0,0,12,6,18,12,6,18,0,251,4,1,1,4.60199,0.273632,38.3632,86.0219,201,4,7.59431,-1.59431
Sri Lanka,244,223.373,7.09016,0.344262,227.578,7.47541,0.385246,HDRL Thirimanne,0,0,0,0,0,0,0,0,8,15,23,8,15,23,295,274,12,1,1,2.77778,0.246914,31.5802,71.4725,81,4,8.26947,6.73053
England,221,237.176,7.17647,0.289593,230.633,7.45701,0.384615,AN Cook,0,0,0,0,0,0,0,0,12,9,21,12,9,21,0,325,0,0,1,4.17045,0.272727,35.75,75.5524,88,4,7.7801,1.2199
India,259,242.378,7.15058,0.339768,244.568,7.12741,0.30888,Yuvraj Singh,0,0,0,0,0,0,0,0,4,9,13,4,9,13,0,285,6,1,1,4.05833,0.258333,32.525,83.8093,120,4,6.85241,2.14759
England,221,237.176,7.17647,0.289593,230.633,7.45701,0.384615,KP Pietersen,0,0,0,0,0,0,0,0,12,7,19,12,7,19,286,158,4,0,1,3.69892,0.236559,33.4946,82.2117,93,4,8.22357,-1.22357
India,259,242.378,7.15058,0.339768,244.568,7.12741,0.30888,G Gambhir,0,0,0,0,0,0,0,0,16,3,19,16,3,19,258,258,1,1,1,3.99145,0.333333,37.4701,84.1944,117,4,7.40524,-4.40524
India,259,242.378,7.15058,0.339768,244.568,7.12741,0.30888,RG Sharma,0,0,0,0,0,0,0,0,12,1,13,12,1,13,0,226,1,1,1,3.82836,0.268657,35.9179,83.083,134,4,6.85241,-5.85241
New Zealand,184,233.745,7.39674,0.36413,227.951,7.30435,0.353261,LRPL Taylor,0,0,0,0,0,0,0,0,16,5,21,16,5,21,228,231,5,0,1,3.68382,0.301471,36.7206,79.3959,136,4,7.25603,-2.25603
New Zealand,184,233.745,7.39674,0.36413,227.951,7.30435,0.353261,MJ Guptill,0,0,0,0,0,0,0,0,16,5,21,16,5,21,228,231,5,0,1,4.8087,0.313043,38.1217,82.7482,115,4,7.25603,-2.25603
Ireland,55,219.527,7.65455,0.290909,202.727,7.56364,0.4,WTS Porterfield,0,0,0,0,0,0,0,0,24,3,27,24,3,27,0,269,6,1,1,2.6,0.142857,24.6857,56.2866,35,3,6.97902,-3.97902
Ireland,55,219.527,7.65455,0.290909,202.727,7.56364,0.4,PR Stirling,0,0,0,0,0,0,0,0,24,3,27,24,3,27,0,269,6,1,1,3.47826,0.173913,24.2174,88.1329,23,0,6.00209,-3.00209
Ireland,55,219.527,7.65455,0.290909,202.727,7.56364,0.4,EC Joyce,0,0,0,0,0,0,0,0,24,3,27,24,3,27,0,269,6,1,1,3.08571,0.2,28.3429,68.6505,35,4,4.24406,-1.24406
England,221,237.176,7.17647,0.289593,230.633,7.45701,0.384615,JWA Taylor,0,0,0,0,0,0,0,0,12,5,17,12,5,17,270,274,0,0,1,3.375,0.333333,35.9167,79.8888,24,4,7.87362,-2.87362
England,221,237.176,7.17647,0.289593,230.633,7.45701,0.384615,JE Root,0,0,0,0,0,0,0,0,4,3,7,4,3,7,316,227,3,1,1,3.68852,0.327869,41.6721,83.3443,61,4,5.48006,-2.48006
Australia,228,239.627,7.69737,0.372807,232.079,7.23246,0.337719,SE Marsh,0,0,0,0,0,0,0,0,8,3,11,8,3,11,0,227,4,0,1,3.66667,0.291667,35.5417,74.7918,48,4,7.87937,-4.87937
England,221,237.176,7.17647,0.289593,230.633,7.45701,0.384615,EJG Morgan,0,0,0,0,0,0,0,0,8,6,14,8,6,14,228,231,2,1,1,3.19549,0.233083,30.0526,86.9291,133,4,6.76246,-0.762459
England,221,237.176,7.17647,0.289593,230.633,7.45701,0.384615,KP Pietersen,0,0,0,0,0,0,0,0,12,10,22,12,10,22,299,249,0,1,1,3.69892,0.236559,33.4946,82.2117,93,4,8.01028,1.98972
South Africa,190,234.274,7.4,0.373684,232.363,7.33158,0.342105,CA Ingram,0,0,0,0,0,0,0,0,4,9,13,4,9,13,0,175,3,0,1,3,0.178571,27.1786,81.3904,28,4,7.85679,1.14321
South Africa,190,234.274,7.4,0.373684,232.363,7.33158,0.342105,HM Amla,0,0,0,0,0,0,0,0,4,9,13,4,9,13,0,175,3,0,1,5.20168,0.403361,48.7899,86.9292,119,4,7.85679,1.14321
South Africa,190,234.274,7.4,0.373684,232.363,7.33158,0.342105,CA Ingram,0,0,0,0,0,0,0,0,4,15,19,4,15,19,0,208,6,1,1,3,0.178571,27.1786,81.3904,28,4,7.38502,7.61498
New Zealand,184,233.745,7.39674,0.36413,227.951,7.30435,0.353261,BJ Watling,0,0,0,0,0,0,0,0,8,1,9,8,1,9,209,209,1,0,1,3,0.263158,27.7895,66.9202,19,4,6.96092,-5.96092
New Zealand,184,233.745,7.39674,0.36413,227.951,7.30435,0.353261,KS Williamson,0,0,0,0,0,0,0,0,8,1,9,8,1,9,209,209,1,0,1,4.31707,0.390244,43.0488,82.8833,82,4,6.96092,-5.96092
New Zealand,184,233.745,7.39674,0.36413,227.951,7.30435,0.353261,MJ Guptill,0,0,0,0,0,0,0,0,8,5,13,8,5,13,0,260,2,0,1,4.8087,0.313043,38.1217,82.7482,115,4,6.85021,-1.85021
South Africa,190,234.274,7.4,0.373684,232.363,7.33158,0.342105,GC Smith,0,0,0,0,0,0,0,0,8,6,14,8,6,14,0,315,1,1,1,3.97,0.29,33.57,79.6819,100,4,7.38502,-1.38502
South Africa,190,234.274,7.4,0.373684,232.363,7.33158,0.342105,HM Amla,0,0,0,0,0,0,0,0,12,11,23,12,11,23,0,191,3,1,1,5.20168,0.403361,48.7899,86.9292,119,4,7.38502,3.61498
South Africa,190,234.274,7.4,0.373684,232.363,7.33158,0.342105,GC Smith,0,0,0,0,0,0,0,0,12,11,23,12,11,23,0,191,3,1,1,3.97,0.29,33.57,79.6819,100,4,7.38502,3.61498
South Africa,190,234.274,7.4,0.373684,232.363,7.33158,0.342105,CA Ingram,0,0,0,0,0,0,0,0,4,5,9,4,5,9,0,343,2,1,1,3,0.178571,27.1786,81.3904,28,4,7.38502,-2.38502
South Africa,190,234.274,7.4,0.373684,232.363,7.33158,0.342105,CA Ingram,0,0,0,0,0,0,0,0,12,6,18,12,6,18,0,234,1,1,1,3,0.178571,27.1786,81.3904,28,4,7.38502,-1.38502
England,221,237.176,7.17647,0.289593,230.633,7.45701,0.384615,IR Bell,0,0,0,0,0,0,0,0,12,4,16,12,4,16,270,270,1,0,1,3.63433,0.246269,35.3806,75.6623,134,4,7.87362,-3.87362
Pakistan,211,222.621,7.38389,0.393365,235.517,7.54976,0.336493,Mohammad Hafeez,0,0,0,0,0,0,0,0,4,11,15,4,11,15,0,198,5,0,1,4.04511,0.255639,34.3534,78.0625,133,4,7.14441,3.85559
Australia,228,239.627,7.69737,0.372807,232.079,7.23246,0.337719,MS Wade,0,0,0,0,0,0,0,0,12,8,20,12,8,20,0,248,7,0,1,1.86275,0.117647,20.3333,78.2642,51,1,7.305,0.694996
Australia,228,239.627,7.69737,0.372807,232.079,7.23246,0.337719,DA Warner,0,0,0,0,0,0,0,0,12,8,20,12,8,20,0,248,7,0,1,4.20312,0.265625,35.2031,87.7336,64,4,7.87937,0.120634
Pakistan,211,222.621,7.38389,0.393365,235.517,7.54976,0.336493,Mohammad Hafeez,0,0,0,0,0,0,0,0,16,8,24,16,8,24,0,244,2,0,1,4.04511,0.255639,34.3534,78.0625,133,4,7.14441,0.85559
Sri Lanka,244,223.373,7.09016,0.344262,227.578,7.47541,0.385246,DPMD Jayawardene,0,0,0,0,0,0,0,0,4,7,11,4,7,11,75,75,2,0,1,3.20833,0.244792,31.6979,79.1109,192,4,7.25946,-0.259463
West Indies,176,217.33,7.15909,0.3125,225.278,7.57386,0.380682,KOA Powell,0,0,0,0,0,0,0,0,8,3,11,8,3,11,0,70,3,0,1,3.59259,0.222222,26.4815,80.6088,27,4,5.82675,-2.82675
Australia,228,239.627,7.69737,0.372807,232.079,7.23246,0.337719,AJ Finch,0,0,0,0,0,0,0,0,12,6,18,12,6,18,0,266,2,1,1,4.52941,0.313725,37.2549,83.4431,51,4,8.21609,-2.21609
Australia,228,239.627,7.69737,0.372807,232.079,7.23246,0.337719,SR Watson,0,0,0,0,0,0,0,0,12,7,19,12,7,19,0,329,1,1,1,4.71318,0.286822,37.7907,90.0943,129,4,8.21609,-1.21609
West Indies,176,217.33,7.15909,0.3125,225.278,7.57386,0.380682,KOA Powell,0,0,0,0,0,0,0,0,16,3,19,16,3,19,330,290,0,0,1,3.59259,0.222222,26.4815,80.6088,27,4,7.58159,-4.58159
West Indies,176,217.33,7.15909,0.3125,225.278,7.57386,0.380682,DC Thomas,0,0,0,0,0,0,0,0,16,3,19,16,3,19,330,290,0,0,1,1.11111,0,12.4444,61.3699,18,1,8.22876,-5.22876
Australia,228,239.627,7.69737,0.372807,232.079,7.23246,0.337719,SR Watson,0,0,0,0,0,0,0,0,8,8,16,8,8,16,221,221,10,1,1,4.71318,0.286822,37.7907,90.0943,129,4,8.53244,-0.532445
India,259,242.378,7.15058,0.339768,244.568,7.12741,0.30888,S Dhawan,0,0,0,0,0,0,0,0,4,8,12,4,8,12,0,331,3,0,1,5.65217,0.362319,43.2174,88.9088,69,4,8.07854,-0.0785389
South Africa,190,234.274,7.4,0.373684,232.363,7.33158,0.342105,CA Ingram,0,0,0,0,0,0,0,0,28,14,42,28,14,42,332,305,0,0,1,3,0.178571,27.1786,81.3904,28,4,12.0655,1.93446
South Africa,190,234.274,7.4,0.373684,232.363,7.33158,0.342105,RJ Peterson,0,0,0,0,0,0,0,0,28,14,42,28,14,42,332,305,0,0,1,1.62069,0.0344828,15.7931,83.5766,29,1,12.0655,1.93446
Pakistan,211,222.621,7.38389,0.393365,235.517,7.54976,0.336493,Mohammad Hafeez,0,0,0,0,0,0,0,0,8,4,12,8,4,12,0,170,2,0,1,4.04511,0.255639,34.3534,78.0625,133,4,7.14441,-3.14441
West Indies,176,217.33,7.15909,0.3125,225.278,7.57386,0.380682,DM Bravo,0,0,0,0,0,0,0,0,12,5,17,12,5,17,171,172,0,0,1,3,0.226667,28.52,67.4551,75,4,6.03871,-1.03871
Australia,228,239.627,7.69737,0.372807,232.079,7.23246,0.337719,DA Warner,0,0,0,0,0,0,0,0,4,12,16,4,12,16,270,221,1,0,1,4.20312,0.265625,35.2031,87.7336,64,4,7.80727,4.19273
India,259,242.378,7.15058,0.339768,244.568,7.12741,0.30888,S Dhawan,0,0,0,0,0,0,0,0,16,15,31,16,15,31,234,236,1,0,1,5.65217,0.362319,43.2174,88.9088,69,4,8.20537,6.79463
West Indies,176,217.33,7.15909,0.3125,225.278,7.57386,0.380682,CH Gayle,0,0,0,0,0,0,0,0,12,11,23,12,11,23,231,190,0,0,1,4.58621,0.206897,31.1293,89.4255,116,4,5.86996,5.13004
Pakistan,211,222.621,7.38389,0.393365,235.517,7.54976,0.336493,Nasir Jamshed,0,0,0,0,0,0,0,0,0,6,6,0,6,6,0,165,1,0,1,3.63043,0.23913,30.2174,73.8184,46,4,7.14441,-1.14441
New Zealand,184,233.745,7.39674,0.36413,227.951,7.30435,0.353261,L Ronchi,0,0,0,0,0,0,0,0,4,10,14,4,10,14,170,159,3,0,1,2.92157,0.0784314,22.1961,115.392,51,0,8.30959,1.69041
Sri Lanka,244,223.373,7.09016,0.344262,227.578,7.47541,0.385246,WU Tharanga,0,0,0,0,0,0,0,0,20,6,26,20,6,26,189,200,4,1,1,3.93985,0.263158,32.9699,71.6035,133,4,8.14876,-2.14876
Bangladesh,160,218.438,7.70625,0.4,211.106,7.05,0.325,Tamim Iqbal,0,0,0,0,0,0,0,0,14,4,18,14,4,18,200,201,3,1,1,4.05344,0.274809,31.8015,76.8068,131,4,7.75938,-3.75938
West Indies,176,217.33,7.15909,0.3125,225.278,7.57386,0.380682,CH Gayle,0,0,0,0,0,0,0,0,10,4,14,10,4,14,293,132,2,0,1,4.58621,0.206897,31.1293,89.4255,116,4,6.8923,-2.8923
West Indies,176,217.33,7.15909,0.3125,225.278,7.57386,0.380682,KOA Powell,0,0,0,0,0,0,0,0,14,4,18,14,4,18,228,228,0,0,1,3.59259,0.222222,26.4815,80.6088,27,4,5.48139,-1.48139
West Indies,176,217.33,7.15909,0.3125,225.278,7.57386,0.380682,MN Samuels,0,0,0,0,0,0,0,0,14,4,18,14,4,18,228,228,0,0,1,3.74757,0.23301,31.6214,74.5821,103,4,5.48139,-1.48139
Bangladesh,160,218.438,7.70625,0.4,211.106,7.05,0.325,Anamul Haque,0,0,0,0,0,0,0,0,0,7,7,0,7,7,212,136,5,1,1,4.12,0.24,36.8,69.6442,25,4,7.75938,-0.759379
Bangladesh,160,218.438,7.70625,0.4,211.106,7.05,0.325,Mushfiqur Rahim,0,0,0,0,0,0,0,0,0,7,7,0,7,7,212,136,5,1,1,2.61111,0.18254,27.7778,75.2526,126,4,7.75938,-0.759379
Bangladesh,160,218.438,7.70625,0.4,211.106,7.05,0.325,Mominul Haque,0,0,0,0,0,0,0,0,0,7,7,0,7,7,212,136,5,1,1,2.57143,0.0952381,23.3333,73.4633,21,4,7.75938,-0.759379
Bangladesh,160,218.438,7.70625,0.4,211.106,7.05,0.325,Tamim Iqbal,0,0,0,0,0,0,0,0,20,2,22,20,2,22,218,221,0,1,1,4.05344,0.274809,31.8015,76.8068,131,4,7.75938,-5.75938
Bangladesh,160,218.438,7.70625,0.4,211.106,7.05,0.325,Anamul Haque,0,0,0,0,0,0,0,0,20,2,22,20,2,22,218,221,0,1,1,4.12,0.24,36.8,69.6442,25,4,7.75938,-5.75938
Bangladesh,160,218.438,7.70625,0.4,211.106,7.05,0.325,Jahurul Islam,0,0,0,0,0,0,0,0,20,2,22,20,2,22,218,221,0,1,1,2.18182,0.0909091,20.5455,69.5385,11,1,7.82583,-5.82583
Pakistan,211,222.621,7.38389,0.393365,235.517,7.54976,0.336493,Mohammad Hafeez,0,0,0,0,0,0,0,0,0,4,4,0,4,4,228,228,4,0,1,4.04511,0.255639,34.3534,78.0625,133,4,5.88292,-1.88292
India,259,242.378,7.15058,0.339768,244.568,7.12741,0.30888,G Gambhir,0,0,0,0,0,0,0,0,12,9,21,12,9,21,251,165,6,1,1,3.99145,0.333333,37.4701,84.1944,117,4,7.82655,1.17345
Pakistan,211,222.621,7.38389,0.393365,235.517,7.54976,0.336493,Kamran Akmal,0,0,0,0,0,0,0,0,4,4,8,4,4,8,168,157,1,0,1,3.01124,0.11236,23.0787,81.4433,89,4,7.1199,-3.1199
West Indies,176,217.33,7.15909,0.3125,225.278,7.57386,0.380682,J Charles,0,0,0,0,0,0,0,0,8,12,20,8,12,20,0,337,1,1,1,3.82353,0.147059,28.2353,81.2183,34,4,6.48576,5.51424
Zimbabwe,142,212.077,7.5,0.380282,227.704,6.97887,0.316901,V Sibanda,0,0,0,0,0,0,0,0,14,4,18,14,4,18,338,181,4,0,1,2.9697,0.181818,23.5152,63.5545,66,1,5.42297,-1.42297
West Indies,176,217.33,7.15909,0.3125,225.278,7.57386,0.380682,J Charles,0,0,0,0,0,0,0,0,8,4,12,8,4,12,209,209,4,1,1,3.82353,0.147059,28.2353,81.2183,34,4,5.96997,-1.96997
Sri Lanka,244,223.373,7.09016,0.344262,227.578,7.47541,0.385246,WU Tharanga,0,0,0,0,0,0,0,0,8,4,12,8,4,12,120,96,6,0,1,3.93985,0.263158,32.9699,71.6035,133,4,7.99591,-3.99591
Sri Lanka,244,223.373,7.09016,0.344262,227.578,7.47541,0.385246,DPMD Jayawardene,0,0,0,0,0,0,0,0,8,4,12,8,4,12,120,96,6,0,1,3.20833,0.244792,31.6979,79.1109,192,4,7.99591,-3.99591
India,259,242.378,7.15058,0.339768,244.568,7.12741,0.30888,RG Sharma,0,0,0,0,0,0,0,0,4,10,14,4,10,14,202,203,2,0,1,3.82836,0.268657,35.9179,83.083,134,4,8.76105,1.23895
Pakistan,211,222.621,7.38389,0.393365,235.517,7.54976,0.336493,Imran Farhat,0,0,0,0,0,0,0,0,0,6,6,0,6,6,0,266,2,0,1,3.03333,0.266667,27.0333,62.9658,30,4,7.14441,-1.14441
Pakistan,211,222.621,7.38389,0.393365,235.517,7.54976,0.336493,Nasir Jamshed,0,0,0,0,0,0,0,0,0,5,5,0,5,5,230,230,3,0,1,3.63043,0.23913,30.2174,73.8184,46,4,5.88292,-0.882916
Sri Lanka,244,223.373,7.09016,0.344262,227.578,7.47541,0.385246,TM Dilshan,0,0,0,0,0,0,0,0,26,10,36,26,10,36,0,302,0,1,1,4.60199,0.273632,38.3632,86.0219,201,4,7.59431,2.40569
Bangladesh,160,218.438,7.70625,0.4,211.106,7.05,0.325,Anamul Haque,0,0,0,0,0,0,0,0,20,7,27,20,7,27,303,184,11,0,1,4.12,0.24,36.8,69.6442,25,4,7.59589,-0.595889
Zimbabwe,142,212.077,7.5,0.380282,227.704,6.97887,0.316901,H Masakadza,0,0,0,0,0,0,0,0,12,6,18,12,6,18,270,148,5,1,1,3.11215,0.186916,26.972,70.0485,107,4,6.91232,-0.912315
Bangladesh,160,218.438,7.70625,0.4,211.106,7.05,0.325,Mominul Haque,0,0,0,0,0,0,0,0,4,9,13,4,9,13,0,252,1,0,1,2.57143,0.0952381,23.3333,73.4633,21,4,7.85483,1.14517
Bangladesh,160,218.438,7.70625,0.4,211.106,7.05,0.325,Mohammad Ashraful,0,0,0,0,0,0,0,0,10,9,19,10,9,19,0,247,1,0,1,2.17722,0.113924,19.4557,63.9085,79,1,8.28946,0.710541
Bangladesh,160,218.438,7.70625,0.4,211.106,7.05,0.325,Jahurul Islam,0,0,0,0,0,0,0,0,10,9,19,10,9,19,0,247,1,0,1,2.18182,0.0909091,20.5455,69.5385,11,1,8.28946,0.710541
Sri Lanka,244,223.373,7.09016,0.344262,227.578,7.47541,0.385246,TM Dilshan,0,0,0,0,0,0,0,0,12,7,19,12,7,19,0,320,8,1,1,4.60199,0.273632,38.3632,86.0219,201,4,7.59431,-0.594315
Sri Lanka,244,223.373,7.09016,0.344262,227.578,7.47541,0.385246,WU Tharanga,0,0,0,0,0,0,0,0,4,7,11,4,7,11,0,223,3,1,1,3.93985,0.263158,32.9699,71.6035,133,4,7.59431,-0.594315
South Africa,190,234.274,7.4,0.373684,232.363,7.33158,0.342105,RJ Peterson,0,0,0,0,0,0,0,0,12,16,28,12,16,28,224,104,2,0,1,1.62069,0.0344828,15.7931,83.5766,29,1,9.26171,6.73829
South Africa,190,234.274,7.4,0.373684,232.363,7.33158,0.342105,JP Duminy,0,0,0,0,0,0,0,0,12,16,28,12,16,28,224,104,2,0,1,2.3252,0.186992,29.9675,80.2351,123,4,9.26171,6.73829
Sri Lanka,244,223.373,7.09016,0.344262,227.578,7.47541,0.385246,KC Sangakkara,0,0,0,0,0,0,0,0,8,3,11,8,3,11,224,167,4,1,1,4.33659,0.360976,41.9854,80.6276,205,4,7.61184,-4.61184
South Africa,190,234.274,7.4,0.373684,232.363,7.33158,0.342105,JP Duminy,0,0,0,0,0,0,0,0,24,6,30,24,6,30,0,238,0,0,1,2.3252,0.186992,29.9675,80.2351,123,4,7.85679,-1.85679
Sri Lanka,244,223.373,7.09016,0.344262,227.578,7.47541,0.385246,TM Dilshan,0,0,0,0,0,0,0,0,8,3,11,8,3,11,0,307,3,1,1,4.60199,0.273632,38.3632,86.0219,201,4,7.59431,-4.59431
South Africa,190,234.274,7.4,0.373684,232.363,7.33158,0.342105,Q de Kock,0,0,0,0,0,0,0,0,24,8,32,24,8,32,308,179,0,0,1,5.12963,0.240741,39.1111,91.2311,54,4,9.0487,-1.0487
Australia,228,239.627,7.69737,0.372807,232.079,7.23246,0.337719,AJ Finch,0,0,0,0,0,0,0,0,16,8,24,16,8,24,270,270,4,1,1,4.52941,0.313725,37.2549,83.4431,51,4,8.18996,-0.189962
Australia,228,239.627,7.69737,0.372807,232.079,7.23246,0.337719,AJ Finch,0,0,0,0,0,0,0,0,16,14,30,16,14,30,301,301,1,1,1,4.52941,0.313725,37.2549,83.4431,51,4,8.6203,5.3797
Australia,228,239.627,7.69737,0.372807,232.079,7.23246,0.337719,AJ Finch,0,0,0,0,0,0,0,0,12,15,27,12,15,27,244,244,3,1,1,4.52941,0.313725,37.2549,83.4431,51,4,8.52617,6.47383
Australia,228,239.627,7.69737,0.372807,232.079,7.23246,0.337719,SE Marsh,0,0,0,0,0,0,0,0,4,7,11,4,7,11,0,217,3,1,1,3.66667,0.291667,35.5417,74.7918,48,4,8.21609,-1.21609
West Indies,176,217.33,7.15909,0.3125,225.278,7.57386,0.380682,KOA Powell,0,0,0,0,0,0,0,0,10,9,19,10,9,19,0,269,0,1,1,3.59259,0.222222,26.4815,80.6088,27,4,6.48576,2.51424
England,221,237.176,7.17647,0.289593,230.633,7.45701,0.384615,MJ Lumb,0,0,0,0,0,0,0,0,12,11,23,12,11,23,270,254,2,0,1,5,0.333333,55,80.0971,3,4,7.87362,3.12638
England,221,237.176,7.17647,0.289593,230.633,7.45701,0.384615,MM Ali,0,0,0,0,0,0,0,0,12,11,23,12,11,23,270,254,2,0,1,2.67647,0.117647,21.3824,94.5384,34,0,7.84771,3.15229
England,221,237.176,7.17647,0.289593,230.633,7.45701,0.384615,MJ Lumb,0,0,0,0,0,0,0,0,8,11,19,8,11,19,160,163,4,0,1,5,0.333333,55,80.0971,3,4,8.47456,2.52544
England,221,237.176,7.17647,0.289593,230.633,7.45701,0.384615,MM Ali,0,0,0,0,0,0,0,0,8,11,19,8,11,19,160,163,4,0,1,2.67647,0.117647,21.3824,94.5384,34,0,8.67038,2.32962
West Indies,176,217.33,7.15909,0.3125,225.278,7.57386,0.380682,KOA Powell,0,0,0,0,0,0,0,0,24,8,32,24,8,32,304,278,0,1,1,3.59259,0.222222,26.4815,80.6088,27,4,7.03164,0.968358
West Indies,176,217.33,7.15909,0.3125,225.278,7.57386,0.380682,LMP Simmons,0,0,0,0,0,0,0,0,24,8,32,24,8,32,304,278,0,1,1,3.3125,0.28125,30.5938,71.4338,64,4,7.03164,0.968358
West Indies,176,217.33,7.15909,0.3125,225.278,7.57386,0.380682,DM Bravo,0,0,0,0,0,0,0,0,24,8,32,24,8,32,304,278,0,1,1,3,0.226667,28.52,67.4551,75,4,7.03164,0.968358
India,259,242.378,7.15058,0.339768,244.568,7.12741,0.30888,V Kohli,0,0,0,0,0,0,0,0,16,6,22,16,6,22,0,294,7,0,1,4.66456,0.379747,44.9937,88.3325,158,4,8.07854,-2.07854
Zimbabwe,142,212.077,7.5,0.380282,227.704,6.97887,0.316901,Sikandar Raza,0,0,0,0,0,0,0,0,12,5,17,12,5,17,0,183,5,1,1,3,0.131579,26.1842,81.1582,38,4,6.31573,-1.31573
Zimbabwe,142,212.077,7.5,0.380282,227.704,6.97887,0.316901,V Sibanda,0,0,0,0,0,0,0,0,4,5,9,4,5,9,0,144,3,1,1,2.9697,0.181818,23.5152,63.5545,66,1,6.12263,-1.12263
India,259,242.378,7.15058,0.339768,244.568,7.12741,0.30888,RG Sharma,0,0,0,0,0,0,0,0,8,4,12,8,4,12,145,145,0,0,1,3.82836,0.268657,35.9179,83.083,134,4,8.31538,-4.31538
Zimbabwe,142,212.077,7.5,0.380282,227.704,6.97887,0.316901,V Sibanda,0,0,0,0,0,0,0,0,12,6,18,12,6,18,0,163,1,1,1,2.9697,0.181818,23.5152,63.5545,66,1,6.12263,-0.122631
Zimbabwe,142,212.077,7.5,0.380282,227.704,6.97887,0.316901,H Masakadza,0,0,0,0,0,0,0,0,12,6,18,12,6,18,0,163,1,1,1,3.11215,0.186916,26.972,70.0485,107,4,6.31573,-0.315727
Pakistan,211,222.621,7.38389,0.393365,235.517,7.54976,0.336493,Mohammad Hafeez,0,0,0,0,0,0,0,0,8,2,10,8,2,10,0,224,7,0,1,4.04511,0.255639,34.3534,78.0625,133,4,7.14441,-5.14441
West Indies,176,217.33,7.15909,0.3125,225.278,7.57386,0.380682,CH Gayle,0,0,0,0,0,0,0,0,4,2,6,4,2,6,225,98,1,1,1,4.58621,0.206897,31.1293,89.4255,116,4,5.82422,-3.82422
West Indies,176,217.33,7.15909,0.3125,225.278,7.57386,0.380682,DM Bravo,0,0,0,0,0,0,0,0,8,10,18,8,10,18,0,232,1,1,1,3,0.226667,28.52,67.4551,75,4,6.48576,3.51424
Pakistan,211,222.621,7.38389,0.393365,235.517,7.54976,0.336493,Ahmed Shehzad,0,0,0,0,0,0,0,0,0,0,0,0,0,0,233,195,5,0,1,3.67143,0.242857,33.2714,70.8118,70,4,6.66557,-6.66557
Pakistan,211,222.621,7.38389,0.393365,235.517,7.54976,0.336493,Nasir Jamshed,0,0,0,0,0,0,0,0,8,6,14,8,6,14,0,229,1,0,1,3.63043,0.23913,30.2174,73.8184,46,4,7.14441,-1.14441
West Indies,176,217.33,7.15909,0.3125,225.278,7.57386,0.380682,DM Bravo,0,0,0,0,0,0,0,0,8,9,17,8,9,17,230,229,2,1,1,3,0.226667,28.52,67.4551,75,4,6.21279,2.78721
West Indies,176,217.33,7.15909,0.3125,225.278,7.57386,0.380682,J Charles,0,0,0,0,0,0,0,0,12,4,16,12,4,16,0,261,0,1,1,3.82353,0.147059,28.2353,81.2183,34,4,6.48576,-2.48576
Pakistan,211,222.621,7.38389,0.393365,235.517,7.54976,0.336493,Ahmed Shehzad,0,0,0,0,0,0,0,0,8,14,22,8,14,22,262,189,1,0,1,3.67143,0.242857,33.2714,70.8118,70,4,8.09637,5.90363
Australia,228,239.627,7.69737,0.372807,232.079,7.23246,0.337719,PJ Hughes,0,0,0,0,0,0,0,0,4,7,11,4,7,11,0,304,2,0,1,4.52381,0.285714,38.7619,74.7475,21,4,7.87937,-0.879366
India,259,242.378,7.15058,0.339768,244.568,7.12741,0.30888,RG Sharma,0,0,0,0,0,0,0,0,4,9,13,4,9,13,305,232,2,1,1,3.82836,0.268657,35.9179,83.083,134,4,7.83557,1.16443
Australia,228,239.627,7.69737,0.372807,232.079,7.23246,0.337719,AJ Finch,0,0,0,0,0,0,0,0,16,5,21,16,5,21,0,359,2,0,1,4.52941,0.313725,37.2549,83.4431,51,4,7.87937,-2.87937
India,259,242.378,7.15058,0.339768,244.568,7.12741,0.30888,S Dhawan,0,0,0,0,0,0,0,0,16,8,24,16,8,24,360,362,6,1,1,5.65217,0.362319,43.2174,88.9088,69,4,9.94161,-1.94161
India,259,242.378,7.15058,0.339768,244.568,7.12741,0.30888,V Kohli,0,0,0,0,0,0,0,0,20,2,22,20,2,22,0,303,7,1,1,4.66456,0.379747,44.9937,88.3325,158,4,6.85241,-4.85241
Australia,228,239.627,7.69737,0.372807,232.079,7.23246,0.337719,PJ Hughes,0,0,0,0,0,0,0,0,8,4,12,8,4,12,0,350,0,0,1,4.52381,0.285714,38.7619,74.7475,21,4,7.87937,-3.87937
India,259,242.378,7.15058,0.339768,244.568,7.12741,0.30888,RG Sharma,0,0,0,0,0,0,0,0,12,9,21,12,9,21,351,351,5,1,1,3.82836,0.268657,35.9179,83.083,134,4,11.8666,-2.86658
India,259,242.378,7.15058,0.339768,244.568,7.12741,0.30888,S Dhawan,0,0,0,0,0,0,0,0,12,9,21,12,9,21,351,351,5,1,1,5.65217,0.362319,43.2174,88.9088,69,4,11.8666,-2.86658
India,259,242.378,7.15058,0.339768,244.568,7.12741,0.30888,S Dhawan,0,0,0,0,0,0,0,0,20,8,28,20,8,28,0,383,5,1,1,5.65217,0.362319,43.2174,88.9088,69,4,6.85241,1.14759
Australia,228,239.627,7.69737,0.372807,232.079,7.23246,0.337719,AJ Finch,0,0,0,0,0,0,0,0,8,8,16,8,8,16,384,326,0,0,1,4.52941,0.313725,37.2549,83.4431,51,4,8.36236,-0.362358
Australia,228,239.627,7.69737,0.372807,232.079,7.23246,0.337719,PJ Hughes,0,0,0,0,0,0,0,0,8,8,16,8,8,16,384,326,0,0,1,4.52381,0.285714,38.7619,74.7475,21,4,8.36236,-0.362358
Pakistan,211,222.621,7.38389,0.393365,235.517,7.54976,0.336493,Nasir Jamshed,0,0,0,0,0,0,0,0,0,3,3,0,3,3,184,182,1,0,1,3.63043,0.23913,30.2174,73.8184,46,4,7.39851,-4.39851
South Africa,190,234.274,7.4,0.373684,232.363,7.33158,0.342105,GC Smith,0,0,0,0,0,0,0,0,16,9,25,16,9,25,210,143,2,0,1,3.97,0.29,33.57,79.6819,100,4,9.26171,-0.261711
Pakistan,211,222.621,7.38389,0.393365,235.517,7.54976,0.336493,Mohammad Hafeez,0,0,0,0,0,0,0,0,32,3,35,32,3,35,260,191,2,0,1,4.04511,0.255639,34.3534,78.0625,133,4,8.09637,-5.09637
Pakistan,211,222.621,7.38389,0.393365,235.517,7.54976,0.336493,Mohammad Hafeez,0,0,0,0,0,0,0,0,0,7,7,0,7,7,267,238,1,0,1,4.04511,0.255639,34.3534,78.0625,133,4,7.68114,-0.681141
South Africa,190,234.274,7.4,0.373684,232.363,7.33158,0.342105,Q de Kock,0,0,0,0,0,0,0,0,16,9,25,16,9,25,0,268,3,0,1,5.12963,0.240741,39.1111,91.2311,54,4,7.85679,1.14321
England,221,237.176,7.17647,0.289593,230.633,7.45701,0.384615,IR Bell,0,0,0,0,0,0,0,0,20,6,26,20,6,26,343,231,3,0,1,3.63433,0.246269,35.3806,75.6623,134,4,7.41337,-1.41337
England,221,237.176,7.17647,0.289593,230.633,7.45701,0.384615,GS Ballance,0,0,0,0,0,0,0,0,20,6,26,20,6,26,343,231,3,0,1,1.69231,0.153846,22,66.3573,13,1,7.41337,-1.41337
India,259,242.378,7.15058,0.339768,244.568,7.12741,0.30888,S Dhawan,0,0,0,0,0,0,0,0,12,8,20,12,8,20,0,300,1,0,1,5.65217,0.362319,43.2174,88.9088,69,4,8.07854,-0.0785389
West Indies,176,217.33,7.15909,0.3125,225.278,7.57386,0.380682,DR Smith,0,0,0,0,0,0,0,0,8,8,16,8,8,16,0,310,1,0,1,2.5,0.12,17.96,84.5574,50,1,6.19764,1.80236
Pakistan,211,222.621,7.38389,0.393365,235.517,7.54976,0.336493,Sohaib Maqsood,0,0,0,0,0,0,0,0,0,2,2,0,2,2,311,160,1,0,1,2.86957,0.217391,29.4348,79.7409,23,4,6.47332,-4.47332
Pakistan,211,222.621,7.38389,0.393365,235.517,7.54976,0.336493,Misbah-ul-Haq,0,0,0,0,0,0,0,0,0,2,2,0,2,2,311,160,1,0,1,2.95238,0.285714,34.9921,71.8195,126,4,6.47332,-4.47332
South Africa,190,234.274,7.4,0.373684,232.363,7.33158,0.342105,F du Plessis,0,0,0,0,0,0,0,0,4,10,14,4,10,14,308,177,3,0,1,3.45122,0.292683,34.9268,83.135,82,4,9.0487,0.951303
Zimbabwe,142,212.077,7.5,0.380282,227.704,6.97887,0.316901,RW Chakabva,0,0,0,0,0,0,0,0,12,12,24,12,12,24,373,289,2,0,1,0.846154,0,13.2692,51.3393,26,3,8.81683,3.18317
West Indies,176,217.33,7.15909,0.3125,225.278,7.57386,0.380682,DR Smith,0,0,0,0,0,0,0,0,6,7,13,6,7,13,409,151,7,0,1,2.5,0.12,17.96,84.5574,50,1,7.31204,-0.312037
West Indies,176,217.33,7.15909,0.3125,225.278,7.57386,0.380682,JL Carter,0,0,0,0,0,0,0,0,6,7,13,6,7,13,409,151,7,0,1,1.63636,0,14.7273,55.8621,11,3,6.95397,0.0460272
Australia,228,239.627,7.69737,0.372807,232.079,7.23246,0.337719,AJ Finch,0,0,0,0,0,0,0,0,28,13,41,28,13,41,0,151,7,0,1,4.52941,0.313725,37.2549,83.4431,51,4,7.87937,5.12063
Australia,228,239.627,7.69737,0.372807,232.079,7.23246,0.337719,SR Watson,0,0,0,0,0,0,0,0,28,13,41,28,13,41,0,151,7,0,1,4.71318,0.286822,37.7907,90.0943,129,4,7.87937,5.12063
New Zealand,184,233.745,7.39674,0.36413,227.951,7.30435,0.353261,BB McCullum,0,0,0,0,0,0,0,0,42,5,47,42,5,47,152,152,3,1,1,3.98611,0.201389,29.9028,98.4004,144,0,8.16502,-3.16502
England,221,237.176,7.17647,0.289593,230.633,7.45701,0.384615,IR Bell,0,0,0,0,0,0,0,0,32,4,36,32,4,36,0,309,6,0,1,3.63433,0.246269,35.3806,75.6623,134,4,7.7801,-3.7801
Zimbabwe,142,212.077,7.5,0.380282,227.704,6.97887,0.316901,Sikandar Raza,0,0,0,0,0,0,0,0,8,6,14,8,6,14,236,215,1,0,1,3,0.131579,26.1842,81.1582,38,4,6.27418,-0.27418
Ireland,55,219.527,7.65455,0.290909,202.727,7.56364,0.4,A Balbirnie,0,0,0,0,0,0,0,0,20,5,25,20,5,25,412,210,0,0,1,3,0.222222,28.7778,81.1912,9,4,5.52595,-0.525946
Ireland,55,219.527,7.65455,0.290909,202.727,7.56364,0.4,PR Stirling,0,0,0,0,0,0,0,0,8,12,20,8,12,20,0,331,1,0,1,3.47826,0.173913,24.2174,88.1329,23,0,5.25076,6.74924
Ireland,55,219.527,7.65455,0.290909,202.727,7.56364,0.4,EC Joyce,0,0,0,0,0,0,0,0,8,12,20,8,12,20,0,331,1,0,1,3.08571,0.2,28.3429,68.6505,35,4,4.12741,7.87259
Australia,228,239.627,7.69737,0.372807,232.079,7.23246,0.337719,SPD Smith,0,0,0,0,0,0,0,0,12,11,23,12,11,23,0,376,1,1,1,3.19298,0.22807,34.5614,87.0526,57,4,8.21609,2.78391
Bangladesh,160,218.438,7.70625,0.4,211.106,7.05,0.325,Tamim Iqbal,0,0,0,0,0,0,0,0,4,8,12,4,8,12,0,275,0,0,1,4.05344,0.274809,31.8015,76.8068,131,4,7.85483,0.145175
Bangladesh,160,218.438,7.70625,0.4,211.106,7.05,0.325,Imrul Kayes,0,0,0,0,0,0,0,0,0,4,4,0,4,4,0,288,0,0,1,3,0.207547,26.2642,63.6488,53,4,7.85483,-3.85483
New Zealand,184,233.745,7.39674,0.36413,227.951,7.30435,0.353261,BB McCullum,0,0,0,0,0,0,0,0,24,9,33,24,9,33,289,290,0,1,1,3.98611,0.201389,29.9028,98.4004,144,0,5.99457,3.00543
Ireland,55,219.527,7.65455,0.290909,202.727,7.56364,0.4,WTS Porterfield,0,0,0,0,0,0,0,0,8,7,15,8,7,15,0,237,1,0,1,2.6,0.142857,24.6857,56.2866,35,3,5.4886,1.5114
Pakistan,211,222.621,7.38389,0.393365,235.517,7.54976,0.336493,Sarfraz Ahmed,0,0,0,0,0,0,0,0,4,10,14,4,10,14,238,241,3,0,1,2.04878,0.097561,25.4878,83.9357,41,4,6.66557,3.33443
Sri Lanka,244,223.373,7.09016,0.344262,227.578,7.47541,0.385246,MDKJ Perera,0,0,0,0,0,0,0,0,0,4,4,0,4,4,0,133,2,0,1,3.30435,0.195652,25.7391,90.5199,46,0,7.37712,-3.37712
Bangladesh,160,218.438,7.70625,0.4,211.106,7.05,0.325,Imrul Kayes,0,0,0,0,0,0,0,0,12,8,20,12,8,20,303,193,3,0,1,3,0.207547,26.2642,63.6488,53,4,7.59589,0.404111
Pakistan,211,222.621,7.38389,0.393365,235.517,7.54976,0.336493,Ahmed Shehzad,0,0,0,0,0,0,0,0,8,11,19,8,11,19,0,213,5,0,1,3.67143,0.242857,33.2714,70.8118,70,4,7.14441,3.85559
Australia,228,239.627,7.69737,0.372807,232.079,7.23246,0.337719,DA Warner,0,0,0,0,0,0,0,0,18,11,29,18,11,29,0,328,2,1,1,4.20312,0.265625,35.2031,87.7336,64,4,8.21609,2.78391
New Zealand,184,233.745,7.39674,0.36413,227.951,7.30435,0.353261,MJ Guptill,0,0,0,0,0,0,0,0,10,4,14,10,4,14,0,183,4,0,1,4.8087,0.313043,38.1217,82.7482,115,4,6.85021,-2.85021
Australia,228,239.627,7.69737,0.372807,232.079,7.23246,0.337719,AJ Finch,0,0,0,0,0,0,0,0,16,13,29,16,13,29,184,186,4,1,1,4.52941,0.313725,37.2549,83.4431,51,4,9.89563,3.10437
Pakistan,211,222.621,7.38389,0.393365,235.517,7.54976,0.336493,Sharjeel Khan,0,0,0,0,0,0,0,0,22,8,30,22,8,30,0,322,2,0,1,2.6,0.1,16.9,81.25,10,1,7.57972,0.420281
Pakistan,211,222.621,7.38389,0.393365,235.517,7.54976,0.336493,Ahmed Shehzad,0,0,0,0,0,0,0,0,22,8,30,22,8,30,0,322,2,0,1,3.67143,0.242857,33.2714,70.8118,70,4,7.14441,0.85559
Sri Lanka,244,223.373,7.09016,0.344262,227.578,7.47541,0.385246,MDKJ Perera,0,0,0,0,0,0,0,0,8,10,18,8,10,18,285,287,0,0,1,3.30435,0.195652,25.7391,90.5199,46,0,8.69587,1.30413
Pakistan,211,222.621,7.38389,0.393365,235.517,7.54976,0.336493,Ahmed Shehzad,0,0,0,0,0,0,0,0,4,11,15,4,11,15,0,326,0,0,1,3.67143,0.242857,33.2714,70.8118,70,4,7.14441,3.85559
Sri Lanka,244,223.373,7.09016,0.344262,227.578,7.47541,0.385246,FDM Karunaratne,0,0,0,0,0,0,0,0,16,10,26,16,10,26,327,213,0,0,1,0.8,0,10.7,64.8485,10,1,9.87599,0.124007
Pakistan,211,222.621,7.38389,0.393365,235.517,7.54976,0.336493,Ahmed Shehzad,0,0,0,0,0,0,0,0,20,10,30,20,10,30,226,226,1,0,1,3.67143,0.242857,33.2714,70.8118,70,4,7.84552,2.15448
Pakistan,211,222.621,7.38389,0.393365,235.517,7.54976,0.336493,Ahmed Shehzad,0,0,0,0,0,0,0,0,0,8,8,0,8,8,0,244,5,0,1,3.67143,0.242857,33.2714,70.8118,70,4,7.14441,0.85559
Pakistan,211,222.621,7.38389,0.393365,235.517,7.54976,0.336493,Nasir Jamshed,0,0,0,0,0,0,0,0,8,5,13,8,5,13,0,260,2,0,1,3.63043,0.23913,30.2174,73.8184,46,4,7.14441,-2.14441
Zimbabwe,142,212.077,7.5,0.380282,227.704,6.97887,0.316901,H Masakadza,0,0,0,0,0,0,0,0,4,6,10,4,6,10,261,152,8,1,1,3.11215,0.186916,26.972,70.0485,107,4,6.80242,-0.802419
New Zealand,184,233.745,7.39674,0.36413,227.951,7.30435,0.353261,MJ Guptill,0,0,0,0,0,0,0,0,0,5,5,0,5,5,0,156,0,1,1,4.8087,0.313043,38.1217,82.7482,115,4,6.8371,-1.8371
New Zealand,184,233.745,7.39674,0.36413,227.951,7.30435,0.353261,JD Ryder,0,0,0,0,0,0,0,0,50,7,57,50,7,57,0,283,0,1,1,4.88571,0.257143,34.4,97.2536,35,0,6.7086,0.2914
West Indies,176,217.33,7.15909,0.3125,225.278,7.57386,0.380682,LMP Simmons,0,0,0,0,0,0,0,0,10,9,19,10,9,19,284,124,1,0,1,3.3125,0.28125,30.5938,71.4338,64,4,6.7574,2.2426
West Indies,176,217.33,7.15909,0.3125,225.278,7.57386,0.380682,KOA Powell,0,0,0,0,0,0,0,0,34,3,37,34,3,37,0,363,0,0,1,3.59259,0.222222,26.4815,80.6088,27,4,5.82675,-2.82675
New Zealand,184,233.745,7.39674,0.36413,227.951,7.30435,0.353261,MJ Guptill,0,0,0,0,0,0,0,0,22,2,24,22,2,24,0,292,2,1,1,4.8087,0.313043,38.1217,82.7482,115,4,6.8371,-4.8371
India,259,242.378,7.15058,0.339768,244.568,7.12741,0.30888,RG Sharma,0,0,0,0,0,0,0,0,4,6,10,4,6,10,272,277,0,0,1,3.82836,0.268657,35.9179,83.083,134,4,8.06011,-2.06011
India,259,242.378,7.15058,0.339768,244.568,7.12741,0.30888,RG Sharma,0,0,0,0,0,0,0,0,14,11,25,14,11,25,315,314,0,0,1,3.82836,0.268657,35.9179,83.083,134,4,9.01971,1.98029
England,221,237.176,7.17647,0.289593,230.633,7.45701,0.384615,AD Hales,0,0,0,0,0,0,0,0,12,4,16,12,4,16,0,206,0,1,1,4.2963,0.296296,34.1111,85.1201,27,4,7.83019,-3.83019
England,221,237.176,7.17647,0.289593,230.633,7.45701,0.384615,MA Carberry,0,0,0,0,0,0,0,0,8,14,22,8,14,22,257,99,4,1,1,2.8,0.2,22.6,63.4831,5,1,7.57994,6.42006
Sri Lanka,244,223.373,7.09016,0.344262,227.578,7.47541,0.385246,HDRL Thirimanne,0,0,0,0,0,0,0,0,8,7,15,8,7,15,0,67,2,0,1,2.77778,0.246914,31.5802,71.4725,81,4,7.38489,-0.384891
Sri Lanka,244,223.373,7.09016,0.344262,227.578,7.47541,0.385246,TM Dilshan,0,0,0,0,0,0,0,0,16,10,26,16,10,26,220,222,9,0,1,4.60199,0.273632,38.3632,86.0219,201,4,7.75641,2.24359
Bangladesh,160,218.438,7.70625,0.4,211.106,7.05,0.325,Anamul Haque,0,0,0,0,0,0,0,0,12,7,19,12,7,19,0,265,3,1,1,4.12,0.24,36.8,69.6442,25,4,6.38578,0.614223
Bangladesh,160,218.438,7.70625,0.4,211.106,7.05,0.325,Mushfiqur Rahim,0,0,0,0,0,0,0,0,12,7,19,12,7,19,0,265,3,1,1,2.61111,0.18254,27.7778,75.2526,126,4,6.38578,0.614223
New Zealand,184,233.745,7.39674,0.36413,227.951,7.30435,0.353261,AP Devcich,0,0,0,0,0,0,0,0,12,4,16,12,4,16,266,162,0,0,1,3.125,0.125,22.125,73.444,8,1,7.6899,-3.6899
New Zealand,184,233.745,7.39674,0.36413,227.951,7.30435,0.353261,GD Elliott,0,0,0,0,0,0,0,0,12,4,16,12,4,16,266,162,0,0,1,2.67188,0.203125,29.4375,79.7629,64,4,7.6899,-3.6899
Bangladesh,160,218.438,7.70625,0.4,211.106,7.05,0.325,Tamim Iqbal,0,0,0,0,0,0,0,0,12,2,14,12,2,14,0,247,1,1,1,4.05344,0.274809,31.8015,76.8068,131,4,6.38578,-4.38578
Sri Lanka,244,223.373,7.09016,0.344262,227.578,7.47541,0.385246,KC Sangakkara,0,0,0,0,0,0,0,0,16,8,24,16,8,24,0,138,0,1,1,4.33659,0.360976,41.9854,80.6276,205,4,7.59431,0.405685
Sri Lanka,244,223.373,7.09016,0.344262,227.578,7.47541,0.385246,TM Dilshan,0,0,0,0,0,0,0,0,24,4,28,24,4,28,0,211,2,1,1,4.60199,0.273632,38.3632,86.0219,201,4,7.59431,-3.59431
South Africa,190,234.274,7.4,0.373684,232.363,7.33158,0.342105,HM Amla,0,0,0,0,0,0,0,0,12,8,20,12,8,20,219,195,1,1,1,5.20168,0.403361,48.7899,86.9292,119,4,8.60684,-0.606843
Pakistan,211,222.621,7.38389,0.393365,235.517,7.54976,0.336493,Mohammad Hafeez,0,0,0,0,0,0,0,0,4,12,16,4,12,16,0,262,2,0,1,4.04511,0.255639,34.3534,78.0625,133,4,7.14441,4.85559
South Africa,190,234.274,7.4,0.373684,232.363,7.33158,0.342105,Q de Kock,0,0,0,0,0,0,0,0,4,5,9,4,5,9,263,261,0,1,1,5.12963,0.240741,39.1111,91.2311,54,4,7.65828,-2.65828
South Africa,190,234.274,7.4,0.373684,232.363,7.33158,0.342105,HM Amla,0,0,0,0,0,0,0,0,24,10,34,24,10,34,180,181,0,1,1,5.20168,0.403361,48.7899,86.9292,119,4,8.0014,1.9986
Sri Lanka,244,223.373,7.09016,0.344262,227.578,7.47541,0.385246,KC Sangakkara,0,0,0,0,0,0,0,0,14,11,25,14,11,25,0,180,2,0,1,4.33659,0.360976,41.9854,80.6276,205,4,7.38489,3.61511
Sri Lanka,244,223.373,7.09016,0.344262,227.578,7.47541,0.385246,TM Dilshan,0,0,0,0,0,0,0,0,16,9,25,16,9,25,0,289,0,0,1,4.60199,0.273632,38.3632,86.0219,201,4,7.38489,1.61511
Bangladesh,160,218.438,7.70625,0.4,211.106,7.05,0.325,Shamsur Rahman,0,0,0,0,0,0,0,0,0,6,6,0,6,6,290,228,1,1,1,3.55556,0.222222,29.5556,74.5098,9,4,7.52252,-1.52252
Sri Lanka,244,223.373,7.09016,0.344262,227.578,7.47541,0.385246,HDRL Thirimanne,0,0,0,0,0,0,0,0,12,9,21,12,9,21,241,246,2,0,1,2.77778,0.246914,31.5802,71.4725,81,4,8.18109,0.818907
Ireland,55,219.527,7.65455,0.290909,202.727,7.56364,0.4,PR Stirling,0,0,0,0,0,0,0,0,8,3,11,8,3,11,220,140,0,1,1,3.47826,0.173913,24.2174,88.1329,23,0,7.49133,-4.49133
India,259,242.378,7.15058,0.339768,244.568,7.12741,0.30888,S Dhawan,0,0,0,0,0,0,0,0,8,3,11,8,3,11,280,280,0,0,1,5.65217,0.362319,43.2174,88.9088,69,4,8.41005,-5.41005
India,259,242.378,7.15058,0.339768,244.568,7.12741,0.30888,RG Sharma,0,0,0,0,0,0,0,0,22,6,28,22,6,28,0,245,2,0,1,3.82836,0.268657,35.9179,83.083,134,4,8.07854,-2.07854
Bangladesh,160,218.438,7.70625,0.4,211.106,7.05,0.325,Shamsur Rahman,0,0,0,0,0,0,0,0,8,8,16,8,8,16,0,204,0,1,1,3.55556,0.222222,29.5556,74.5098,9,4,6.38578,1.61422
Sri Lanka,244,223.373,7.09016,0.344262,227.578,7.47541,0.385246,MDKJ Perera,0,0,0,0,0,0,0,0,8,7,15,8,7,15,205,208,1,0,1,3.30435,0.195652,25.7391,90.5199,46,0,8.03197,-1.03197
Pakistan,211,222.621,7.38389,0.393365,235.517,7.54976,0.336493,Sharjeel Khan,0,0,0,0,0,0,0,0,12,5,17,12,5,17,0,260,1,0,1,2.6,0.1,16.9,81.25,10,1,7.57972,-2.57972
South Africa,190,234.274,7.4,0.373684,232.363,7.33158,0.342105,RR Rossouw,0,0,0,0,0,0,0,0,12,5,17,12,5,17,0,279,3,1,1,3.80769,0.230769,31.3846,93.1507,26,0,7.64395,-2.64395
West Indies,176,217.33,7.15909,0.3125,225.278,7.57386,0.380682,CH Gayle,0,0,0,0,0,0,0,0,28,14,42,28,14,42,280,164,1,0,1,4.58621,0.206897,31.1293,89.4255,116,4,6.7574,7.2426
West Indies,176,217.33,7.15909,0.3125,225.278,7.57386,0.380682,N Deonarine,0,0,0,0,0,0,0,0,12,2,14,12,2,14,0,122,4,0,1,2.09091,0.136364,20.9545,65.7632,22,1,6.19764,-4.19764
South Africa,190,234.274,7.4,0.373684,232.363,7.33158,0.342105,RR Rossouw,0,0,0,0,0,0,0,0,20,1,21,20,1,21,0,262,6,1,1,3.80769,0.230769,31.3846,93.1507,26,0,7.64395,-6.64395
South Africa,190,234.274,7.4,0.373684,232.363,7.33158,0.342105,F du Plessis,0,0,0,0,0,0,0,0,16,4,20,16,4,20,0,361,3,1,1,3.45122,0.292683,34.9268,83.135,82,4,7.38502,-3.38502
West Indies,176,217.33,7.15909,0.3125,225.278,7.57386,0.380682,CH Gayle,0,0,0,0,0,0,0,0,22,7,29,22,7,29,362,230,3,0,1,4.58621,0.206897,31.1293,89.4255,116,4,10.1615,-3.16147
Pakistan,211,222.621,7.38389,0.393365,235.517,7.54976,0.336493,Sarfraz Ahmed,0,0,0,0,0,0,0,0,4,13,17,4,13,17,232,230,1,0,1,2.04878,0.097561,25.4878,83.9357,41,4,6.66557,6.33443
Sri Lanka,244,223.373,7.09016,0.344262,227.578,7.47541,0.385246,MDKJ Perera,0,0,0,0,0,0,0,0,16,8,24,16,8,24,305,229,1,1,1,3.30435,0.195652,25.7391,90.5199,46,0,5.54852,2.45148
Sri Lanka,244,223.373,7.09016,0.344262,227.578,7.47541,0.385246,TM Dilshan,0,0,0,0,0,0,0,0,24,13,37,24,13,37,0,267,1,1,1,4.60199,0.273632,38.3632,86.0219,201,4,7.59431,5.40569
South Africa,190,234.274,7.4,0.373684,232.363,7.33158,0.342105,AB de Villiers,0,0,0,0,0,0,0,0,20,5,25,20,5,25,268,180,1,0,1,5.04969,0.403727,47.2174,98.8428,161,4,8.31314,-3.31314
Bangladesh,160,218.438,7.70625,0.4,211.106,7.05,0.325,Tamim Iqbal,0,0,0,0,0,0,0,0,0,15,15,0,15,15,0,217,1,0,1,4.05344,0.274809,31.8015,76.8068,131,4,7.85483,7.14517
West Indies,176,217.33,7.15909,0.3125,225.278,7.57386,0.380682,KA Edwards,0,0,0,0,0,0,0,0,0,8,8,0,8,8,218,219,0,1,1,1.875,0.0625,20.6875,64.902,16,1,6.63302,1.36698
West Indies,176,217.33,7.15909,0.3125,225.278,7.57386,0.380682,CH Gayle,0,0,0,0,0,0,0,0,10,2,12,10,2,12,0,247,1,1,1,4.58621,0.206897,31.1293,89.4255,116,4,6.48576,-4.48576
West Indies,176,217.33,7.15909,0.3125,225.278,7.57386,0.380682,DM Bravo,0,0,0,0,0,0,0,0,10,2,12,10,2,12,0,247,1,1,1,3,0.226667,28.52,67.4551,75,4,6.48576,-4.48576
Bangladesh,160,218.438,7.70625,0.4,211.106,7.05,0.325,Tamim Iqbal,0,0,0,0,0,0,0,0,6,5,11,6,5,11,248,70,1,0,1,4.05344,0.274809,31.8015,76.8068,131,4,7.77659,-2.77659
Bangladesh,160,218.438,7.70625,0.4,211.106,7.05,0.325,Imrul Kayes,0,0,0,0,0,0,0,0,6,5,11,6,5,11,248,70,1,0,1,3,0.207547,26.2642,63.6488,53,4,7.77659,-2.77659
Bangladesh,160,218.438,7.70625,0.4,211.106,7.05,0.325,Tamim Iqbal,0,0,0,0,0,0,0,0,8,7,15,8,7,15,339,247,0,0,1,4.05344,0.274809,31.8015,76.8068,131,4,5.69508,1.30492
Bangladesh,160,218.438,7.70625,0.4,211.106,7.05,0.325,Anamul Haque,0,0,0,0,0,0,0,0,8,7,15,8,7,15,339,247,0,0,1,4.12,0.24,36.8,69.6442,25,4,5.69508,1.30492
South Africa,190,234.274,7.4,0.373684,232.363,7.33158,0.342105,Q de Kock,0,0,0,0,0,0,0,0,12,7,19,12,7,19,0,309,0,0,1,5.12963,0.240741,39.1111,91.2311,54,4,7.85679,-0.856788
Zimbabwe,142,212.077,7.5,0.380282,227.704,6.97887,0.316901,R Mutumbami,0,0,0,0,0,0,0,0,4,8,12,4,8,12,258,196,2,1,1,1.93333,0.0666667,15.4667,69.8795,15,1,6.86887,1.13113
Australia,228,239.627,7.69737,0.372807,232.079,7.23246,0.337719,PJ Hughes,0,0,0,0,0,0,0,0,12,14,26,12,14,26,0,327,1,0,1,4.52381,0.285714,38.7619,74.7475,21,4,7.87937,6.12063
Zimbabwe,142,212.077,7.5,0.380282,227.704,6.97887,0.316901,Sikandar Raza,0,0,0,0,0,0,0,0,4,5,9,4,5,9,210,211,0,1,1,3,0.131579,26.1842,81.1582,38,4,7.25161,-2.25161
South Africa,190,234.274,7.4,0.373684,232.363,7.33158,0.342105,HM Amla,0,0,0,0,0,0,0,0,8,8,16,8,8,16,283,220,5,0,1,5.20168,0.403361,48.7899,86.9292,119,4,8.66309,-0.663087
South Africa,190,234.274,7.4,0.373684,232.363,7.33158,0.342105,F du Plessis,0,0,0,0,0,0,0,0,8,8,16,8,8,16,283,220,5,0,1,3.45122,0.292683,34.9268,83.135,82,4,8.66309,-0.663087
Zimbabwe,142,212.077,7.5,0.380282,227.704,6.97887,0.316901,V Sibanda,0,0,0,0,0,0,0,0,8,12,20,8,12,20,272,208,1,1,1,2.9697,0.181818,23.5152,63.5545,66,1,6.97877,5.02123
Australia,228,239.627,7.69737,0.372807,232.079,7.23246,0.337719,SPD Smith,0,0,0,0,0,0,0,0,16,11,27,16,11,27,0,217,3,0,1,3.19298,0.22807,34.5614,87.0526,57,4,7.87937,3.12063
New Zealand,184,233.745,7.39674,0.36413,227.951,7.30435,0.353261,DG Brownlie,0,0,0,0,0,0,0,0,12,6,18,12,6,18,253,255,4,0,1,3,0,22.5556,72.5,9,1,7.6899,-1.6899
New Zealand,184,233.745,7.39674,0.36413,227.951,7.30435,0.353261,MJ Guptill,0,0,0,0,0,0,0,0,8,10,18,8,10,18,0,299,1,0,1,4.8087,0.313043,38.1217,82.7482,115,4,6.85021,3.14979
Pakistan,211,222.621,7.38389,0.393365,235.517,7.54976,0.336493,Ahmed Shehzad,0,0,0,0,0,0,0,0,8,10,18,8,10,18,300,292,0,0,1,3.67143,0.242857,33.2714,70.8118,70,4,7.64365,2.35635
Pakistan,211,222.621,7.38389,0.393365,235.517,7.54976,0.336493,Younis Khan,0,0,0,0,0,0,0,0,8,10,18,8,10,18,300,292,0,0,1,2.64655,0.215517,28.5,73.2713,116,4,7.64365,2.35635
New Zealand,184,233.745,7.39674,0.36413,227.951,7.30435,0.353261,KS Williamson,0,0,0,0,0,0,0,0,20,9,29,20,9,29,0,275,1,0,1,4.31707,0.390244,43.0488,82.8833,82,4,6.85021,2.14979
England,221,237.176,7.17647,0.289593,230.633,7.45701,0.384615,JE Root,0,0,0,0,0,0,0,0,20,15,35,20,15,35,0,408,0,1,1,3.68852,0.327869,41.6721,83.3443,61,4,7.83019,7.16981
England,221,237.176,7.17647,0.289593,230.633,7.45701,0.384615,AD Hales,0,0,0,0,0,0,0,0,20,15,35,20,15,35,0,408,0,1,1,4.2963,0.296296,34.1111,85.1201,27,4,7.83019,7.16981
England,221,237.176,7.17647,0.289593,230.633,7.45701,0.384615,AD Hales,0,0,0,0,0,0,0,0,16,10,26,16,10,26,0,302,2,1,1,4.2963,0.296296,34.1111,85.1201,27,4,7.83019,2.16981
New Zealand,184,233.745,7.39674,0.36413,227.951,7.30435,0.353261,BB McCullum,0,0,0,0,0,0,0,0,8,16,24,8,16,24,0,349,1,0,1,3.98611,0.201389,29.9028,98.4004,144,0,7.17241,8.82759
England,221,237.176,7.17647,0.289593,230.633,7.45701,0.384615,JJ Roy,0,0,0,0,0,0,0,0,8,9,17,8,9,17,284,192,6,1,1,4.36842,0.210526,29.3684,95.3846,19,0,7.11047,1.88953
Ireland,55,219.527,7.65455,0.290909,202.727,7.56364,0.4,WTS Porterfield,0,0,0,0,0,0,0,0,12,10,22,12,10,22,223,157,2,1,1,2.6,0.142857,24.6857,56.2866,35,3,6.84783,3.15217
Ireland,55,219.527,7.65455,0.290909,202.727,7.56364,0.4,NJ O'Brien,0,0,0,0,0,0,0,0,12,10,22,12,10,22,223,157,2,1,1,2.55882,0.176471,25.5882,69.378,34,4,6.84783,3.15217
England,221,237.176,7.17647,0.289593,230.633,7.45701,0.384615,AD Hales,0,0,0,0,0,0,0,0,30,5,35,30,5,35,306,246,0,1,1,4.2963,0.296296,34.1111,85.1201,27,4,7.78623,-2.78623
Australia,228,239.627,7.69737,0.372807,232.079,7.23246,0.337719,JA Burns,0,0,0,0,0,0,0,0,4,5,9,4,5,9,139,140,4,0,1,2.83333,0.166667,24.3333,77.2487,6,4,7.9911,-2.9911
India,259,242.378,7.15058,0.339768,244.568,7.12741,0.30888,AM Rahane,0,0,0,0,0,0,0,0,12,11,23,12,11,23,273,153,2,0,1,3.55738,0.262295,32.2295,78.0159,61,4,9.50195,1.49805
Pakistan,211,222.621,7.38389,0.393365,235.517,7.54976,0.336493,Sharjeel Khan,0,0,0,0,0,0,0,0,0,4,4,0,4,4,0,102,2,0,1,2.6,0.1,16.9,81.25,10,1,7.57972,-3.57972
Sri Lanka,244,223.373,7.09016,0.344262,227.578,7.47541,0.385246,WU Tharanga,0,0,0,0,0,0,0,0,24,7,31,24,7,31,103,104,3,1,1,3.93985,0.263158,32.9699,71.6035,133,4,8.08216,-1.08216
Sri Lanka,244,223.373,7.09016,0.344262,227.578,7.47541,0.385246,TM Dilshan,0,0,0,0,0,0,0,0,24,7,31,24,7,31,103,104,3,1,1,4.60199,0.273632,38.3632,86.0219,201,4,8.08216,-1.08216
New Zealand,184,233.745,7.39674,0.36413,227.951,7.30435,0.353261,MJ Guptill,0,0,0,0,0,0,0,0,12,5,17,12,5,17,0,230,3,1,1,4.8087,0.313043,38.1217,82.7482,115,4,6.8371,-1.8371
New Zealand,184,233.745,7.39674,0.36413,227.951,7.30435,0.353261,JDS Neesham,0,0,0,0,0,0,0,0,12,5,17,12,5,17,0,230,3,1,1,1.75,0,14.875,93.7008,16,0,6.7086,-1.7086
New Zealand,184,233.745,7.39674,0.36413,227.951,7.30435,0.353261,KS Williamson,0,0,0,0,0,0,0,0,32,12,44,32,12,44,219,219,4,1,1,4.31707,0.390244,43.0488,82.8833,82,4,7.11146,4.88854
New Zealand,184,233.745,7.39674,0.36413,227.951,7.30435,0.353261,BB McCullum,0,0,0,0,0,0,0,0,16,12,28,16,12,28,0,248,0,1,1,3.98611,0.201389,29.9028,98.4004,144,0,6.7086,5.2914
New Zealand,184,233.745,7.39674,0.36413,227.951,7.30435,0.353261,MJ Guptill,0,0,0,0,0,0,0,0,12,13,25,12,13,25,277,280,1,1,1,4.8087,0.313043,38.1217,82.7482,115,4,6.81399,6.18601
New Zealand,184,233.745,7.39674,0.36413,227.951,7.30435,0.353261,BB McCullum,0,0,0,0,0,0,0,0,12,13,25,12,13,25,277,280,1,1,1,3.98611,0.201389,29.9028,98.4004,144,0,5.99457,7.00543
Sri Lanka,244,223.373,7.09016,0.344262,227.578,7.47541,0.385246,TM Dilshan,0,0,0,0,0,0,0,0,8,9,17,8,9,17,361,252,5,0,1,4.60199,0.273632,38.3632,86.0219,201,4,11.7238,-2.72381
Sri Lanka,244,223.373,7.09016,0.344262,227.578,7.47541,0.385246,HDRL Thirimanne,0,0,0,0,0,0,0,0,12,8,20,12,8,20,316,195,1,0,1,2.77778,0.246914,31.5802,71.4725,81,4,6.9708,1.0292
New Zealand,184,233.745,7.39674,0.36413,227.951,7.30435,0.353261,BB McCullum,0,0,0,0,0,0,0,0,18,10,28,18,10,28,0,369,2,1,1,3.98611,0.201389,29.9028,98.4004,144,0,6.7086,3.2914
Sri Lanka,244,223.373,7.09016,0.344262,227.578,7.47541,0.385246,MDKJ Perera,0,0,0,0,0,0,0,0,16,9,25,16,9,25,0,317,1,1,1,3.30435,0.195652,25.7391,90.5199,46,0,7.84505,1.15495
England,221,237.176,7.17647,0.289593,230.633,7.45701,0.384615,JWA Taylor,0,0,0,0,0,0,0,0,4,9,13,4,9,13,0,265,1,0,1,3.375,0.333333,35.9167,79.8888,24,4,7.7801,1.2199
Sri Lanka,244,223.373,7.09016,0.344262,227.578,7.47541,0.385246,TM Dilshan,0,0,0,0,0,0,0,0,20,6,26,20,6,26,266,267,2,1,1,4.60199,0.273632,38.3632,86.0219,201,4,8.26947,-2.26947
England,221,237.176,7.17647,0.289593,230.633,7.45701,0.384615,JWA Taylor,0,0,0,0,0,0,0,0,18,7,25,18,7,25,240,240,0,0,1,3.375,0.333333,35.9167,79.8888,24,4,8.41295,-1.41295
Australia,228,239.627,7.69737,0.372807,232.079,7.23246,0.337719,AJ Finch,0,0,0,0,0,0,0,0,0,10,10,0,10,10,0,300,2,1,1,4.52941,0.313725,37.2549,83.4431,51,4,8.21609,1.78391
South Africa,190,234.274,7.4,0.373684,232.363,7.33158,0.342105,HM Amla,0,0,0,0,0,0,0,0,12,6,18,12,6,18,155,157,2,0,1,5.20168,0.403361,48.7899,86.9292,119,4,8.85421,-2.85421
South Africa,190,234.274,7.4,0.373684,232.363,7.33158,0.342105,HM Amla,0,0,0,0,0,0,0,0,12,10,22,12,10,22,0,267,5,0,1,5.20168,0.403361,48.7899,86.9292,119,4,7.85679,2.14321
Australia,228,239.627,7.69737,0.372807,232.079,7.23246,0.337719,AJ Finch,0,0,0,0,0,0,0,0,4,11,15,4,11,15,268,268,0,1,1,4.52941,0.313725,37.2549,83.4431,51,4,8.18996,2.81004
Australia,228,239.627,7.69737,0.372807,232.079,7.23246,0.337719,DA Warner,0,0,0,0,0,0,0,0,26,10,36,26,10,36,281,275,1,1,1,4.20312,0.265625,35.2031,87.7336,64,4,8.5399,1.4601
England,221,237.176,7.17647,0.289593,230.633,7.45701,0.384615,IR Bell,0,0,0,0,0,0,0,0,8,5,13,8,5,13,0,234,2,0,1,3.63433,0.246269,35.3806,75.6623,134,4,7.7801,-2.7801
England,221,237.176,7.17647,0.289593,230.633,7.45701,0.384615,JE Root,0,0,0,0,0,0,0,0,8,5,13,8,5,13,0,234,2,0,1,3.68852,0.327869,41.6721,83.3443,61,4,7.7801,-2.7801
Australia,228,239.627,7.69737,0.372807,232.079,7.23246,0.337719,DA Warner,0,0,0,0,0,0,0,0,16,8,24,16,8,24,235,235,0,1,1,4.20312,0.265625,35.2031,87.7336,64,4,8.13211,-0.132109
India,259,242.378,7.15058,0.339768,244.568,7.12741,0.30888,AM Rahane,0,0,0,0,0,0,0,0,0,6,6,0,6,6,0,153,2,0,1,3.55738,0.262295,32.2295,78.0159,61,4,8.07854,-2.07854
India,259,242.378,7.15058,0.339768,244.568,7.12741,0.30888,S Dhawan,0,0,0,0,0,0,0,0,0,6,6,0,6,6,0,153,2,0,1,5.65217,0.362319,43.2174,88.9088,69,4,8.07854,-2.07854
England,221,237.176,7.17647,0.289593,230.633,7.45701,0.384615,MM Ali,0,0,0,0,0,0,0,0,12,17,29,12,17,29,154,156,2,0,1,2.67647,0.117647,21.3824,94.5384,34,0,8.67038,8.32962
Australia,228,239.627,7.69737,0.372807,232.079,7.23246,0.337719,AJ Finch,0,0,0,0,0,0,0,0,28,8,36,28,8,36,304,304,3,1,1,4.52941,0.313725,37.2549,83.4431,51,4,8.6203,-0.620298
England,221,237.176,7.17647,0.289593,230.633,7.45701,0.384615,JWA Taylor,0,0,0,0,0,0,0,0,8,6,14,8,6,14,201,201,2,0,1,3.375,0.333333,35.9167,79.8888,24,4,6.61872,-0.618721
Australia,228,239.627,7.69737,0.372807,232.079,7.23246,0.337719,SPD Smith,0,0,0,0,0,0,0,0,16,9,25,16,9,25,0,278,0,1,1,3.19298,0.22807,34.5614,87.0526,57,4,8.21609,0.783907
Bangladesh,160,218.438,7.70625,0.4,211.106,7.05,0.325,Tamim Iqbal,0,0,0,0,0,0,0,0,4,4,8,4,4,8,0,281,0,1,1,4.05344,0.274809,31.8015,76.8068,131,4,6.38578,-2.38578
Bangladesh,160,218.438,7.70625,0.4,211.106,7.05,0.325,Mominul Haque,0,0,0,0,0,0,0,0,4,4,8,4,4,8,0,281,0,1,1,2.57143,0.0952381,23.3333,73.4633,21,4,6.38578,-2.38578
Bangladesh,160,218.438,7.70625,0.4,211.106,7.05,0.325,Tamim Iqbal,0,0,0,0,0,0,0,0,10,5,15,10,5,15,0,297,4,1,1,4.05344,0.274809,31.8015,76.8068,131,4,6.38578,-1.38578
Bangladesh,160,218.438,7.70625,0.4,211.106,7.05,0.325,Anamul Haque,0,0,0,0,0,0,0,0,8,6,14,8,6,14,0,256,4,1,1,4.12,0.24,36.8,69.6442,25,4,6.38578,-0.385777
Zimbabwe,142,212.077,7.5,0.380282,227.704,6.97887,0.316901,H Masakadza,0,0,0,0,0,0,0,0,16,7,23,16,7,23,257,235,3,0,1,3.11215,0.186916,26.972,70.0485,107,4,7.87237,-0.872374
Zimbabwe,142,212.077,7.5,0.380282,227.704,6.97887,0.316901,V Sibanda,0,0,0,0,0,0,0,0,12,5,17,12,5,17,0,128,1,0,1,2.9697,0.181818,23.5152,63.5545,66,1,6.44168,-1.44168
West Indies,176,217.33,7.15909,0.3125,225.278,7.57386,0.380682,DR Smith,0,0,0,0,0,0,0,0,12,4,16,12,4,16,0,321,3,0,1,2.5,0.12,17.96,84.5574,50,1,6.19764,-2.19764
India,259,242.378,7.15058,0.339768,244.568,7.12741,0.30888,AM Rahane,0,0,0,0,0,0,0,0,8,10,18,8,10,18,0,330,2,1,1,3.55738,0.262295,32.2295,78.0159,61,4,6.85241,3.14759
Sri Lanka,244,223.373,7.09016,0.344262,227.578,7.47541,0.385246,TM Dilshan,0,0,0,0,0,0,0,0,8,7,15,8,7,15,0,274,6,0,1,4.60199,0.273632,38.3632,86.0219,201,4,7.38489,-0.384891
India,259,242.378,7.15058,0.339768,244.568,7.12741,0.30888,RG Sharma,0,0,0,0,0,0,0,0,16,8,24,16,8,24,0,404,0,1,1,3.82836,0.268657,35.9179,83.083,134,4,6.85241,1.14759
Sri Lanka,244,223.373,7.09016,0.344262,227.578,7.47541,0.385246,LD Chandimal,0,0,0,0,0,0,0,0,20,4,24,20,4,24,405,251,1,0,1,2.18478,0.184783,25.7391,73.8615,92,4,6.04316,-2.04316
India,259,242.378,7.15058,0.339768,244.568,7.12741,0.30888,RG Sharma,0,0,0,0,0,0,0,0,8,5,13,8,5,13,287,288,1,1,1,3.82836,0.268657,35.9179,83.083,134,4,7.75518,-2.75518
South Africa,190,234.274,7.4,0.373684,232.363,7.33158,0.342105,HM Amla,0,0,0,0,0,0,0,0,8,2,10,8,2,10,0,262,0,1,1,5.20168,0.403361,48.7899,86.9292,119,4,7.38502,-5.38502
England,221,237.176,7.17647,0.289593,230.633,7.45701,0.384615,JJ Roy,0,0,0,0,0,0,0,0,12,5,17,12,5,17,0,262,1,0,1,4.36842,0.210526,29.3684,95.3846,19,0,8.1023,-3.1023
South Africa,190,234.274,7.4,0.373684,232.363,7.33158,0.342105,Q de Kock,0,0,0,0,0,0,0,0,8,4,12,8,4,12,0,162,5,0,1,5.12963,0.240741,39.1111,91.2311,54,4,7.85679,-3.85679
Bangladesh,160,218.438,7.70625,0.4,211.106,7.05,0.325,Liton Das,0,0,0,0,0,0,0,0,26,6,32,26,6,32,163,167,1,1,1,1,0,7.66667,69.697,6,1,8.15275,-2.15275
South Africa,190,234.274,7.4,0.373684,232.363,7.33158,0.342105,Q de Kock,0,0,0,0,0,0,0,0,8,9,17,8,9,17,0,168,0,0,1,5.12963,0.240741,39.1111,91.2311,54,4,7.85679,1.14321
South Africa,190,234.274,7.4,0.373684,232.363,7.33158,0.342105,MN van Wyk,0,0,0,0,0,0,0,0,14,7,21,14,7,21,0,304,4,1,1,3.33333,0.266667,27.2,66.9951,15,4,7.38502,-0.385017
South Africa,190,234.274,7.4,0.373684,232.363,7.33158,0.342105,HM Amla,0,0,0,0,0,0,0,0,14,7,21,14,7,21,0,304,4,1,1,5.20168,0.403361,48.7899,86.9292,119,4,7.38502,-0.385017
South Africa,190,234.274,7.4,0.373684,232.363,7.33158,0.342105,MN van Wyk,0,0,0,0,0,0,0,0,16,4,20,16,4,20,0,204,0,1,1,3.33333,0.266667,27.2,66.9951,15,4,7.38502,-3.38502
South Africa,190,234.274,7.4,0.373684,232.363,7.33158,0.342105,RR Rossouw,0,0,0,0,0,0,0,0,16,4,20,16,4,20,0,204,0,1,1,3.80769,0.230769,31.3846,93.1507,26,0,7.64395,-3.64395
New Zealand,184,233.745,7.39674,0.36413,227.951,7.30435,0.353261,MJ Guptill,0,0,0,0,0,0,0,0,8,9,17,8,9,17,284,221,1,0,1,4.8087,0.313043,38.1217,82.7482,115,4,7.6899,1.3101
Pakistan,211,222.621,7.38389,0.393365,235.517,7.54976,0.336493,Sarfraz Ahmed,0,0,0,0,0,0,0,0,8,10,18,8,10,18,0,239,2,0,1,2.04878,0.097561,25.4878,83.9357,41,4,7.14441,2.85559
Bangladesh,160,218.438,7.70625,0.4,211.106,7.05,0.325,Tamim Iqbal,0,0,0,0,0,0,0,0,36,1,37,36,1,37,240,240,1,1,1,4.05344,0.274809,31.8015,76.8068,131,4,4.28841,-3.28841
Bangladesh,160,218.438,7.70625,0.4,211.106,7.05,0.325,Tamim Iqbal,0,0,0,0,0,0,0,0,16,5,21,16,5,21,251,251,2,1,1,4.05344,0.274809,31.8015,76.8068,131,4,7.50863,-2.50863
Pakistan,211,222.621,7.38389,0.393365,235.517,7.54976,0.336493,Ahmed Shehzad,0,0,0,0,0,0,0,0,16,8,24,16,8,24,256,259,0,0,1,3.67143,0.242857,33.2714,70.8118,70,4,8.09637,-0.0963678
Pakistan,211,222.621,7.38389,0.393365,235.517,7.54976,0.336493,Azhar Ali,0,0,0,0,0,0,0,0,0,11,11,0,11,11,0,287,5,0,1,3.83333,0.3,38.5333,73.6775,30,4,7.14441,3.85559
Sri Lanka,244,223.373,7.09016,0.344262,227.578,7.47541,0.385246,MDKJ Perera,0,0,0,0,0,0,0,0,58,5,63,58,5,63,288,288,2,1,1,3.30435,0.195652,25.7391,90.5199,46,0,7.45005,-2.45005
Pakistan,211,222.621,7.38389,0.393365,235.517,7.54976,0.336493,Ahmed Shehzad,0,0,0,0,0,0,0,0,0,13,13,0,13,13,0,316,4,0,1,3.67143,0.242857,33.2714,70.8118,70,4,7.14441,5.85559
Sri Lanka,244,223.373,7.09016,0.344262,227.578,7.47541,0.385246,TM Dilshan,0,0,0,0,0,0,0,0,12,10,22,12,10,22,0,368,0,1,1,4.60199,0.273632,38.3632,86.0219,201,4,7.59431,2.40569
Pakistan,211,222.621,7.38389,0.393365,235.517,7.54976,0.336493,Azhar Ali,0,0,0,0,0,0,0,0,4,10,14,4,10,14,369,203,3,0,1,3.83333,0.3,38.5333,73.6775,30,4,11.2323,-1.23231
Zimbabwe,142,212.077,7.5,0.380282,227.704,6.97887,0.316901,CJ Chibhabha,0,0,0,0,0,0,0,0,8,5,13,8,5,13,0,268,2,0,1,2.56716,0.149254,23.5373,64.7373,67,1,6.44168,-1.44168
Bangladesh,160,218.438,7.70625,0.4,211.106,7.05,0.325,Tamim Iqbal,0,0,0,0,0,0,0,0,8,17,25,8,17,25,0,307,2,1,1,4.05344,0.274809,31.8015,76.8068,131,4,6.38578,10.6142
India,259,242.378,7.15058,0.339768,244.568,7.12741,0.30888,RG Sharma,0,0,0,0,0,0,0,0,4,15,19,4,15,19,308,228,9,0,1,3.82836,0.268657,35.9179,83.083,134,4,9.01971,5.98029
India,259,242.378,7.15058,0.339768,244.568,7.12741,0.30888,S Dhawan,0,0,0,0,0,0,0,0,4,15,19,4,15,19,308,228,9,0,1,5.65217,0.362319,43.2174,88.9088,69,4,9.01971,5.98029
India,259,242.378,7.15058,0.339768,244.568,7.12741,0.30888,S Dhawan,0,0,0,0,0,0,0,0,16,7,23,16,7,23,0,200,5,0,1,5.65217,0.362319,43.2174,88.9088,69,4,8.07854,-1.07854
India,259,242.378,7.15058,0.339768,244.568,7.12741,0.30888,RG Sharma,0,0,0,0,0,0,0,0,8,16,24,8,16,24,0,317,2,0,1,3.82836,0.268657,35.9179,83.083,134,4,8.07854,7.92146
Bangladesh,160,218.438,7.70625,0.4,211.106,7.05,0.325,Litton Das,0,0,0,0,0,0,0,0,22,7,29,22,7,29,318,240,5,1,1,2.66667,0,25.3333,72.381,3,4,7.01328,-0.0132775
India,259,242.378,7.15058,0.339768,244.568,7.12741,0.30888,AM Rahane,0,0,0,0,0,0,0,0,8,8,16,8,8,16,0,271,1,0,1,3.55738,0.262295,32.2295,78.0159,61,4,8.07854,-0.0785389
Zimbabwe,142,212.077,7.5,0.380282,227.704,6.97887,0.316901,CR Ervine,0,0,0,0,0,0,0,0,12,3,15,12,3,15,0,235,0,1,1,3.06667,0.2,30.5333,73.9903,30,4,6.31573,-3.31573
Australia,228,239.627,7.69737,0.372807,232.079,7.23246,0.337719,DA Warner,0,0,0,0,0,0,0,0,8,11,19,8,11,19,310,310,2,1,1,4.20312,0.265625,35.2031,87.7336,64,4,8.6203,2.3797
Australia,228,239.627,7.69737,0.372807,232.079,7.23246,0.337719,GJ Bailey,0,0,0,0,0,0,0,0,8,11,19,8,11,19,310,310,2,1,1,3.34921,0.301587,36.3492,84.658,63,4,8.6203,2.3797
India,259,242.378,7.15058,0.339768,244.568,7.12741,0.30888,V Kohli,0,0,0,0,0,0,0,0,8,7,15,8,7,15,0,295,1,0,1,4.66456,0.379747,44.9937,88.3325,158,4,8.07854,-1.07854
Australia,228,239.627,7.69737,0.372807,232.079,7.23246,0.337719,AJ Finch,0,0,0,0,0,0,0,0,32,8,40,32,8,40,0,348,0,1,1,4.52941,0.313725,37.2549,83.4431,51,4,8.21609,-0.216093
India,259,242.378,7.15058,0.339768,244.568,7.12741,0.30888,RG Sharma,0,0,0,0,0,0,0,0,14,16,30,14,16,30,349,323,0,0,1,3.82836,0.268657,35.9179,83.083,134,4,9.77617,6.22383
Australia,228,239.627,7.69737,0.372807,232.079,7.23246,0.337719,AJ Finch,0,0,0,0,0,0,0,0,12,16,28,12,16,28,0,330,2,1,1,4.52941,0.313725,37.2549,83.4431,51,4,8.21609,7.78391
Australia,228,239.627,7.69737,0.372807,232.079,7.23246,0.337719,SPD Smith,0,0,0,0,0,0,0,0,12,16,28,12,16,28,0,330,2,1,1,3.19298,0.22807,34.5614,87.0526,57,4,8.21609,7.78391
England,221,237.176,7.17647,0.289593,230.633,7.45701,0.384615,JWA Taylor,0,0,0,0,0,0,0,0,12,7,19,12,7,19,0,216,0,0,1,3.375,0.333333,35.9167,79.8888,24,4,7.7801,-0.780101
Pakistan,211,222.621,7.38389,0.393365,235.517,7.54976,0.336493,Bilal Asif,0,0,0,0,0,0,0,0,16,4,20,16,4,20,217,217,3,0,1,2.33333,0,13.3333,76.9231,3,1,7.38264,-3.38264
England,221,237.176,7.17647,0.289593,230.633,7.45701,0.384615,JJ Roy,0,0,0,0,0,0,0,0,12,6,18,12,6,18,0,283,0,0,1,4.36842,0.210526,29.3684,95.3846,19,0,8.1023,-2.1023
Pakistan,211,222.621,7.38389,0.393365,235.517,7.54976,0.336493,Azhar Ali,0,0,0,0,0,0,0,0,0,8,8,0,8,8,284,188,2,0,1,3.83333,0.3,38.5333,73.6775,30,4,8.08449,-0.0844908
Pakistan,211,222.621,7.38389,0.393365,235.517,7.54976,0.336493,Azhar Ali,0,0,0,0,0,0,0,0,4,10,14,4,10,14,0,208,1,0,1,3.83333,0.3,38.5333,73.6775,30,4,7.14441,2.85559
England,221,237.176,7.17647,0.289593,230.633,7.45701,0.384615,AD Hales,0,0,0,0,0,0,0,0,12,11,23,12,11,23,209,210,0,0,1,4.2963,0.296296,34.1111,85.1201,27,4,7.55927,3.44073
England,221,237.176,7.17647,0.289593,230.633,7.45701,0.384615,JJ Roy,0,0,0,0,0,0,0,0,4,17,21,4,17,21,0,355,3,0,1,4.36842,0.210526,29.3684,95.3846,19,0,8.1023,8.8977
India,259,242.378,7.15058,0.339768,244.568,7.12741,0.30888,RG Sharma,0,0,0,0,0,0,0,0,20,5,25,20,5,25,304,298,1,1,1,3.82836,0.268657,35.9179,83.083,134,4,7.83557,-2.83557
India,259,242.378,7.15058,0.339768,244.568,7.12741,0.30888,S Dhawan,0,0,0,0,0,0,0,0,16,13,29,16,13,29,0,299,0,1,1,5.65217,0.362319,43.2174,88.9088,69,4,6.85241,6.14759
South Africa,190,234.274,7.4,0.373684,232.363,7.33158,0.342105,HM Amla,0,0,0,0,0,0,0,0,16,16,32,16,16,32,300,264,4,0,1,5.20168,0.403361,48.7899,86.9292,119,4,9.27275,6.72725
South Africa,190,234.274,7.4,0.373684,232.363,7.33158,0.342105,Q de Kock,0,0,0,0,0,0,0,0,36,7,43,36,7,43,0,438,1,0,1,5.12963,0.240741,39.1111,91.2311,54,4,7.85679,-0.856788
Sri Lanka,244,223.373,7.09016,0.344262,227.578,7.47541,0.385246,TM Dilshan,0,0,0,0,0,0,0,0,8,10,18,8,10,18,0,188,2,0,1,4.60199,0.273632,38.3632,86.0219,201,4,7.38489,2.61511
Sri Lanka,244,223.373,7.09016,0.344262,227.578,7.47541,0.385246,TM Dilshan,0,0,0,0,0,0,0,0,16,9,25,16,9,25,295,258,1,0,1,4.60199,0.273632,38.3632,86.0219,201,4,8.41404,0.585957
Sri Lanka,244,223.373,7.09016,0.344262,227.578,7.47541,0.385246,LD Chandimal,0,0,0,0,0,0,0,0,16,9,25,16,9,25,295,258,1,0,1,2.18478,0.184783,25.7391,73.8615,92,4,8.41404,0.585957
New Zealand,184,233.745,7.39674,0.36413,227.951,7.30435,0.353261,BB McCullum,0,0,0,0,0,0,0,0,26,2,28,26,2,28,0,307,0,1,1,3.98611,0.201389,29.9028,98.4004,144,0,6.7086,-4.7086
Australia,228,239.627,7.69737,0.372807,232.079,7.23246,0.337719,DA Warner,0,0,0,0,0,0,0,0,16,11,27,16,11,27,308,148,2,0,1,4.20312,0.265625,35.2031,87.7336,64,4,8.76687,2.23313
New Zealand,184,233.745,7.39674,0.36413,227.951,7.30435,0.353261,MJ Guptill,0,0,0,0,0,0,0,0,26,8,34,26,8,34,0,281,2,1,1,4.8087,0.313043,38.1217,82.7482,115,4,6.8371,1.1629
Australia,228,239.627,7.69737,0.372807,232.079,7.23246,0.337719,DA Warner,0,0,0,0,0,0,0,0,26,9,35,26,9,35,282,283,2,0,1,4.20312,0.265625,35.2031,87.7336,64,4,8.15721,0.842787
Australia,228,239.627,7.69737,0.372807,232.079,7.23246,0.337719,UT Khawaja,0,0,0,0,0,0,0,0,26,13,39,26,13,39,247,191,0,0,1,2.8,0.2,21.6,84.375,5,4,10.1182,2.88181
West Indies,176,217.33,7.15909,0.3125,225.278,7.57386,0.380682,J Charles,0,0,0,0,0,0,0,0,8,7,15,8,7,15,0,159,6,0,1,3.82353,0.147059,28.2353,81.2183,34,4,5.82675,1.17325
West Indies,176,217.33,7.15909,0.3125,225.278,7.57386,0.380682,MN Samuels,0,0,0,0,0,0,0,0,8,7,15,8,7,15,0,159,6,0,1,3.74757,0.23301,31.6214,74.5821,103,4,5.82675,1.17325
Sri Lanka,244,223.373,7.09016,0.344262,227.578,7.47541,0.385246,MDKJ Perera,0,0,0,0,0,0,0,0,34,13,47,34,13,47,160,164,1,1,1,3.30435,0.195652,25.7391,90.5199,46,0,8.6654,4.3346
West Indies,176,217.33,7.15909,0.3125,225.278,7.57386,0.380682,J Blackwood,0,0,0,0,0,0,0,0,12,12,24,12,12,24,0,214,6,0,1,0.5,0,5.5,44,2,3,6.1107,5.8893
Pakistan,211,222.621,7.38389,0.393365,235.517,7.54976,0.336493,Azhar Ali,0,0,0,0,0,0,0,0,4,7,11,4,7,11,0,259,1,0,1,3.83333,0.3,38.5333,73.6775,30,4,7.14441,-0.14441
Zimbabwe,142,212.077,7.5,0.380282,227.704,6.97887,0.316901,CJ Chibhabha,0,0,0,0,0,0,0,0,4,6,10,4,6,10,260,128,1,1,1,2.56716,0.149254,23.5373,64.7373,67,1,6.86887,-0.868875
Zimbabwe,142,212.077,7.5,0.380282,227.704,6.97887,0.316901,H Masakadza,0,0,0,0,0,0,0,0,8,7,15,8,7,15,0,276,1,1,1,3.11215,0.186916,26.972,70.0485,107,4,6.31573,0.684273
Pakistan,211,222.621,7.38389,0.393365,235.517,7.54976,0.336493,Azhar Ali,0,0,0,0,0,0,0,0,12,3,15,12,3,15,277,256,2,0,1,3.83333,0.3,38.5333,73.6775,30,4,8.08449,-5.08449
Pakistan,211,222.621,7.38389,0.393365,235.517,7.54976,0.336493,Bilal Asif,0,0,0,0,0,0,0,0,12,3,15,12,3,15,277,256,2,0,1,2.33333,0,13.3333,76.9231,3,1,8.15095,-5.15095
Ireland,55,219.527,7.65455,0.290909,202.727,7.56364,0.4,WTS Porterfield,0,0,0,0,0,0,0,0,12,4,16,12,4,16,0,219,0,0,1,2.6,0.142857,24.6857,56.2866,35,3,5.4886,-1.4886
Zimbabwe,142,212.077,7.5,0.380282,227.704,6.97887,0.316901,R Mutumbami,0,0,0,0,0,0,0,0,12,10,22,12,10,22,269,270,7,1,1,1.93333,0.0666667,15.4667,69.8795,15,1,6.97877,3.02123
Bangladesh,160,218.438,7.70625,0.4,211.106,7.05,0.325,Tamim Iqbal,0,0,0,0,0,0,0,0,12,6,18,12,6,18,0,273,1,1,1,4.05344,0.274809,31.8015,76.8068,131,4,6.38578,-0.385777
Bangladesh,160,218.438,7.70625,0.4,211.106,7.05,0.325,Liton Das,0,0,0,0,0,0,0,0,12,6,18,12,6,18,0,273,1,1,1,1,0,7.66667,69.697,6,1,5.00096,0.999044
Bangladesh,160,218.438,7.70625,0.4,211.106,7.05,0.325,Imrul Kayes,0,0,0,0,0,0,0,0,12,9,21,12,9,21,0,241,0,1,1,3,0.207547,26.2642,63.6488,53,4,6.38578,2.61422
Zimbabwe,142,212.077,7.5,0.380282,227.704,6.97887,0.316901,RW Chakabva,0,0,0,0,0,0,0,0,10,5,15,10,5,15,242,183,8,0,1,0.846154,0,13.2692,51.3393,26,3,5.54174,-0.541739
Bangladesh,160,218.438,7.70625,0.4,211.106,7.05,0.325,Tamim Iqbal,0,0,0,0,0,0,0,0,14,7,21,14,7,21,0,276,0,1,1,4.05344,0.274809,31.8015,76.8068,131,4,6.38578,0.614223
Zimbabwe,142,212.077,7.5,0.380282,227.704,6.97887,0.316901,RW Chakabva,0,0,0,0,0,0,0,0,20,7,27,20,7,27,277,215,3,0,1,0.846154,0,13.2692,51.3393,26,3,7.65506,-0.655057
