Team,Total Matches Played,Runs Scored,Wickets Lost,Got All Out,Runs Conceded,Opponent Wickets Taken,Opponent All Out,Match Index,Batsman,Player Total Runs,Player Home Runs,Player Non Home Runs,Balls Faced,R0,W0,R1,W1,Current_HR,Current_NHR,Total Runs in Segment,Total HR till Segment,Total NHR till Segment,Total Runs Till Segment,Target,Final Runs Made,Extras,Home,Segment,Home Run Hitting Ability,Milestone Reaching Ability,Batting Average,Strike Rate,Matches Played,ClusterID
England,221,237.176,7.17647,0.289593,230.633,7.45701,0.384615,1,ME Trescothick,0,0,0,0,0,0,0,0,4,2,6,4,2,6,0,321,1,1,1,6.625,0.375,49.5,87.4172,8,4
England,221,237.176,7.17647,0.289593,230.633,7.45701,0.384615,1,AN Cook,0,0,0,0,0,0,0,0,4,2,6,4,2,6,0,321,1,1,1,4.17045,0.272727,35.75,75.5524,88,4
Sri Lanka,244,223.373,7.09016,0.344262,227.578,7.47541,0.385246,1,WU Tharanga,0,0,0,0,0,0,0,0,42,10,52,42,10,52,322,324,7,0,1,3.93985,0.263158,32.9699,71.6035,133,4
Sri Lanka,244,223.373,7.09016,0.344262,227.578,7.47541,0.385246,1,ST Jayasuriya,0,0,0,0,0,0,0,0,42,10,52,42,10,52,322,324,7,0,1,4.91549,0.211268,33.9859,98.4898,71,0
India,259,242.378,7.15058,0.339768,244.568,7.12741,0.30888,2,SC Ganguly,0,0,0,0,0,0,0,0,0,7,7,0,7,7,0,191,6,0,1,4.56,0.36,36.8,68.2999,25,4
India,259,242.378,7.15058,0.339768,244.568,7.12741,0.30888,2,V Sehwag,0,0,0,0,0,0,0,0,0,7,7,0,7,7,0,191,6,0,1,5.88636,0.238636,38.8295,108.649,88,0
India,259,242.378,7.15058,0.339768,244.568,7.12741,0.30888,2,RV Uthappa,0,0,0,0,0,0,0,0,0,7,7,0,7,7,0,191,6,0,1,3,0.117647,22.1471,89.0071,34,0
Bangladesh,160,218.438,7.70625,0.4,211.106,7.05,0.325,2,Tamim Iqbal,0,0,0,0,0,0,0,0,8,8,16,8,8,16,192,192,8,0,1,4.05344,0.274809,31.8015,76.8068,131,4
Bangladesh,160,218.438,7.70625,0.4,211.106,7.05,0.325,2,Shahriar Nafees,0,0,0,0,0,0,0,0,8,8,16,8,8,16,192,192,8,0,1,3.40541,0.162162,24.4865,69.1076,37,4
Bangladesh,160,218.438,7.70625,0.4,211.106,7.05,0.325,2,Mushfiqur Rahim,0,0,0,0,0,0,0,0,8,8,16,8,8,16,192,192,8,0,1,2.61111,0.18254,27.7778,75.2526,126,4
England,221,237.176,7.17647,0.289593,230.633,7.45701,0.384615,4,EC Joyce,0,0,0,0,0,0,0,0,8,7,15,8,7,15,0,266,7,0,1,3.08571,0.2,28.3429,68.6505,35,4
England,221,237.176,7.17647,0.289593,230.633,7.45701,0.384615,4,MP Vaughan,0,0,0,0,0,0,0,0,8,7,15,8,7,15,0,266,7,0,1,2.6,0.1,20.6,66.4516,10,1
England,221,237.176,7.17647,0.289593,230.633,7.45701,0.384615,4,IR Bell,0,0,0,0,0,0,0,0,8,7,15,8,7,15,0,266,7,0,1,3.63433,0.246269,35.3806,75.6623,134,4
Ireland,55,219.527,7.65455,0.290909,202.727,7.56364,0.4,4,WTS Porterfield,0,0,0,0,0,0,0,0,0,7,7,0,7,7,267,218,4,0,1,2.6,0.142857,24.6857,56.2866,35,3
Ireland,55,219.527,7.65455,0.290909,202.727,7.56364,0.4,4,JP Bray,0,0,0,0,0,0,0,0,0,7,7,0,7,7,267,218,4,0,1,2.7,0.1,23.4,63.0728,10,1
Ireland,55,219.527,7.65455,0.290909,202.727,7.56364,0.4,4,EJG Morgan,0,0,0,0,0,0,0,0,0,7,7,0,7,7,267,218,4,0,1,3.19549,0.233083,30.0526,86.9291,133,4
Ireland,55,219.527,7.65455,0.290909,202.727,7.56364,0.4,4,NJ O'Brien,0,0,0,0,0,0,0,0,0,7,7,0,7,7,267,218,4,0,1,2.55882,0.176471,25.5882,69.378,34,4
Bangladesh,160,218.438,7.70625,0.4,211.106,7.05,0.325,5,Tamim Iqbal,0,0,0,0,0,0,0,0,12,7,19,12,7,19,0,143,3,0,1,4.05344,0.274809,31.8015,76.8068,131,4
Bangladesh,160,218.438,7.70625,0.4,211.106,7.05,0.325,5,Shahriar Nafees,0,0,0,0,0,0,0,0,12,7,19,12,7,19,0,143,3,0,1,3.40541,0.162162,24.4865,69.1076,37,4
Bangladesh,160,218.438,7.70625,0.4,211.106,7.05,0.325,5,Habibul Bashar,0,0,0,0,0,0,0,0,12,7,19,12,7,19,0,143,3,0,1,1.125,0,15.25,51.2605,16,3
England,221,237.176,7.17647,0.289593,230.633,7.45701,0.384615,5,IR Bell,0,0,0,0,0,0,0,0,4,3,7,4,3,7,144,147,8,0,1,3.63433,0.246269,35.3806,75.6623,134,4
England,221,237.176,7.17647,0.289593,230.633,7.45701,0.384615,5,MP Vaughan,0,0,0,0,0,0,0,0,4,3,7,4,3,7,144,147,8,0,1,2.6,0.1,20.6,66.4516,10,1
England,221,237.176,7.17647,0.289593,230.633,7.45701,0.384615,5,AJ Strauss,0,0,0,0,0,0,0,0,4,3,7,4,3,7,144,147,8,0,1,3.93243,0.27027,33.9054,79.8028,74,4
West Indies,176,217.33,7.15909,0.3125,225.278,7.57386,0.380682,6,CH Gayle,0,0,0,0,0,0,0,0,22,10,32,22,10,32,0,300,6,1,1,4.58621,0.206897,31.1293,89.4255,116,4
West Indies,176,217.33,7.15909,0.3125,225.278,7.57386,0.380682,6,DS Smith,0,0,0,0,0,0,0,0,22,10,32,22,10,32,0,300,6,1,1,2.61765,0.147059,23.5588,71.2,34,4
England,221,237.176,7.17647,0.289593,230.633,7.45701,0.384615,6,AJ Strauss,0,0,0,0,0,0,0,0,12,15,27,12,15,27,301,301,7,0,1,3.93243,0.27027,33.9054,79.8028,74,4
England,221,237.176,7.17647,0.289593,230.633,7.45701,0.384615,6,MP Vaughan,0,0,0,0,0,0,0,0,12,15,27,12,15,27,301,301,7,0,1,2.6,0.1,20.6,66.4516,10,1
England,221,237.176,7.17647,0.289593,230.633,7.45701,0.384615,6,RS Bopara,0,0,0,0,0,0,0,0,12,15,27,12,15,27,301,301,7,0,1,2.22115,0.144231,25.1538,75.9361,104,4
New Zealand,184,233.745,7.39674,0.36413,227.951,7.30435,0.353261,7,SP Fleming,0,0,0,0,0,0,0,0,4,3,7,4,3,7,0,218,0,0,1,3.875,0.25,30.2917,70.9268,24,4
New Zealand,184,233.745,7.39674,0.36413,227.951,7.30435,0.353261,7,NJ Astle,0,0,0,0,0,0,0,0,4,3,7,4,3,7,0,218,0,0,1,2.8,0.1,20,67.5676,10,1
New Zealand,184,233.745,7.39674,0.36413,227.951,7.30435,0.353261,7,HJH Marshall,0,0,0,0,0,0,0,0,4,3,7,4,3,7,0,218,0,0,1,1.1,0.1,11.4,69.5122,10,1
New Zealand,184,233.745,7.39674,0.36413,227.951,7.30435,0.353261,7,LRPL Taylor,0,0,0,0,0,0,0,0,4,3,7,4,3,7,0,218,0,0,1,3.68382,0.301471,36.7206,79.3959,136,4
Australia,228,239.627,7.69737,0.372807,232.079,7.23246,0.337719,7,AC Gilchrist,0,0,0,0,0,0,0,0,4,4,8,4,4,8,219,224,4,1,1,4.3,0.275,31.425,96.1009,40,0
Australia,228,239.627,7.69737,0.372807,232.079,7.23246,0.337719,7,ML Hayden,0,0,0,0,0,0,0,0,4,4,8,4,4,8,219,224,4,1,1,6.37838,0.378378,50.6757,83.3333,37,4
Australia,228,239.627,7.69737,0.372807,232.079,7.23246,0.337719,7,MJ Clarke,0,0,0,0,0,0,0,0,4,4,8,4,4,8,219,224,4,1,1,3.10294,0.301471,35.9265,74.0303,136,4
Australia,228,239.627,7.69737,0.372807,232.079,7.23246,0.337719,7,RT Ponting,0,0,0,0,0,0,0,0,4,4,8,4,4,8,219,224,4,1,1,4.17431,0.33945,38.1009,80.8606,109,4
England,221,237.176,7.17647,0.289593,230.633,7.45701,0.384615,8,EC Joyce,0,0,0,0,0,0,0,0,12,6,18,12,6,18,0,270,6,0,1,3.08571,0.2,28.3429,68.6505,35,4
England,221,237.176,7.17647,0.289593,230.633,7.45701,0.384615,8,MP Vaughan,0,0,0,0,0,0,0,0,12,6,18,12,6,18,0,270,6,0,1,2.6,0.1,20.6,66.4516,10,1
England,221,237.176,7.17647,0.289593,230.633,7.45701,0.384615,8,IR Bell,0,0,0,0,0,0,0,0,12,6,18,12,6,18,0,270,6,0,1,3.63433,0.246269,35.3806,75.6623,134,4
New Zealand,184,233.745,7.39674,0.36413,227.951,7.30435,0.353261,8,L Vincent,0,0,0,0,0,0,0,0,12,13,25,12,13,25,271,256,12,0,1,3.125,0.25,27.8125,67.5266,16,4
New Zealand,184,233.745,7.39674,0.36413,227.951,7.30435,0.353261,8,SP Fleming,0,0,0,0,0,0,0,0,12,13,25,12,13,25,271,256,12,0,1,3.875,0.25,30.2917,70.9268,24,4
Bangladesh,160,218.438,7.70625,0.4,211.106,7.05,0.325,9,Rajin Saleh,0,0,0,0,0,0,0,0,4,2,6,4,2,6,0,231,3,0,1,3.5,0,21.5,53.0864,2,3
Bangladesh,160,218.438,7.70625,0.4,211.106,7.05,0.325,9,Shahriar Nafees,0,0,0,0,0,0,0,0,4,2,6,4,2,6,0,231,3,0,1,3.40541,0.162162,24.4865,69.1076,37,4
Zimbabwe,142,212.077,7.5,0.380282,227.704,6.97887,0.316901,9,CJ Chibhabha,0,0,0,0,0,0,0,0,8,11,19,8,11,19,232,130,1,0,1,2.56716,0.149254,23.5373,64.7373,67,1
Zimbabwe,142,212.077,7.5,0.380282,227.704,6.97887,0.316901,9,BRM Taylor,0,0,0,0,0,0,0,0,8,11,19,8,11,19,232,130,1,0,1,3.3,0.26,33.56,76.3421,100,4
India,259,242.378,7.15058,0.339768,244.568,7.12741,0.30888,10,V Sehwag,0,0,0,0,0,0,0,0,12,8,20,12,8,20,0,223,2,1,1,5.88636,0.238636,38.8295,108.649,88,0
India,259,242.378,7.15058,0.339768,244.568,7.12741,0.30888,10,SR Tendulkar,0,0,0,0,0,0,0,0,12,8,20,12,8,20,0,223,2,1,1,5.89773,0.363636,45.6023,84.5376,88,4
India,259,242.378,7.15058,0.339768,244.568,7.12741,0.30888,10,IK Pathan,0,0,0,0,0,0,0,0,12,8,20,12,8,20,0,223,2,1,1,1.875,0.025,16.85,78.2811,40,1
West Indies,176,217.33,7.15909,0.3125,225.278,7.57386,0.380682,10,CH Gayle,0,0,0,0,0,0,0,0,20,1,21,20,1,21,224,224,3,0,1,4.58621,0.206897,31.1293,89.4255,116,4
West Indies,176,217.33,7.15909,0.3125,225.278,7.57386,0.380682,10,S Chanderpaul,0,0,0,0,0,0,0,0,20,1,21,20,1,21,224,224,3,0,1,3.57143,0.396825,40.8254,68.0783,63,4
Pakistan,211,222.621,7.38389,0.393365,235.517,7.54976,0.336493,11,Mohammad Hafeez,0,0,0,0,0,0,0,0,10,4,14,10,4,14,0,153,5,0,1,4.04511,0.255639,34.3534,78.0625,133,4
Pakistan,211,222.621,7.38389,0.393365,235.517,7.54976,0.336493,11,Imran Nazir,0,0,0,0,0,0,0,0,10,4,14,10,4,14,0,153,5,0,1,4.66667,0.133333,29,96.0265,15,0
Pakistan,211,222.621,7.38389,0.393365,235.517,7.54976,0.336493,11,Younis Khan,0,0,0,0,0,0,0,0,10,4,14,10,4,14,0,153,5,0,1,2.64655,0.215517,28.5,73.2713,116,4
South Africa,190,234.274,7.4,0.373684,232.363,7.33158,0.342105,11,GC Smith,0,0,0,0,0,0,0,0,12,5,17,12,5,17,154,156,3,1,1,3.97,0.29,33.57,79.6819,100,4
South Africa,190,234.274,7.4,0.373684,232.363,7.33158,0.342105,11,JH Kallis,0,0,0,0,0,0,0,0,12,5,17,12,5,17,154,156,3,1,1,3.58621,0.356322,37.2644,76.4442,87,4
South Africa,190,234.274,7.4,0.373684,232.363,7.33158,0.342105,11,AB de Villiers,0,0,0,0,0,0,0,0,12,5,17,12,5,17,154,156,3,1,1,5.04969,0.403727,47.2174,98.8428,161,4
India,259,242.378,7.15058,0.339768,244.568,7.12741,0.30888,12,R Dravid,0,0,0,0,0,0,0,0,12,5,17,12,5,17,0,162,6,0,1,2.83721,0.255814,29.8605,72.7067,43,4
India,259,242.378,7.15058,0.339768,244.568,7.12741,0.30888,12,V Sehwag,0,0,0,0,0,0,0,0,12,5,17,12,5,17,0,162,6,0,1,5.88636,0.238636,38.8295,108.649,88,0
India,259,242.378,7.15058,0.339768,244.568,7.12741,0.30888,12,SR Tendulkar,0,0,0,0,0,0,0,0,12,5,17,12,5,17,0,162,6,0,1,5.89773,0.363636,45.6023,84.5376,88,4
India,259,242.378,7.15058,0.339768,244.568,7.12741,0.30888,12,SK Raina,0,0,0,0,0,0,0,0,12,5,17,12,5,17,0,162,6,0,1,3.11111,0.216374,28.9064,91.8944,171,0
West Indies,176,217.33,7.15909,0.3125,225.278,7.57386,0.380682,12,S Chanderpaul,0,0,0,0,0,0,0,0,4,12,16,4,12,16,163,146,2,0,1,3.57143,0.396825,40.8254,68.0783,63,4
West Indies,176,217.33,7.15909,0.3125,225.278,7.57386,0.380682,12,RS Morton,0,0,0,0,0,0,0,0,4,12,16,4,12,16,163,146,2,0,1,2.2963,0.222222,28.8889,67.0103,27,4
West Indies,176,217.33,7.15909,0.3125,225.278,7.57386,0.380682,13,CH Gayle,0,0,0,0,0,0,0,0,20,2,22,20,2,22,0,289,3,0,1,4.58621,0.206897,31.1293,89.4255,116,4
West Indies,176,217.33,7.15909,0.3125,225.278,7.57386,0.380682,13,DS Smith,0,0,0,0,0,0,0,0,20,2,22,20,2,22,0,289,3,0,1,2.61765,0.147059,23.5588,71.2,34,4
West Indies,176,217.33,7.15909,0.3125,225.278,7.57386,0.380682,13,S Chanderpaul,0,0,0,0,0,0,0,0,20,2,22,20,2,22,0,289,3,0,1,3.57143,0.396825,40.8254,68.0783,63,4
England,221,237.176,7.17647,0.289593,230.633,7.45701,0.384615,13,AN Cook,0,0,0,0,0,0,0,0,8,5,13,8,5,13,290,196,2,1,1,4.17045,0.272727,35.75,75.5524,88,4
England,221,237.176,7.17647,0.289593,230.633,7.45701,0.384615,13,MJ Prior,0,0,0,0,0,0,0,0,8,5,13,8,5,13,290,196,2,1,1,2.27083,0.0625,21.6875,76.4879,48,4
England,221,237.176,7.17647,0.289593,230.633,7.45701,0.384615,13,IR Bell,0,0,0,0,0,0,0,0,8,5,13,8,5,13,290,196,2,1,1,3.63433,0.246269,35.3806,75.6623,134,4
Australia,228,239.627,7.69737,0.372807,232.079,7.23246,0.337719,17,AC Gilchrist,0,0,0,0,0,0,0,0,8,9,17,8,9,17,0,236,0,1,1,4.3,0.275,31.425,96.1009,40,0
Australia,228,239.627,7.69737,0.372807,232.079,7.23246,0.337719,17,ML Hayden,0,0,0,0,0,0,0,0,8,9,17,8,9,17,0,236,0,1,1,6.37838,0.378378,50.6757,83.3333,37,4
Australia,228,239.627,7.69737,0.372807,232.079,7.23246,0.337719,17,RT Ponting,0,0,0,0,0,0,0,0,8,9,17,8,9,17,0,236,0,1,1,4.17431,0.33945,38.1009,80.8606,109,4
Sri Lanka,244,223.373,7.09016,0.344262,227.578,7.47541,0.385246,17,TM Dilshan,0,0,0,0,0,0,0,0,20,8,28,20,8,28,237,173,8,0,1,4.60199,0.273632,38.3632,86.0219,201,4
Sri Lanka,244,223.373,7.09016,0.344262,227.578,7.47541,0.385246,17,ST Jayasuriya,0,0,0,0,0,0,0,0,20,8,28,20,8,28,237,173,8,0,1,4.91549,0.211268,33.9859,98.4898,71,0
Sri Lanka,244,223.373,7.09016,0.344262,227.578,7.47541,0.385246,17,KC Sangakkara,0,0,0,0,0,0,0,0,20,8,28,20,8,28,237,173,8,0,1,4.33659,0.360976,41.9854,80.6276,205,4
Sri Lanka,244,223.373,7.09016,0.344262,227.578,7.47541,0.385246,17,DPMD Jayawardene,0,0,0,0,0,0,0,0,20,8,28,20,8,28,237,173,8,0,1,3.20833,0.244792,31.6979,79.1109,192,4
South Africa,190,234.274,7.4,0.373684,232.363,7.33158,0.342105,18,MN van Wyk,0,0,0,0,0,0,0,0,20,8,28,20,8,28,0,173,8,0,1,3.33333,0.266667,27.2,66.9951,15,4
South Africa,190,234.274,7.4,0.373684,232.363,7.33158,0.342105,18,AB de Villiers,0,0,0,0,0,0,0,0,20,8,28,20,8,28,0,173,8,0,1,5.04969,0.403727,47.2174,98.8428,161,4
Ireland,55,219.527,7.65455,0.290909,202.727,7.56364,0.4,18,WTS Porterfield,0,0,0,0,0,0,0,0,12,10,22,12,10,22,174,131,4,1,1,2.6,0.142857,24.6857,56.2866,35,3
Ireland,55,219.527,7.65455,0.290909,202.727,7.56364,0.4,18,KED Carroll,0,0,0,0,0,0,0,0,12,10,22,12,10,22,174,131,4,1,1,0.333333,0,9.33333,66.6667,3,1
New Zealand,184,233.745,7.39674,0.36413,227.951,7.30435,0.353261,19,JM How,0,0,0,0,0,0,0,0,18,8,26,18,8,26,0,182,0,0,1,3.34615,0.192308,29.9231,64.9416,26,4
New Zealand,184,233.745,7.39674,0.36413,227.951,7.30435,0.353261,19,BB McCullum,0,0,0,0,0,0,0,0,18,8,26,18,8,26,0,182,0,0,1,3.98611,0.201389,29.9028,98.4004,144,0
New Zealand,184,233.745,7.39674,0.36413,227.951,7.30435,0.353261,19,LRPL Taylor,0,0,0,0,0,0,0,0,18,8,26,18,8,26,0,182,0,0,1,3.68382,0.301471,36.7206,79.3959,136,4
England,221,237.176,7.17647,0.289593,230.633,7.45701,0.384615,19,IR Bell,0,0,0,0,0,0,0,0,4,5,9,4,5,9,183,160,10,1,1,3.63433,0.246269,35.3806,75.6623,134,4
England,221,237.176,7.17647,0.289593,230.633,7.45701,0.384615,19,LJ Wright,0,0,0,0,0,0,0,0,4,5,9,4,5,9,183,160,10,1,1,1.92105,0.0263158,17.2368,81.875,38,1
England,221,237.176,7.17647,0.289593,230.633,7.45701,0.384615,19,KP Pietersen,0,0,0,0,0,0,0,0,4,5,9,4,5,9,183,160,10,1,1,3.69892,0.236559,33.4946,82.2117,93,4
England,221,237.176,7.17647,0.289593,230.633,7.45701,0.384615,19,RS Bopara,0,0,0,0,0,0,0,0,4,5,9,4,5,9,183,160,10,1,1,2.22115,0.144231,25.1538,75.9361,104,4
India,259,242.378,7.15058,0.339768,244.568,7.12741,0.30888,20,SC Ganguly,0,0,0,0,0,0,0,0,4,3,7,4,3,7,0,148,9,1,1,4.56,0.36,36.8,68.2999,25,4
India,259,242.378,7.15058,0.339768,244.568,7.12741,0.30888,20,R Dravid,0,0,0,0,0,0,0,0,4,3,7,4,3,7,0,148,9,1,1,2.83721,0.255814,29.8605,72.7067,43,4
India,259,242.378,7.15058,0.339768,244.568,7.12741,0.30888,20,Yuvraj Singh,0,0,0,0,0,0,0,0,4,3,7,4,3,7,0,148,9,1,1,4.05833,0.258333,32.525,83.8093,120,4
India,259,242.378,7.15058,0.339768,244.568,7.12741,0.30888,20,SR Tendulkar,0,0,0,0,0,0,0,0,4,3,7,4,3,7,0,148,9,1,1,5.89773,0.363636,45.6023,84.5376,88,4
India,259,242.378,7.15058,0.339768,244.568,7.12741,0.30888,20,RV Uthappa,0,0,0,0,0,0,0,0,4,3,7,4,3,7,0,148,9,1,1,3,0.117647,22.1471,89.0071,34,0
Australia,228,239.627,7.69737,0.372807,232.079,7.23246,0.337719,20,AC Gilchrist,0,0,0,0,0,0,0,0,12,8,20,12,8,20,149,149,0,0,1,4.3,0.275,31.425,96.1009,40,0
Australia,228,239.627,7.69737,0.372807,232.079,7.23246,0.337719,20,ML Hayden,0,0,0,0,0,0,0,0,12,8,20,12,8,20,149,149,0,0,1,6.37838,0.378378,50.6757,83.3333,37,4
New Zealand,184,233.745,7.39674,0.36413,227.951,7.30435,0.353261,21,L Vincent,0,0,0,0,0,0,0,0,4,8,12,4,8,12,0,238,4,0,1,3.125,0.25,27.8125,67.5266,16,4
New Zealand,184,233.745,7.39674,0.36413,227.951,7.30435,0.353261,21,BB McCullum,0,0,0,0,0,0,0,0,4,8,12,4,8,12,0,238,4,0,1,3.98611,0.201389,29.9028,98.4004,144,0
New Zealand,184,233.745,7.39674,0.36413,227.951,7.30435,0.353261,21,JM How,0,0,0,0,0,0,0,0,4,8,12,4,8,12,0,238,4,0,1,3.34615,0.192308,29.9231,64.9416,26,4
South Africa,190,234.274,7.4,0.373684,232.363,7.33158,0.342105,21,GC Smith,0,0,0,0,0,0,0,0,22,10,32,22,10,32,239,242,1,1,1,3.97,0.29,33.57,79.6819,100,4
South Africa,190,234.274,7.4,0.373684,232.363,7.33158,0.342105,21,HH Gibbs,0,0,0,0,0,0,0,0,22,10,32,22,10,32,239,242,1,1,1,4.61538,0.307692,35.6923,83.4157,52,4
South Africa,190,234.274,7.4,0.373684,232.363,7.33158,0.342105,22,HH Gibbs,0,0,0,0,0,0,0,0,12,8,20,12,8,20,0,233,5,0,1,4.61538,0.307692,35.6923,83.4157,52,4
South Africa,190,234.274,7.4,0.373684,232.363,7.33158,0.342105,22,GC Smith,0,0,0,0,0,0,0,0,12,8,20,12,8,20,0,233,5,0,1,3.97,0.29,33.57,79.6819,100,4
South Africa,190,234.274,7.4,0.373684,232.363,7.33158,0.342105,22,JH Kallis,0,0,0,0,0,0,0,0,12,8,20,12,8,20,0,233,5,0,1,3.58621,0.356322,37.2644,76.4442,87,4
Pakistan,211,222.621,7.38389,0.393365,235.517,7.54976,0.336493,22,Imran Nazir,0,0,0,0,0,0,0,0,28,2,30,28,2,30,234,219,1,1,1,4.66667,0.133333,29,96.0265,15,0
Pakistan,211,222.621,7.38389,0.393365,235.517,7.54976,0.336493,22,Kamran Akmal,0,0,0,0,0,0,0,0,28,2,30,28,2,30,234,219,1,1,1,3.01124,0.11236,23.0787,81.4433,89,4
Pakistan,211,222.621,7.38389,0.393365,235.517,7.54976,0.336493,22,Younis Khan,0,0,0,0,0,0,0,0,28,2,30,28,2,30,234,219,1,1,1,2.64655,0.215517,28.5,73.2713,116,4
Zimbabwe,142,212.077,7.5,0.380282,227.704,6.97887,0.316901,23,H Masakadza,0,0,0,0,0,0,0,0,8,2,10,8,2,10,0,247,0,1,1,3.11215,0.186916,26.972,70.0485,107,4
Zimbabwe,142,212.077,7.5,0.380282,227.704,6.97887,0.316901,23,V Sibanda,0,0,0,0,0,0,0,0,8,2,10,8,2,10,0,247,0,1,1,2.9697,0.181818,23.5152,63.5545,66,1
South Africa,190,234.274,7.4,0.373684,232.363,7.33158,0.342105,23,GC Smith,0,0,0,0,0,0,0,0,8,9,17,8,9,17,248,251,2,0,1,3.97,0.29,33.57,79.6819,100,4
South Africa,190,234.274,7.4,0.373684,232.363,7.33158,0.342105,23,HH Gibbs,0,0,0,0,0,0,0,0,8,9,17,8,9,17,248,251,2,0,1,4.61538,0.307692,35.6923,83.4157,52,4
Australia,228,239.627,7.69737,0.372807,232.079,7.23246,0.337719,24,SE Marsh,0,0,0,0,0,0,0,0,16,13,29,16,13,29,0,273,2,0,1,3.66667,0.291667,35.5417,74.7918,48,4
Australia,228,239.627,7.69737,0.372807,232.079,7.23246,0.337719,24,SR Watson,0,0,0,0,0,0,0,0,16,13,29,16,13,29,0,273,2,0,1,4.71318,0.286822,37.7907,90.0943,129,4
West Indies,176,217.33,7.15909,0.3125,225.278,7.57386,0.380682,24,XM Marshall,0,0,0,0,0,0,0,0,4,8,12,4,8,12,274,189,1,1,1,1.5,0,10.5,58.3333,8,3
West Indies,176,217.33,7.15909,0.3125,225.278,7.57386,0.380682,24,CH Gayle,0,0,0,0,0,0,0,0,4,8,12,4,8,12,274,189,1,1,1,4.58621,0.206897,31.1293,89.4255,116,4
West Indies,176,217.33,7.15909,0.3125,225.278,7.57386,0.380682,24,RR Sarwan,0,0,0,0,0,0,0,0,4,8,12,4,8,12,274,189,1,1,1,2.8254,0.222222,29.1429,69.1005,63,4
Australia,228,239.627,7.69737,0.372807,232.079,7.23246,0.337719,27,SE Marsh,0,0,0,0,0,0,0,0,8,12,20,8,12,20,0,254,10,1,1,3.66667,0.291667,35.5417,74.7918,48,4
Australia,228,239.627,7.69737,0.372807,232.079,7.23246,0.337719,27,JR Hopes,0,0,0,0,0,0,0,0,8,12,20,8,12,20,0,254,10,1,1,2.09259,0.0555556,21.2778,91.4809,54,0
Bangladesh,160,218.438,7.70625,0.4,211.106,7.05,0.325,27,Tamim Iqbal,0,0,0,0,0,0,0,0,12,6,18,12,6,18,255,74,1,0,1,4.05344,0.274809,31.8015,76.8068,131,4
Bangladesh,160,218.438,7.70625,0.4,211.106,7.05,0.325,27,Mehrab Hossain jnr,0,0,0,0,0,0,0,0,12,6,18,12,6,18,255,74,1,0,1,1.7,0.1,18.3,42.4594,10,3
Bangladesh,160,218.438,7.70625,0.4,211.106,7.05,0.325,27,Mohammad Ashraful,0,0,0,0,0,0,0,0,12,6,18,12,6,18,255,74,1,0,1,2.17722,0.113924,19.4557,63.9085,79,1
Bangladesh,160,218.438,7.70625,0.4,211.106,7.05,0.325,28,Tamim Iqbal,0,0,0,0,0,0,0,0,4,11,15,4,11,15,0,210,0,0,1,4.05344,0.274809,31.8015,76.8068,131,4
Bangladesh,160,218.438,7.70625,0.4,211.106,7.05,0.325,28,Junaid Siddique,0,0,0,0,0,0,0,0,4,11,15,4,11,15,0,210,0,0,1,2.16279,0.116279,20.0233,68.225,43,1
Bangladesh,160,218.438,7.70625,0.4,211.106,7.05,0.325,28,Aftab Ahmed,0,0,0,0,0,0,0,0,4,11,15,4,11,15,0,210,0,0,1,2.44118,0.0882353,19.1471,73.8095,34,1
Bangladesh,160,218.438,7.70625,0.4,211.106,7.05,0.325,28,Mohammad Ashraful,0,0,0,0,0,0,0,0,4,11,15,4,11,15,0,210,0,0,1,2.17722,0.113924,19.4557,63.9085,79,1
Bangladesh,160,218.438,7.70625,0.4,211.106,7.05,0.325,28,Shakib Al Hasan,0,0,0,0,0,0,0,0,4,11,15,4,11,15,0,210,0,0,1,2.86992,0.252033,29.9106,79.0163,123,4
Pakistan,211,222.621,7.38389,0.393365,235.517,7.54976,0.336493,28,Salman Butt,0,0,0,0,0,0,0,0,12,10,22,12,10,22,211,212,2,1,1,5.4359,0.384615,42.3846,78.8645,39,4
Pakistan,211,222.621,7.38389,0.393365,235.517,7.54976,0.336493,28,Kamran Akmal,0,0,0,0,0,0,0,0,12,10,22,12,10,22,211,212,2,1,1,3.01124,0.11236,23.0787,81.4433,89,4
England,221,237.176,7.17647,0.289593,230.633,7.45701,0.384615,29,AJ Strauss,0,0,0,0,0,0,0,0,12,4,16,12,4,16,0,299,0,1,1,3.93243,0.27027,33.9054,79.8028,74,4
England,221,237.176,7.17647,0.289593,230.633,7.45701,0.384615,29,JL Denly,0,0,0,0,0,0,0,0,12,4,16,12,4,16,0,299,0,1,1,3.55556,0.222222,29.3333,63.1579,9,4
Australia,228,239.627,7.69737,0.372807,232.079,7.23246,0.337719,29,SR Watson,0,0,0,0,0,0,0,0,16,8,24,16,8,24,300,302,0,0,1,4.71318,0.286822,37.7907,90.0943,129,4
Australia,228,239.627,7.69737,0.372807,232.079,7.23246,0.337719,29,TD Paine,0,0,0,0,0,0,0,0,16,8,24,16,8,24,300,302,0,0,1,3.3913,0.217391,27.6522,65.7704,23,4
Australia,228,239.627,7.69737,0.372807,232.079,7.23246,0.337719,30,SE Marsh,0,0,0,0,0,0,0,0,12,5,17,12,5,17,0,249,4,1,1,3.66667,0.291667,35.5417,74.7918,48,4
Australia,228,239.627,7.69737,0.372807,232.079,7.23246,0.337719,30,DA Warner,0,0,0,0,0,0,0,0,12,5,17,12,5,17,0,249,4,1,1,4.20312,0.265625,35.2031,87.7336,64,4
Australia,228,239.627,7.69737,0.372807,232.079,7.23246,0.337719,30,RT Ponting,0,0,0,0,0,0,0,0,12,5,17,12,5,17,0,249,4,1,1,4.17431,0.33945,38.1009,80.8606,109,4
South Africa,190,234.274,7.4,0.373684,232.363,7.33158,0.342105,30,HH Gibbs,0,0,0,0,0,0,0,0,0,14,14,0,14,14,250,244,0,0,1,4.61538,0.307692,35.6923,83.4157,52,4
South Africa,190,234.274,7.4,0.373684,232.363,7.33158,0.342105,30,HM Amla,0,0,0,0,0,0,0,0,0,14,14,0,14,14,250,244,0,0,1,5.20168,0.403361,48.7899,86.9292,119,4
England,221,237.176,7.17647,0.289593,230.633,7.45701,0.384615,31,AJ Strauss,0,0,0,0,0,0,0,0,4,6,10,4,6,10,0,117,5,0,1,3.93243,0.27027,33.9054,79.8028,74,4
England,221,237.176,7.17647,0.289593,230.633,7.45701,0.384615,31,RS Bopara,0,0,0,0,0,0,0,0,4,6,10,4,6,10,0,117,5,0,1,2.22115,0.144231,25.1538,75.9361,104,4
West Indies,176,217.33,7.15909,0.3125,225.278,7.57386,0.380682,31,CH Gayle,0,0,0,0,0,0,0,0,30,8,38,30,8,38,118,117,9,1,1,4.58621,0.206897,31.1293,89.4255,116,4
West Indies,176,217.33,7.15909,0.3125,225.278,7.57386,0.380682,31,LMP Simmons,0,0,0,0,0,0,0,0,30,8,38,30,8,38,118,117,9,1,1,3.3125,0.28125,30.5938,71.4338,64,4
India,259,242.378,7.15058,0.339768,244.568,7.12741,0.30888,32,V Sehwag,0,0,0,0,0,0,0,0,20,8,28,20,8,28,0,273,1,0,1,5.88636,0.238636,38.8295,108.649,88,0
India,259,242.378,7.15058,0.339768,244.568,7.12741,0.30888,32,SR Tendulkar,0,0,0,0,0,0,0,0,20,8,28,20,8,28,0,273,1,0,1,5.89773,0.363636,45.6023,84.5376,88,4
New Zealand,184,233.745,7.39674,0.36413,227.951,7.30435,0.353261,32,JD Ryder,0,0,0,0,0,0,0,0,4,4,8,4,4,8,274,162,1,1,1,4.88571,0.257143,34.4,97.2536,35,0
New Zealand,184,233.745,7.39674,0.36413,227.951,7.30435,0.353261,32,BB McCullum,0,0,0,0,0,0,0,0,4,4,8,4,4,8,274,162,1,1,1,3.98611,0.201389,29.9028,98.4004,144,0
New Zealand,184,233.745,7.39674,0.36413,227.951,7.30435,0.353261,32,MJ Guptill,0,0,0,0,0,0,0,0,4,4,8,4,4,8,274,162,1,1,1,4.8087,0.313043,38.1217,82.7482,115,4
Sri Lanka,244,223.373,7.09016,0.344262,227.578,7.47541,0.385246,33,WU Tharanga,0,0,0,0,0,0,0,0,4,2,6,4,2,6,0,152,2,0,1,3.93985,0.263158,32.9699,71.6035,133,4
Sri Lanka,244,223.373,7.09016,0.344262,227.578,7.47541,0.385246,33,DPMD Jayawardene,0,0,0,0,0,0,0,0,4,2,6,4,2,6,0,152,2,0,1,3.20833,0.244792,31.6979,79.1109,192,4
Sri Lanka,244,223.373,7.09016,0.344262,227.578,7.47541,0.385246,33,KC Sangakkara,0,0,0,0,0,0,0,0,4,2,6,4,2,6,0,152,2,0,1,4.33659,0.360976,41.9854,80.6276,205,4
Zimbabwe,142,212.077,7.5,0.380282,227.704,6.97887,0.316901,33,H Masakadza,0,0,0,0,0,0,0,0,0,14,14,0,14,14,153,133,11,1,1,3.11215,0.186916,26.972,70.0485,107,4
Zimbabwe,142,212.077,7.5,0.380282,227.704,6.97887,0.316901,33,V Sibanda,0,0,0,0,0,0,0,0,0,14,14,0,14,14,153,133,11,1,1,2.9697,0.181818,23.5152,63.5545,66,1
Zimbabwe,142,212.077,7.5,0.380282,227.704,6.97887,0.316901,33,T Taibu,0,0,0,0,0,0,0,0,0,14,14,0,14,14,153,133,11,1,1,2.36364,0.254545,29.4,71.0145,55,4
South Africa,190,234.274,7.4,0.373684,232.363,7.33158,0.342105,35,HM Amla,0,0,0,0,0,0,0,0,16,13,29,16,13,29,0,354,1,1,1,5.20168,0.403361,48.7899,86.9292,119,4
South Africa,190,234.274,7.4,0.373684,232.363,7.33158,0.342105,35,GC Smith,0,0,0,0,0,0,0,0,16,13,29,16,13,29,0,354,1,1,1,3.97,0.29,33.57,79.6819,100,4
England,221,237.176,7.17647,0.289593,230.633,7.45701,0.384615,35,AJ Strauss,0,0,0,0,0,0,0,0,30,10,40,30,10,40,355,242,1,0,1,3.93243,0.27027,33.9054,79.8028,74,4
England,221,237.176,7.17647,0.289593,230.633,7.45701,0.384615,35,LJ Wright,0,0,0,0,0,0,0,0,30,10,40,30,10,40,355,242,1,0,1,1.92105,0.0263158,17.2368,81.875,38,1
Bangladesh,160,218.438,7.70625,0.4,211.106,7.05,0.325,36,Tamim Iqbal,0,0,0,0,0,0,0,0,12,5,17,12,5,17,0,246,7,0,1,4.05344,0.274809,31.8015,76.8068,131,4
Bangladesh,160,218.438,7.70625,0.4,211.106,7.05,0.325,36,Mohammad Ashraful,0,0,0,0,0,0,0,0,12,5,17,12,5,17,0,246,7,0,1,2.17722,0.113924,19.4557,63.9085,79,1
Bangladesh,160,218.438,7.70625,0.4,211.106,7.05,0.325,36,Junaid Siddique,0,0,0,0,0,0,0,0,12,5,17,12,5,17,0,246,7,0,1,2.16279,0.116279,20.0233,68.225,43,1
West Indies,176,217.33,7.15909,0.3125,225.278,7.57386,0.380682,36,DM Richards,0,0,0,0,0,0,0,0,4,7,11,4,7,11,247,194,1,1,1,3.42857,0.285714,25.5714,68.8462,7,4
West Indies,176,217.33,7.15909,0.3125,225.278,7.57386,0.380682,36,ADS Fletcher,0,0,0,0,0,0,0,0,4,7,11,4,7,11,247,194,1,1,1,1.8125,0.125,13.5,62.6087,16,1
West Indies,176,217.33,7.15909,0.3125,225.278,7.57386,0.380682,36,DS Smith,0,0,0,0,0,0,0,0,4,7,11,4,7,11,247,194,1,1,1,2.61765,0.147059,23.5588,71.2,34,4
West Indies,176,217.33,7.15909,0.3125,225.278,7.57386,0.380682,36,FL Reifer,0,0,0,0,0,0,0,0,4,7,11,4,7,11,247,194,1,1,1,1.16667,0,14.3333,45.2632,6,3
New Zealand,184,233.745,7.39674,0.36413,227.951,7.30435,0.353261,37,BB McCullum,0,0,0,0,0,0,0,0,8,5,13,8,5,13,0,155,1,0,1,3.98611,0.201389,29.9028,98.4004,144,0
New Zealand,184,233.745,7.39674,0.36413,227.951,7.30435,0.353261,37,JD Ryder,0,0,0,0,0,0,0,0,8,5,13,8,5,13,0,155,1,0,1,4.88571,0.257143,34.4,97.2536,35,0
New Zealand,184,233.745,7.39674,0.36413,227.951,7.30435,0.353261,37,MJ Guptill,0,0,0,0,0,0,0,0,8,5,13,8,5,13,0,155,1,0,1,4.8087,0.313043,38.1217,82.7482,115,4
New Zealand,184,233.745,7.39674,0.36413,227.951,7.30435,0.353261,37,LRPL Taylor,0,0,0,0,0,0,0,0,8,5,13,8,5,13,0,155,1,0,1,3.68382,0.301471,36.7206,79.3959,136,4
India,259,242.378,7.15058,0.339768,244.568,7.12741,0.30888,37,KD Karthik,0,0,0,0,0,0,0,0,0,15,15,0,15,15,156,156,1,0,1,2.46429,0.107143,21.6786,71.8769,56,1
India,259,242.378,7.15058,0.339768,244.568,7.12741,0.30888,37,SR Tendulkar,0,0,0,0,0,0,0,0,0,15,15,0,15,15,156,156,1,0,1,5.89773,0.363636,45.6023,84.5376,88,4
India,259,242.378,7.15058,0.339768,244.568,7.12741,0.30888,37,R Dravid,0,0,0,0,0,0,0,0,0,15,15,0,15,15,156,156,1,0,1,2.83721,0.255814,29.8605,72.7067,43,4
Pakistan,211,222.621,7.38389,0.393365,235.517,7.54976,0.336493,38,Salman Butt,0,0,0,0,0,0,0,0,0,4,4,0,4,4,0,212,0,0,1,5.4359,0.384615,42.3846,78.8645,39,4
Pakistan,211,222.621,7.38389,0.393365,235.517,7.54976,0.336493,38,Younis Khan,0,0,0,0,0,0,0,0,0,4,4,0,4,4,0,212,0,0,1,2.64655,0.215517,28.5,73.2713,116,4
Pakistan,211,222.621,7.38389,0.393365,235.517,7.54976,0.336493,38,Khalid Latif,0,0,0,0,0,0,0,0,0,4,4,0,4,4,0,212,0,0,1,2.6,0.2,29.4,63.0901,5,4
Pakistan,211,222.621,7.38389,0.393365,235.517,7.54976,0.336493,38,Shoaib Malik,0,0,0,0,0,0,0,0,0,4,4,0,4,4,0,212,0,0,1,2.77551,0.193878,28.7041,81.4418,98,4
Australia,228,239.627,7.69737,0.372807,232.079,7.23246,0.337719,38,SE Marsh,0,0,0,0,0,0,0,0,8,12,20,8,12,20,213,213,1,1,1,3.66667,0.291667,35.5417,74.7918,48,4
Australia,228,239.627,7.69737,0.372807,232.079,7.23246,0.337719,38,BJ Haddin,0,0,0,0,0,0,0,0,8,12,20,8,12,20,213,213,1,1,1,3.14737,0.147368,26.7789,81.382,95,4
Sri Lanka,244,223.373,7.09016,0.344262,227.578,7.47541,0.385246,39,TM Dilshan,0,0,0,0,0,0,0,0,4,8,12,4,8,12,0,212,5,0,1,4.60199,0.273632,38.3632,86.0219,201,4
Sri Lanka,244,223.373,7.09016,0.344262,227.578,7.47541,0.385246,39,ST Jayasuriya,0,0,0,0,0,0,0,0,4,8,12,4,8,12,0,212,5,0,1,4.91549,0.211268,33.9859,98.4898,71,0
Sri Lanka,244,223.373,7.09016,0.344262,227.578,7.47541,0.385246,39,KC Sangakkara,0,0,0,0,0,0,0,0,4,8,12,4,8,12,0,212,5,0,1,4.33659,0.360976,41.9854,80.6276,205,4
Sri Lanka,244,223.373,7.09016,0.344262,227.578,7.47541,0.385246,39,DPMD Jayawardene,0,0,0,0,0,0,0,0,4,8,12,4,8,12,0,212,5,0,1,3.20833,0.244792,31.6979,79.1109,192,4
England,221,237.176,7.17647,0.289593,230.633,7.45701,0.384615,39,AJ Strauss,0,0,0,0,0,0,0,0,8,6,14,8,6,14,213,213,1,0,1,3.93243,0.27027,33.9054,79.8028,74,4
England,221,237.176,7.17647,0.289593,230.633,7.45701,0.384615,39,JL Denly,0,0,0,0,0,0,0,0,8,6,14,8,6,14,213,213,1,0,1,3.55556,0.222222,29.3333,63.1579,9,4
England,221,237.176,7.17647,0.289593,230.633,7.45701,0.384615,39,OA Shah,0,0,0,0,0,0,0,0,8,6,14,8,6,14,213,213,1,0,1,3.13043,0.23913,32.6739,81.1994,46,4
New Zealand,184,233.745,7.39674,0.36413,227.951,7.30435,0.353261,40,BB McCullum,0,0,0,0,0,0,0,0,0,4,4,0,4,4,0,200,3,0,1,3.98611,0.201389,29.9028,98.4004,144,0
New Zealand,184,233.745,7.39674,0.36413,227.951,7.30435,0.353261,40,AJ Redmond,0,0,0,0,0,0,0,0,0,4,4,0,4,4,0,200,3,0,1,3.16667,0.166667,25.3333,57.1429,6,3
New Zealand,184,233.745,7.39674,0.36413,227.951,7.30435,0.353261,40,MJ Guptill,0,0,0,0,0,0,0,0,0,4,4,0,4,4,0,200,3,0,1,4.8087,0.313043,38.1217,82.7482,115,4
Australia,228,239.627,7.69737,0.372807,232.079,7.23246,0.337719,40,SR Watson,0,0,0,0,0,0,0,0,4,4,8,4,4,8,201,206,3,0,1,4.71318,0.286822,37.7907,90.0943,129,4
Australia,228,239.627,7.69737,0.372807,232.079,7.23246,0.337719,40,TD Paine,0,0,0,0,0,0,0,0,4,4,8,4,4,8,201,206,3,0,1,3.3913,0.217391,27.6522,65.7704,23,4
Australia,228,239.627,7.69737,0.372807,232.079,7.23246,0.337719,40,RT Ponting,0,0,0,0,0,0,0,0,4,4,8,4,4,8,201,206,3,0,1,4.17431,0.33945,38.1009,80.8606,109,4
Australia,228,239.627,7.69737,0.372807,232.079,7.23246,0.337719,40,CL White,0,0,0,0,0,0,0,0,4,4,8,4,4,8,201,206,3,0,1,2.66176,0.191176,28.8235,80.1308,68,4
Zimbabwe,142,212.077,7.5,0.380282,227.704,6.97887,0.316901,41,H Masakadza,0,0,0,0,0,0,0,0,0,7,7,0,7,7,0,44,0,0,1,3.11215,0.186916,26.972,70.0485,107,4
Zimbabwe,142,212.077,7.5,0.380282,227.704,6.97887,0.316901,41,BRM Taylor,0,0,0,0,0,0,0,0,0,7,7,0,7,7,0,44,0,0,1,3.3,0.26,33.56,76.3421,100,4
Zimbabwe,142,212.077,7.5,0.380282,227.704,6.97887,0.316901,41,MA Vermeulen,0,0,0,0,0,0,0,0,0,7,7,0,7,7,0,44,0,0,1,1.85714,0.142857,20.2857,68.2692,7,1
Zimbabwe,142,212.077,7.5,0.380282,227.704,6.97887,0.316901,41,CK Coventry,0,0,0,0,0,0,0,0,0,7,7,0,7,7,0,44,0,0,1,3.33333,0.166667,29.3889,90.273,18,4
Zimbabwe,142,212.077,7.5,0.380282,227.704,6.97887,0.316901,41,MN Waller,0,0,0,0,0,0,0,0,0,7,7,0,7,7,0,44,0,0,1,2.07895,0.0789474,19.3684,68.9784,38,1
Bangladesh,160,218.438,7.70625,0.4,211.106,7.05,0.325,41,Tamim Iqbal,0,0,0,0,0,0,0,0,16,7,23,16,7,23,45,49,3,1,1,4.05344,0.274809,31.8015,76.8068,131,4
Bangladesh,160,218.438,7.70625,0.4,211.106,7.05,0.325,41,Junaid Siddique,0,0,0,0,0,0,0,0,16,7,23,16,7,23,45,49,3,1,1,2.16279,0.116279,20.0233,68.225,43,1
Australia,228,239.627,7.69737,0.372807,232.079,7.23246,0.337719,42,SR Watson,0,0,0,0,0,0,0,0,6,10,16,6,10,16,0,231,4,0,1,4.71318,0.286822,37.7907,90.0943,129,4
Australia,228,239.627,7.69737,0.372807,232.079,7.23246,0.337719,42,TD Paine,0,0,0,0,0,0,0,0,6,10,16,6,10,16,0,231,4,0,1,3.3913,0.217391,27.6522,65.7704,23,4
Ireland,55,219.527,7.65455,0.290909,202.727,7.56364,0.4,42,WTS Porterfield,0,0,0,0,0,0,0,0,28,12,40,28,12,40,232,192,6,1,1,2.6,0.142857,24.6857,56.2866,35,3
Ireland,55,219.527,7.65455,0.290909,202.727,7.56364,0.4,42,PR Stirling,0,0,0,0,0,0,0,0,28,12,40,28,12,40,232,192,6,1,1,3.47826,0.173913,24.2174,88.1329,23,0
Bangladesh,160,218.438,7.70625,0.4,211.106,7.05,0.325,43,Tamim Iqbal,0,0,0,0,0,0,0,0,4,7,11,4,7,11,0,260,3,1,1,4.05344,0.274809,31.8015,76.8068,131,4
Bangladesh,160,218.438,7.70625,0.4,211.106,7.05,0.325,43,Imrul Kayes,0,0,0,0,0,0,0,0,4,7,11,4,7,11,0,260,3,1,1,3,0.207547,26.2642,63.6488,53,4
England,221,237.176,7.17647,0.289593,230.633,7.45701,0.384615,43,AN Cook,0,0,0,0,0,0,0,0,16,8,24,16,8,24,261,261,0,0,1,4.17045,0.272727,35.75,75.5524,88,4
England,221,237.176,7.17647,0.289593,230.633,7.45701,0.384615,43,C Kieswetter,0,0,0,0,0,0,0,0,16,8,24,16,8,24,261,261,0,0,1,3.43243,0.135135,26.4324,88.0288,37,4
England,221,237.176,7.17647,0.289593,230.633,7.45701,0.384615,43,KP Pietersen,0,0,0,0,0,0,0,0,16,8,24,16,8,24,261,261,0,0,1,3.69892,0.236559,33.4946,82.2117,93,4
South Africa,190,234.274,7.4,0.373684,232.363,7.33158,0.342105,44,HM Amla,0,0,0,0,0,0,0,0,12,13,25,12,13,25,0,295,1,1,1,5.20168,0.403361,48.7899,86.9292,119,4
South Africa,190,234.274,7.4,0.373684,232.363,7.33158,0.342105,44,GC Smith,0,0,0,0,0,0,0,0,12,13,25,12,13,25,0,295,1,1,1,3.97,0.29,33.57,79.6819,100,4
Zimbabwe,142,212.077,7.5,0.380282,227.704,6.97887,0.316901,44,MA Vermeulen,0,0,0,0,0,0,0,0,0,11,11,0,11,11,296,250,0,0,1,1.85714,0.142857,20.2857,68.2692,7,1
Zimbabwe,142,212.077,7.5,0.380282,227.704,6.97887,0.316901,44,CJ Chibhabha,0,0,0,0,0,0,0,0,0,11,11,0,11,11,296,250,0,0,1,2.56716,0.149254,23.5373,64.7373,67,1
England,221,237.176,7.17647,0.289593,230.633,7.45701,0.384615,46,AJ Strauss,0,0,0,0,0,0,0,0,22,12,34,22,12,34,0,327,0,0,1,3.93243,0.27027,33.9054,79.8028,74,4
England,221,237.176,7.17647,0.289593,230.633,7.45701,0.384615,46,KP Pietersen,0,0,0,0,0,0,0,0,22,12,34,22,12,34,0,327,0,0,1,3.69892,0.236559,33.4946,82.2117,93,4
Ireland,55,219.527,7.65455,0.290909,202.727,7.56364,0.4,46,WTS Porterfield,0,0,0,0,0,0,0,0,18,4,22,18,4,22,328,329,4,0,1,2.6,0.142857,24.6857,56.2866,35,3
Ireland,55,219.527,7.65455,0.290909,202.727,7.56364,0.4,46,EC Joyce,0,0,0,0,0,0,0,0,18,4,22,18,4,22,328,329,4,0,1,3.08571,0.2,28.3429,68.6505,35,4
Ireland,55,219.527,7.65455,0.290909,202.727,7.56364,0.4,46,PR Stirling,0,0,0,0,0,0,0,0,18,4,22,18,4,22,328,329,4,0,1,3.47826,0.173913,24.2174,88.1329,23,0
Sri Lanka,244,223.373,7.09016,0.344262,227.578,7.47541,0.385246,47,WU Tharanga,0,0,0,0,0,0,0,0,34,7,41,34,7,41,0,327,0,1,1,3.93985,0.263158,32.9699,71.6035,133,4
Sri Lanka,244,223.373,7.09016,0.344262,227.578,7.47541,0.385246,47,TM Dilshan,0,0,0,0,0,0,0,0,34,7,41,34,7,41,0,327,0,1,1,4.60199,0.273632,38.3632,86.0219,201,4
Zimbabwe,142,212.077,7.5,0.380282,227.704,6.97887,0.316901,47,BRM Taylor,0,0,0,0,0,0,0,0,12,15,27,12,15,27,328,188,9,0,1,3.3,0.26,33.56,76.3421,100,4
Zimbabwe,142,212.077,7.5,0.380282,227.704,6.97887,0.316901,47,RW Chakabva,0,0,0,0,0,0,0,0,12,15,27,12,15,27,328,188,9,0,1,0.846154,0,13.2692,51.3393,26,3
England,221,237.176,7.17647,0.289593,230.633,7.45701,0.384615,48,AJ Strauss,0,0,0,0,0,0,0,0,12,6,18,12,6,18,0,243,0,0,1,3.93243,0.27027,33.9054,79.8028,74,4
England,221,237.176,7.17647,0.289593,230.633,7.45701,0.384615,48,MJ Prior,0,0,0,0,0,0,0,0,12,6,18,12,6,18,0,243,0,0,1,2.27083,0.0625,21.6875,76.4879,48,4
West Indies,176,217.33,7.15909,0.3125,225.278,7.57386,0.380682,48,DS Smith,0,0,0,0,0,0,0,0,34,11,45,34,11,45,244,225,5,0,1,2.61765,0.147059,23.5588,71.2,34,4
West Indies,176,217.33,7.15909,0.3125,225.278,7.57386,0.380682,48,CH Gayle,0,0,0,0,0,0,0,0,34,11,45,34,11,45,244,225,5,0,1,4.58621,0.206897,31.1293,89.4255,116,4
England,221,237.176,7.17647,0.289593,230.633,7.45701,0.384615,49,AJ Strauss,0,0,0,0,0,0,0,0,8,9,17,8,9,17,0,229,0,0,1,3.93243,0.27027,33.9054,79.8028,74,4
England,221,237.176,7.17647,0.289593,230.633,7.45701,0.384615,49,IR Bell,0,0,0,0,0,0,0,0,8,9,17,8,9,17,0,229,0,0,1,3.63433,0.246269,35.3806,75.6623,134,4
Sri Lanka,244,223.373,7.09016,0.344262,227.578,7.47541,0.385246,49,WU Tharanga,0,0,0,0,0,0,0,0,10,10,20,10,10,20,230,231,2,1,1,3.93985,0.263158,32.9699,71.6035,133,4
Sri Lanka,244,223.373,7.09016,0.344262,227.578,7.47541,0.385246,49,TM Dilshan,0,0,0,0,0,0,0,0,10,10,20,10,10,20,230,231,2,1,1,4.60199,0.273632,38.3632,86.0219,201,4
India,259,242.378,7.15058,0.339768,244.568,7.12741,0.30888,50,V Sehwag,0,0,0,0,0,0,0,0,12,6,18,12,6,18,0,245,1,0,1,5.88636,0.238636,38.8295,108.649,88,0
India,259,242.378,7.15058,0.339768,244.568,7.12741,0.30888,50,G Gambhir,0,0,0,0,0,0,0,0,12,6,18,12,6,18,0,245,1,0,1,3.99145,0.333333,37.4701,84.1944,117,4
India,259,242.378,7.15058,0.339768,244.568,7.12741,0.30888,50,V Kohli,0,0,0,0,0,0,0,0,12,6,18,12,6,18,0,245,1,0,1,4.66456,0.379747,44.9937,88.3325,158,4
India,259,242.378,7.15058,0.339768,244.568,7.12741,0.30888,50,Yuvraj Singh,0,0,0,0,0,0,0,0,12,6,18,12,6,18,0,245,1,0,1,4.05833,0.258333,32.525,83.8093,120,4
India,259,242.378,7.15058,0.339768,244.568,7.12741,0.30888,50,MS Dhoni,0,0,0,0,0,0,0,0,12,6,18,12,6,18,0,245,1,0,1,3.47872,0.292553,36.7713,84.1612,188,4
Sri Lanka,244,223.373,7.09016,0.344262,227.578,7.47541,0.385246,50,WU Tharanga,0,0,0,0,0,0,0,0,20,8,28,20,8,28,246,249,1,0,1,3.93985,0.263158,32.9699,71.6035,133,4
Sri Lanka,244,223.373,7.09016,0.344262,227.578,7.47541,0.385246,50,KC Sangakkara,0,0,0,0,0,0,0,0,20,8,28,20,8,28,246,249,1,0,1,4.33659,0.360976,41.9854,80.6276,205,4
Sri Lanka,244,223.373,7.09016,0.344262,227.578,7.47541,0.385246,50,TM Dilshan,0,0,0,0,0,0,0,0,20,8,28,20,8,28,246,249,1,0,1,4.60199,0.273632,38.3632,86.0219,201,4
West Indies,176,217.33,7.15909,0.3125,225.278,7.57386,0.380682,51,DM Richards,0,0,0,0,0,0,0,0,14,8,22,14,8,22,0,252,1,1,1,3.42857,0.285714,25.5714,68.8462,7,4
West Indies,176,217.33,7.15909,0.3125,225.278,7.57386,0.380682,51,CH Gayle,0,0,0,0,0,0,0,0,14,8,22,14,8,22,0,252,1,1,1,4.58621,0.206897,31.1293,89.4255,116,4
West Indies,176,217.33,7.15909,0.3125,225.278,7.57386,0.380682,51,S Chanderpaul,0,0,0,0,0,0,0,0,14,8,22,14,8,22,0,252,1,1,1,3.57143,0.396825,40.8254,68.0783,63,4
South Africa,190,234.274,7.4,0.373684,232.363,7.33158,0.342105,51,HM Amla,0,0,0,0,0,0,0,0,4,7,11,4,7,11,253,255,3,0,1,5.20168,0.403361,48.7899,86.9292,119,4
South Africa,190,234.274,7.4,0.373684,232.363,7.33158,0.342105,51,GC Smith,0,0,0,0,0,0,0,0,4,7,11,4,7,11,253,255,3,0,1,3.97,0.29,33.57,79.6819,100,4
England,221,237.176,7.17647,0.289593,230.633,7.45701,0.384615,52,AJ Strauss,0,0,0,0,0,0,0,0,16,11,27,16,11,27,0,299,5,0,1,3.93243,0.27027,33.9054,79.8028,74,4
England,221,237.176,7.17647,0.289593,230.633,7.45701,0.384615,52,MJ Prior,0,0,0,0,0,0,0,0,16,11,27,16,11,27,0,299,5,0,1,2.27083,0.0625,21.6875,76.4879,48,4
England,221,237.176,7.17647,0.289593,230.633,7.45701,0.384615,52,IJL Trott,0,0,0,0,0,0,0,0,16,11,27,16,11,27,0,299,5,0,1,3.3871,0.403226,43.7903,75.2494,62,4
Australia,228,239.627,7.69737,0.372807,232.079,7.23246,0.337719,52,SR Watson,0,0,0,0,0,0,0,0,16,10,26,16,10,26,300,278,2,1,1,4.71318,0.286822,37.7907,90.0943,129,4
Australia,228,239.627,7.69737,0.372807,232.079,7.23246,0.337719,52,BJ Haddin,0,0,0,0,0,0,0,0,16,10,26,16,10,26,300,278,2,1,1,3.14737,0.147368,26.7789,81.382,95,4
Zimbabwe,142,212.077,7.5,0.380282,227.704,6.97887,0.316901,53,H Masakadza,0,0,0,0,0,0,0,0,4,12,16,4,12,16,0,118,2,1,1,3.11215,0.186916,26.972,70.0485,107,4
Zimbabwe,142,212.077,7.5,0.380282,227.704,6.97887,0.316901,53,BRM Taylor,0,0,0,0,0,0,0,0,4,12,16,4,12,16,0,118,2,1,1,3.3,0.26,33.56,76.3421,100,4
Zimbabwe,142,212.077,7.5,0.380282,227.704,6.97887,0.316901,53,GA Lamb,0,0,0,0,0,0,0,0,4,12,16,4,12,16,0,118,2,1,1,0.333333,0,14.0833,46.1749,12,3
Sri Lanka,244,223.373,7.09016,0.344262,227.578,7.47541,0.385246,53,WU Tharanga,0,0,0,0,0,0,0,0,24,8,32,24,8,32,119,119,5,0,1,3.93985,0.263158,32.9699,71.6035,133,4
Sri Lanka,244,223.373,7.09016,0.344262,227.578,7.47541,0.385246,53,TM Dilshan,0,0,0,0,0,0,0,0,24,8,32,24,8,32,119,119,5,0,1,4.60199,0.273632,38.3632,86.0219,201,4
India,259,242.378,7.15058,0.339768,244.568,7.12741,0.30888,54,G Gambhir,0,0,0,0,0,0,0,0,8,8,16,8,8,16,0,209,2,0,1,3.99145,0.333333,37.4701,84.1944,117,4
India,259,242.378,7.15058,0.339768,244.568,7.12741,0.30888,54,KD Karthik,0,0,0,0,0,0,0,0,8,8,16,8,8,16,0,209,2,0,1,2.46429,0.107143,21.6786,71.8769,56,1
Sri Lanka,244,223.373,7.09016,0.344262,227.578,7.47541,0.385246,54,WU Tharanga,0,0,0,0,0,0,0,0,22,6,28,22,6,28,210,211,5,1,1,3.93985,0.263158,32.9699,71.6035,133,4
Sri Lanka,244,223.373,7.09016,0.344262,227.578,7.47541,0.385246,54,TM Dilshan,0,0,0,0,0,0,0,0,22,6,28,22,6,28,210,211,5,1,1,4.60199,0.273632,38.3632,86.0219,201,4
South Africa,190,234.274,7.4,0.373684,232.363,7.33158,0.342105,55,HM Amla,0,0,0,0,0,0,0,0,8,8,16,8,8,16,0,228,0,0,1,5.20168,0.403361,48.7899,86.9292,119,4
South Africa,190,234.274,7.4,0.373684,232.363,7.33158,0.342105,55,JH Kallis,0,0,0,0,0,0,0,0,8,8,16,8,8,16,0,228,0,0,1,3.58621,0.356322,37.2644,76.4442,87,4
South Africa,190,234.274,7.4,0.373684,232.363,7.33158,0.342105,55,CA Ingram,0,0,0,0,0,0,0,0,8,8,16,8,8,16,0,228,0,0,1,3,0.178571,27.1786,81.3904,28,4
South Africa,190,234.274,7.4,0.373684,232.363,7.33158,0.342105,55,AB de Villiers,0,0,0,0,0,0,0,0,8,8,16,8,8,16,0,228,0,0,1,5.04969,0.403727,47.2174,98.8428,161,4
Pakistan,211,222.621,7.38389,0.393365,235.517,7.54976,0.336493,55,Imran Farhat,0,0,0,0,0,0,0,0,0,9,9,0,9,9,229,226,2,0,1,3.03333,0.266667,27.0333,62.9658,30,4
Pakistan,211,222.621,7.38389,0.393365,235.517,7.54976,0.336493,55,Mohammad Hafeez,0,0,0,0,0,0,0,0,0,9,9,0,9,9,229,226,2,0,1,4.04511,0.255639,34.3534,78.0625,133,4
South Africa,190,234.274,7.4,0.373684,232.363,7.33158,0.342105,56,GC Smith,0,0,0,0,0,0,0,0,20,7,27,20,7,27,0,250,5,1,1,3.97,0.29,33.57,79.6819,100,4
South Africa,190,234.274,7.4,0.373684,232.363,7.33158,0.342105,56,HM Amla,0,0,0,0,0,0,0,0,20,7,27,20,7,27,0,250,5,1,1,5.20168,0.403361,48.7899,86.9292,119,4
South Africa,190,234.274,7.4,0.373684,232.363,7.33158,0.342105,56,MN van Wyk,0,0,0,0,0,0,0,0,20,7,27,20,7,27,0,250,5,1,1,3.33333,0.266667,27.2,66.9951,15,4
India,259,242.378,7.15058,0.339768,244.568,7.12741,0.30888,56,PA Patel,0,0,0,0,0,0,0,0,12,11,23,12,11,23,251,234,1,0,1,2.65217,0.130435,22.1304,79.4072,23,4
India,259,242.378,7.15058,0.339768,244.568,7.12741,0.30888,56,RG Sharma,0,0,0,0,0,0,0,0,12,11,23,12,11,23,251,234,1,0,1,3.82836,0.268657,35.9179,83.083,134,4
India,259,242.378,7.15058,0.339768,244.568,7.12741,0.30888,56,V Kohli,0,0,0,0,0,0,0,0,12,11,23,12,11,23,251,234,1,0,1,4.66456,0.379747,44.9937,88.3325,158,4
New Zealand,184,233.745,7.39674,0.36413,227.951,7.30435,0.353261,57,MJ Guptill,0,0,0,0,0,0,0,0,20,4,24,20,4,24,0,103,0,0,1,4.8087,0.313043,38.1217,82.7482,115,4
New Zealand,184,233.745,7.39674,0.36413,227.951,7.30435,0.353261,57,JM How,0,0,0,0,0,0,0,0,20,4,24,20,4,24,0,103,0,0,1,3.34615,0.192308,29.9231,64.9416,26,4
New Zealand,184,233.745,7.39674,0.36413,227.951,7.30435,0.353261,57,BB McCullum,0,0,0,0,0,0,0,0,20,4,24,20,4,24,0,103,0,0,1,3.98611,0.201389,29.9028,98.4004,144,0
New Zealand,184,233.745,7.39674,0.36413,227.951,7.30435,0.353261,57,LRPL Taylor,0,0,0,0,0,0,0,0,20,4,24,20,4,24,0,103,0,0,1,3.68382,0.301471,36.7206,79.3959,136,4
India,259,242.378,7.15058,0.339768,244.568,7.12741,0.30888,57,G Gambhir,0,0,0,0,0,0,0,0,4,10,14,4,10,14,104,107,5,1,1,3.99145,0.333333,37.4701,84.1944,117,4
India,259,242.378,7.15058,0.339768,244.568,7.12741,0.30888,57,V Kohli,0,0,0,0,0,0,0,0,4,10,14,4,10,14,104,107,5,1,1,4.66456,0.379747,44.9937,88.3325,158,4
India,259,242.378,7.15058,0.339768,244.568,7.12741,0.30888,57,PA Patel,0,0,0,0,0,0,0,0,4,10,14,4,10,14,104,107,5,1,1,2.65217,0.130435,22.1304,79.4072,23,4
India,259,242.378,7.15058,0.339768,244.568,7.12741,0.30888,57,Yuvraj Singh,0,0,0,0,0,0,0,0,4,10,14,4,10,14,104,107,5,1,1,4.05833,0.258333,32.525,83.8093,120,4
England,221,237.176,7.17647,0.289593,230.633,7.45701,0.384615,58,C Kieswetter,0,0,0,0,0,0,0,0,18,9,27,18,9,27,0,268,11,1,1,3.43243,0.135135,26.4324,88.0288,37,4
England,221,237.176,7.17647,0.289593,230.633,7.45701,0.384615,58,AN Cook,0,0,0,0,0,0,0,0,18,9,27,18,9,27,0,268,11,1,1,4.17045,0.272727,35.75,75.5524,88,4
Sri Lanka,244,223.373,7.09016,0.344262,227.578,7.47541,0.385246,58,FDM Karunaratne,0,0,0,0,0,0,0,0,8,14,22,8,14,22,269,252,0,0,1,0.8,0,10.7,64.8485,10,1
Sri Lanka,244,223.373,7.09016,0.344262,227.578,7.47541,0.385246,58,TM Dilshan,0,0,0,0,0,0,0,0,8,14,22,8,14,22,269,252,0,0,1,4.60199,0.273632,38.3632,86.0219,201,4
Sri Lanka,244,223.373,7.09016,0.344262,227.578,7.47541,0.385246,58,KC Sangakkara,0,0,0,0,0,0,0,0,8,14,22,8,14,22,269,252,0,0,1,4.33659,0.360976,41.9854,80.6276,205,4
Sri Lanka,244,223.373,7.09016,0.344262,227.578,7.47541,0.385246,58,DPMD Jayawardene,0,0,0,0,0,0,0,0,8,14,22,8,14,22,269,252,0,0,1,3.20833,0.244792,31.6979,79.1109,192,4
Zimbabwe,142,212.077,7.5,0.380282,227.704,6.97887,0.316901,59,BRM Taylor,0,0,0,0,0,0,0,0,16,6,22,16,6,22,0,209,6,0,1,3.3,0.26,33.56,76.3421,100,4
Zimbabwe,142,212.077,7.5,0.380282,227.704,6.97887,0.316901,59,CJ Chibhabha,0,0,0,0,0,0,0,0,16,6,22,16,6,22,0,209,6,0,1,2.56716,0.149254,23.5373,64.7373,67,1
Bangladesh,160,218.438,7.70625,0.4,211.106,7.05,0.325,59,Tamim Iqbal,0,0,0,0,0,0,0,0,8,12,20,8,12,20,210,200,1,1,1,4.05344,0.274809,31.8015,76.8068,131,4
Bangladesh,160,218.438,7.70625,0.4,211.106,7.05,0.325,59,Imrul Kayes,0,0,0,0,0,0,0,0,8,12,20,8,12,20,210,200,1,1,1,3,0.207547,26.2642,63.6488,53,4
West Indies,176,217.33,7.15909,0.3125,225.278,7.57386,0.380682,60,LMP Simmons,0,0,0,0,0,0,0,0,12,9,21,12,9,21,0,240,0,1,1,3.3125,0.28125,30.5938,71.4338,64,4
West Indies,176,217.33,7.15909,0.3125,225.278,7.57386,0.380682,60,KA Edwards,0,0,0,0,0,0,0,0,12,9,21,12,9,21,0,240,0,1,1,1.875,0.0625,20.6875,64.902,16,1
India,259,242.378,7.15058,0.339768,244.568,7.12741,0.30888,60,PA Patel,0,0,0,0,0,0,0,0,8,11,19,8,11,19,241,183,2,0,1,2.65217,0.130435,22.1304,79.4072,23,4
India,259,242.378,7.15058,0.339768,244.568,7.12741,0.30888,60,S Dhawan,0,0,0,0,0,0,0,0,8,11,19,8,11,19,241,183,2,0,1,5.65217,0.362319,43.2174,88.9088,69,4
India,259,242.378,7.15058,0.339768,244.568,7.12741,0.30888,60,V Kohli,0,0,0,0,0,0,0,0,8,11,19,8,11,19,241,183,2,0,1,4.66456,0.379747,44.9937,88.3325,158,4
South Africa,190,234.274,7.4,0.373684,232.363,7.33158,0.342105,61,HM Amla,0,0,0,0,0,0,0,0,20,4,24,20,4,24,0,222,1,1,1,5.20168,0.403361,48.7899,86.9292,119,4
South Africa,190,234.274,7.4,0.373684,232.363,7.33158,0.342105,61,GC Smith,0,0,0,0,0,0,0,0,20,4,24,20,4,24,0,222,1,1,1,3.97,0.29,33.57,79.6819,100,4
Australia,228,239.627,7.69737,0.372807,232.079,7.23246,0.337719,61,SR Watson,0,0,0,0,0,0,0,0,16,9,25,16,9,25,223,227,2,0,1,4.71318,0.286822,37.7907,90.0943,129,4
Australia,228,239.627,7.69737,0.372807,232.079,7.23246,0.337719,61,DA Warner,0,0,0,0,0,0,0,0,16,9,25,16,9,25,223,227,2,0,1,4.20312,0.265625,35.2031,87.7336,64,4
Australia,228,239.627,7.69737,0.372807,232.079,7.23246,0.337719,62,SR Watson,0,0,0,0,0,0,0,0,12,5,17,12,5,17,0,211,6,0,1,4.71318,0.286822,37.7907,90.0943,129,4
Australia,228,239.627,7.69737,0.372807,232.079,7.23246,0.337719,62,SE Marsh,0,0,0,0,0,0,0,0,12,5,17,12,5,17,0,211,6,0,1,3.66667,0.291667,35.5417,74.7918,48,4
Australia,228,239.627,7.69737,0.372807,232.079,7.23246,0.337719,62,RT Ponting,0,0,0,0,0,0,0,0,12,5,17,12,5,17,0,211,6,0,1,4.17431,0.33945,38.1009,80.8606,109,4
Sri Lanka,244,223.373,7.09016,0.344262,227.578,7.47541,0.385246,62,WU Tharanga,0,0,0,0,0,0,0,0,16,12,28,16,12,28,212,213,5,1,1,3.93985,0.263158,32.9699,71.6035,133,4
Sri Lanka,244,223.373,7.09016,0.344262,227.578,7.47541,0.385246,62,KC Sangakkara,0,0,0,0,0,0,0,0,16,12,28,16,12,28,212,213,5,1,1,4.33659,0.360976,41.9854,80.6276,205,4
Sri Lanka,244,223.373,7.09016,0.344262,227.578,7.47541,0.385246,62,DPMD Jayawardene,0,0,0,0,0,0,0,0,16,12,28,16,12,28,212,213,5,1,1,3.20833,0.244792,31.6979,79.1109,192,4
Sri Lanka,244,223.373,7.09016,0.344262,227.578,7.47541,0.385246,62,TM Dilshan,0,0,0,0,0,0,0,0,16,12,28,16,12,28,212,213,5,1,1,4.60199,0.273632,38.3632,86.0219,201,4
Australia,228,239.627,7.69737,0.372807,232.079,7.23246,0.337719,63,DA Warner,0,0,0,0,0,0,0,0,4,5,9,4,5,9,0,252,1,1,1,4.20312,0.265625,35.2031,87.7336,64,4
Australia,228,239.627,7.69737,0.372807,232.079,7.23246,0.337719,63,SR Watson,0,0,0,0,0,0,0,0,4,5,9,4,5,9,0,252,1,1,1,4.71318,0.286822,37.7907,90.0943,129,4
Australia,228,239.627,7.69737,0.372807,232.079,7.23246,0.337719,63,PJ Forrest,0,0,0,0,0,0,0,0,4,5,9,4,5,9,0,252,1,1,1,2.71429,0.285714,26.2143,63.6049,14,4
India,259,242.378,7.15058,0.339768,244.568,7.12741,0.30888,63,V Sehwag,0,0,0,0,0,0,0,0,4,4,8,4,4,8,253,165,10,0,1,5.88636,0.238636,38.8295,108.649,88,0
India,259,242.378,7.15058,0.339768,244.568,7.12741,0.30888,63,SR Tendulkar,0,0,0,0,0,0,0,0,4,4,8,4,4,8,253,165,10,0,1,5.89773,0.363636,45.6023,84.5376,88,4
India,259,242.378,7.15058,0.339768,244.568,7.12741,0.30888,63,G Gambhir,0,0,0,0,0,0,0,0,4,4,8,4,4,8,253,165,10,0,1,3.99145,0.333333,37.4701,84.1944,117,4
New Zealand,184,233.745,7.39674,0.36413,227.951,7.30435,0.353261,64,RJ Nicol,0,0,0,0,0,0,0,0,12,5,17,12,5,17,0,230,2,1,1,3.3,0.2,29.25,73.4003,20,4
New Zealand,184,233.745,7.39674,0.36413,227.951,7.30435,0.353261,64,MJ Guptill,0,0,0,0,0,0,0,0,12,5,17,12,5,17,0,230,2,1,1,4.8087,0.313043,38.1217,82.7482,115,4
South Africa,190,234.274,7.4,0.373684,232.363,7.33158,0.342105,64,HM Amla,0,0,0,0,0,0,0,0,32,3,35,32,3,35,231,231,1,0,1,5.20168,0.403361,48.7899,86.9292,119,4
South Africa,190,234.274,7.4,0.373684,232.363,7.33158,0.342105,64,JH Kallis,0,0,0,0,0,0,0,0,32,3,35,32,3,35,231,231,1,0,1,3.58621,0.356322,37.2644,76.4442,87,4
South Africa,190,234.274,7.4,0.373684,232.363,7.33158,0.342105,64,F du Plessis,0,0,0,0,0,0,0,0,32,3,35,32,3,35,231,231,1,0,1,3.45122,0.292683,34.9268,83.135,82,4
Zimbabwe,142,212.077,7.5,0.380282,227.704,6.97887,0.316901,65,BRM Taylor,0,0,0,0,0,0,0,0,12,7,19,12,7,19,0,199,1,1,1,3.3,0.26,33.56,76.3421,100,4
Zimbabwe,142,212.077,7.5,0.380282,227.704,6.97887,0.316901,65,V Sibanda,0,0,0,0,0,0,0,0,12,7,19,12,7,19,0,199,1,1,1,2.9697,0.181818,23.5152,63.5545,66,1
Bangladesh,160,218.438,7.70625,0.4,211.106,7.05,0.325,65,Tamim Iqbal,0,0,0,0,0,0,0,0,36,11,47,36,11,47,200,203,3,0,1,4.05344,0.274809,31.8015,76.8068,131,4
Bangladesh,160,218.438,7.70625,0.4,211.106,7.05,0.325,65,Imrul Kayes,0,0,0,0,0,0,0,0,36,11,47,36,11,47,200,203,3,0,1,3,0.207547,26.2642,63.6488,53,4
Bangladesh,160,218.438,7.70625,0.4,211.106,7.05,0.325,65,Junaid Siddique,0,0,0,0,0,0,0,0,36,11,47,36,11,47,200,203,3,0,1,2.16279,0.116279,20.0233,68.225,43,1
Sri Lanka,244,223.373,7.09016,0.344262,227.578,7.47541,0.385246,66,WU Tharanga,0,0,0,0,0,0,0,0,4,6,10,4,6,10,0,131,11,0,1,3.93985,0.263158,32.9699,71.6035,133,4
Sri Lanka,244,223.373,7.09016,0.344262,227.578,7.47541,0.385246,66,TM Dilshan,0,0,0,0,0,0,0,0,4,6,10,4,6,10,0,131,11,0,1,4.60199,0.273632,38.3632,86.0219,201,4
Sri Lanka,244,223.373,7.09016,0.344262,227.578,7.47541,0.385246,66,KC Sangakkara,0,0,0,0,0,0,0,0,4,6,10,4,6,10,0,131,11,0,1,4.33659,0.360976,41.9854,80.6276,205,4
Pakistan,211,222.621,7.38389,0.393365,235.517,7.54976,0.336493,66,Mohammad Hafeez,0,0,0,0,0,0,0,0,12,9,21,12,9,21,132,132,9,0,1,4.04511,0.255639,34.3534,78.0625,133,4
Pakistan,211,222.621,7.38389,0.393365,235.517,7.54976,0.336493,66,Imran Farhat,0,0,0,0,0,0,0,0,12,9,21,12,9,21,132,132,9,0,1,3.03333,0.266667,27.0333,62.9658,30,4
Pakistan,211,222.621,7.38389,0.393365,235.517,7.54976,0.336493,66,Younis Khan,0,0,0,0,0,0,0,0,12,9,21,12,9,21,132,132,9,0,1,2.64655,0.215517,28.5,73.2713,116,4
Bangladesh,160,218.438,7.70625,0.4,211.106,7.05,0.325,67,Tamim Iqbal,0,0,0,0,0,0,0,0,16,2,18,16,2,18,0,220,0,1,1,4.05344,0.274809,31.8015,76.8068,131,4
Bangladesh,160,218.438,7.70625,0.4,211.106,7.05,0.325,67,Imrul Kayes,0,0,0,0,0,0,0,0,16,2,18,16,2,18,0,220,0,1,1,3,0.207547,26.2642,63.6488,53,4
Bangladesh,160,218.438,7.70625,0.4,211.106,7.05,0.325,67,Mohammad Ashraful,0,0,0,0,0,0,0,0,16,2,18,16,2,18,0,220,0,1,1,2.17722,0.113924,19.4557,63.9085,79,1
Bangladesh,160,218.438,7.70625,0.4,211.106,7.05,0.325,67,Shakib Al Hasan,0,0,0,0,0,0,0,0,16,2,18,16,2,18,0,220,0,1,1,2.86992,0.252033,29.9106,79.0163,123,4
Bangladesh,160,218.438,7.70625,0.4,211.106,7.05,0.325,67,Mushfiqur Rahim,0,0,0,0,0,0,0,0,16,2,18,16,2,18,0,220,0,1,1,2.61111,0.18254,27.7778,75.2526,126,4
Bangladesh,160,218.438,7.70625,0.4,211.106,7.05,0.325,67,Alok Kapali,0,0,0,0,0,0,0,0,16,2,18,16,2,18,0,220,0,1,1,2.38462,0.0769231,20.7692,76.2712,13,1
West Indies,176,217.33,7.15909,0.3125,225.278,7.57386,0.380682,67,LMP Simmons,0,0,0,0,0,0,0,0,6,7,13,6,7,13,221,221,5,0,1,3.3125,0.28125,30.5938,71.4338,64,4
West Indies,176,217.33,7.15909,0.3125,225.278,7.57386,0.380682,67,DP Hyatt,0,0,0,0,0,0,0,0,6,7,13,6,7,13,221,221,5,0,1,1.55556,0,12.4444,59.2593,9,3
South Africa,190,234.274,7.4,0.373684,232.363,7.33158,0.342105,68,GC Smith,0,0,0,0,0,0,0,0,8,8,16,8,8,16,0,220,1,0,1,3.97,0.29,33.57,79.6819,100,4
South Africa,190,234.274,7.4,0.373684,232.363,7.33158,0.342105,68,HM Amla,0,0,0,0,0,0,0,0,8,8,16,8,8,16,0,220,1,0,1,5.20168,0.403361,48.7899,86.9292,119,4
England,221,237.176,7.17647,0.289593,230.633,7.45701,0.384615,68,AN Cook,0,0,0,0,0,0,0,0,4,6,10,4,6,10,221,224,7,1,1,4.17045,0.272727,35.75,75.5524,88,4
England,221,237.176,7.17647,0.289593,230.633,7.45701,0.384615,68,IR Bell,0,0,0,0,0,0,0,0,4,6,10,4,6,10,221,224,7,1,1,3.63433,0.246269,35.3806,75.6623,134,4
England,221,237.176,7.17647,0.289593,230.633,7.45701,0.384615,68,IJL Trott,0,0,0,0,0,0,0,0,4,6,10,4,6,10,221,224,7,1,1,3.3871,0.403226,43.7903,75.2494,62,4
West Indies,176,217.33,7.15909,0.3125,225.278,7.57386,0.380682,69,LMP Simmons,0,0,0,0,0,0,0,0,8,3,11,8,3,11,0,269,2,0,1,3.3125,0.28125,30.5938,71.4338,64,4
West Indies,176,217.33,7.15909,0.3125,225.278,7.57386,0.380682,69,AB Barath,0,0,0,0,0,0,0,0,8,3,11,8,3,11,0,269,2,0,1,2.76923,0.0769231,21.6154,56.4257,13,3
West Indies,176,217.33,7.15909,0.3125,225.278,7.57386,0.380682,69,MN Samuels,0,0,0,0,0,0,0,0,8,3,11,8,3,11,0,269,2,0,1,3.74757,0.23301,31.6214,74.5821,103,4
India,259,242.378,7.15058,0.339768,244.568,7.12741,0.30888,69,PA Patel,0,0,0,0,0,0,0,0,12,9,21,12,9,21,270,270,2,1,1,2.65217,0.130435,22.1304,79.4072,23,4
India,259,242.378,7.15058,0.339768,244.568,7.12741,0.30888,69,V Sehwag,0,0,0,0,0,0,0,0,12,9,21,12,9,21,270,270,2,1,1,5.88636,0.238636,38.8295,108.649,88,0
India,259,242.378,7.15058,0.339768,244.568,7.12741,0.30888,69,G Gambhir,0,0,0,0,0,0,0,0,12,9,21,12,9,21,270,270,2,1,1,3.99145,0.333333,37.4701,84.1944,117,4
West Indies,176,217.33,7.15909,0.3125,225.278,7.57386,0.380682,70,J Charles,0,0,0,0,0,0,0,0,16,4,20,16,4,20,0,294,3,1,1,3.82353,0.147059,28.2353,81.2183,34,4
West Indies,176,217.33,7.15909,0.3125,225.278,7.57386,0.380682,70,AB Barath,0,0,0,0,0,0,0,0,16,4,20,16,4,20,0,294,3,1,1,2.76923,0.0769231,21.6154,56.4257,13,3
Australia,228,239.627,7.69737,0.372807,232.079,7.23246,0.337719,70,SR Watson,0,0,0,0,0,0,0,0,24,9,33,24,9,33,295,252,4,0,1,4.71318,0.286822,37.7907,90.0943,129,4
Australia,228,239.627,7.69737,0.372807,232.079,7.23246,0.337719,70,DA Warner,0,0,0,0,0,0,0,0,24,9,33,24,9,33,295,252,4,0,1,4.20312,0.265625,35.2031,87.7336,64,4
Australia,228,239.627,7.69737,0.372807,232.079,7.23246,0.337719,70,PJ Forrest,0,0,0,0,0,0,0,0,24,9,33,24,9,33,295,252,4,0,1,2.71429,0.285714,26.2143,63.6049,14,4
West Indies,176,217.33,7.15909,0.3125,225.278,7.57386,0.380682,71,J Charles,0,0,0,0,0,0,0,0,10,6,16,10,6,16,0,264,1,1,1,3.82353,0.147059,28.2353,81.2183,34,4
West Indies,176,217.33,7.15909,0.3125,225.278,7.57386,0.380682,71,CH Gayle,0,0,0,0,0,0,0,0,10,6,16,10,6,16,0,264,1,1,1,4.58621,0.206897,31.1293,89.4255,116,4
West Indies,176,217.33,7.15909,0.3125,225.278,7.57386,0.380682,71,DR Smith,0,0,0,0,0,0,0,0,10,6,16,10,6,16,0,264,1,1,1,2.5,0.12,17.96,84.5574,50,1
New Zealand,184,233.745,7.39674,0.36413,227.951,7.30435,0.353261,71,RJ Nicol,0,0,0,0,0,0,0,0,24,10,34,24,10,34,265,240,8,0,1,3.3,0.2,29.25,73.4003,20,4
New Zealand,184,233.745,7.39674,0.36413,227.951,7.30435,0.353261,71,MJ Guptill,0,0,0,0,0,0,0,0,24,10,34,24,10,34,265,240,8,0,1,4.8087,0.313043,38.1217,82.7482,115,4
New Zealand,184,233.745,7.39674,0.36413,227.951,7.30435,0.353261,71,BB McCullum,0,0,0,0,0,0,0,0,24,10,34,24,10,34,265,240,8,0,1,3.98611,0.201389,29.9028,98.4004,144,0
India,259,242.378,7.15058,0.339768,244.568,7.12741,0.30888,72,G Gambhir,0,0,0,0,0,0,0,0,12,13,25,12,13,25,0,294,4,0,1,3.99145,0.333333,37.4701,84.1944,117,4
India,259,242.378,7.15058,0.339768,244.568,7.12741,0.30888,72,AM Rahane,0,0,0,0,0,0,0,0,12,13,25,12,13,25,0,294,4,0,1,3.55738,0.262295,32.2295,78.0159,61,4
Sri Lanka,244,223.373,7.09016,0.344262,227.578,7.47541,0.385246,72,WU Tharanga,0,0,0,0,0,0,0,0,8,15,23,8,15,23,295,274,12,1,1,3.93985,0.263158,32.9699,71.6035,133,4
Sri Lanka,244,223.373,7.09016,0.344262,227.578,7.47541,0.385246,72,TM Dilshan,0,0,0,0,0,0,0,0,8,15,23,8,15,23,295,274,12,1,1,4.60199,0.273632,38.3632,86.0219,201,4
Sri Lanka,244,223.373,7.09016,0.344262,227.578,7.47541,0.385246,72,HDRL Thirimanne,0,0,0,0,0,0,0,0,8,15,23,8,15,23,295,274,12,1,1,2.77778,0.246914,31.5802,71.4725,81,4
Australia,228,239.627,7.69737,0.372807,232.079,7.23246,0.337719,73,SE Marsh,0,0,0,0,0,0,0,0,8,8,16,8,8,16,0,315,0,0,1,3.66667,0.291667,35.5417,74.7918,48,4
Australia,228,239.627,7.69737,0.372807,232.079,7.23246,0.337719,73,SR Watson,0,0,0,0,0,0,0,0,8,8,16,8,8,16,0,315,0,0,1,4.71318,0.286822,37.7907,90.0943,129,4
Australia,228,239.627,7.69737,0.372807,232.079,7.23246,0.337719,73,AJ Finch,0,0,0,0,0,0,0,0,8,8,16,8,8,16,0,315,0,0,1,4.52941,0.313725,37.2549,83.4431,51,4
England,221,237.176,7.17647,0.289593,230.633,7.45701,0.384615,73,KP Pietersen,0,0,0,0,0,0,0,0,4,3,7,4,3,7,316,227,3,1,1,3.69892,0.236559,33.4946,82.2117,93,4
England,221,237.176,7.17647,0.289593,230.633,7.45701,0.384615,73,MA Carberry,0,0,0,0,0,0,0,0,4,3,7,4,3,7,316,227,3,1,1,2.8,0.2,22.6,63.4831,5,1
England,221,237.176,7.17647,0.289593,230.633,7.45701,0.384615,73,IJL Trott,0,0,0,0,0,0,0,0,4,3,7,4,3,7,316,227,3,1,1,3.3871,0.403226,43.7903,75.2494,62,4
England,221,237.176,7.17647,0.289593,230.633,7.45701,0.384615,73,JE Root,0,0,0,0,0,0,0,0,4,3,7,4,3,7,316,227,3,1,1,3.68852,0.327869,41.6721,83.3443,61,4
South Africa,190,234.274,7.4,0.373684,232.363,7.33158,0.342105,74,HM Amla,0,0,0,0,0,0,0,0,12,11,23,12,11,23,0,191,3,1,1,5.20168,0.403361,48.7899,86.9292,119,4
South Africa,190,234.274,7.4,0.373684,232.363,7.33158,0.342105,74,GC Smith,0,0,0,0,0,0,0,0,12,11,23,12,11,23,0,191,3,1,1,3.97,0.29,33.57,79.6819,100,4
South Africa,190,234.274,7.4,0.373684,232.363,7.33158,0.342105,74,CA Ingram,0,0,0,0,0,0,0,0,12,11,23,12,11,23,0,191,3,1,1,3,0.178571,27.1786,81.3904,28,4
South Africa,190,234.274,7.4,0.373684,232.363,7.33158,0.342105,74,AB de Villiers,0,0,0,0,0,0,0,0,12,11,23,12,11,23,0,191,3,1,1,5.04969,0.403727,47.2174,98.8428,161,4
Pakistan,211,222.621,7.38389,0.393365,235.517,7.54976,0.336493,74,Nasir Jamshed,0,0,0,0,0,0,0,0,14,5,19,14,5,19,192,192,0,0,1,3.63043,0.23913,30.2174,73.8184,46,4
Pakistan,211,222.621,7.38389,0.393365,235.517,7.54976,0.336493,74,Mohammad Hafeez,0,0,0,0,0,0,0,0,14,5,19,14,5,19,192,192,0,0,1,4.04511,0.255639,34.3534,78.0625,133,4
India,259,242.378,7.15058,0.339768,244.568,7.12741,0.30888,76,RG Sharma,0,0,0,0,0,0,0,0,4,8,12,4,8,12,0,331,3,0,1,3.82836,0.268657,35.9179,83.083,134,4
India,259,242.378,7.15058,0.339768,244.568,7.12741,0.30888,76,S Dhawan,0,0,0,0,0,0,0,0,4,8,12,4,8,12,0,331,3,0,1,5.65217,0.362319,43.2174,88.9088,69,4
South Africa,190,234.274,7.4,0.373684,232.363,7.33158,0.342105,76,HM Amla,0,0,0,0,0,0,0,0,28,14,42,28,14,42,332,305,0,0,1,5.20168,0.403361,48.7899,86.9292,119,4
South Africa,190,234.274,7.4,0.373684,232.363,7.33158,0.342105,76,CA Ingram,0,0,0,0,0,0,0,0,28,14,42,28,14,42,332,305,0,0,1,3,0.178571,27.1786,81.3904,28,4
South Africa,190,234.274,7.4,0.373684,232.363,7.33158,0.342105,76,RJ Peterson,0,0,0,0,0,0,0,0,28,14,42,28,14,42,332,305,0,0,1,1.62069,0.0344828,15.7931,83.5766,29,1
South Africa,190,234.274,7.4,0.373684,232.363,7.33158,0.342105,76,AB de Villiers,0,0,0,0,0,0,0,0,28,14,42,28,14,42,332,305,0,0,1,5.04969,0.403727,47.2174,98.8428,161,4
Sri Lanka,244,223.373,7.09016,0.344262,227.578,7.47541,0.385246,77,MDKJ Perera,0,0,0,0,0,0,0,0,8,9,17,8,9,17,0,253,9,0,1,3.30435,0.195652,25.7391,90.5199,46,0
Sri Lanka,244,223.373,7.09016,0.344262,227.578,7.47541,0.385246,77,KC Sangakkara,0,0,0,0,0,0,0,0,8,9,17,8,9,17,0,253,9,0,1,4.33659,0.360976,41.9854,80.6276,205,4
Sri Lanka,244,223.373,7.09016,0.344262,227.578,7.47541,0.385246,77,TM Dilshan,0,0,0,0,0,0,0,0,8,9,17,8,9,17,0,253,9,0,1,4.60199,0.273632,38.3632,86.0219,201,4
Sri Lanka,244,223.373,7.09016,0.344262,227.578,7.47541,0.385246,77,HDRL Thirimanne,0,0,0,0,0,0,0,0,8,9,17,8,9,17,0,253,9,0,1,2.77778,0.246914,31.5802,71.4725,81,4
Australia,228,239.627,7.69737,0.372807,232.079,7.23246,0.337719,77,SR Watson,0,0,0,0,0,0,0,0,30,5,35,30,5,35,254,233,6,0,1,4.71318,0.286822,37.7907,90.0943,129,4
Australia,228,239.627,7.69737,0.372807,232.079,7.23246,0.337719,77,PJ Hughes,0,0,0,0,0,0,0,0,30,5,35,30,5,35,254,233,6,0,1,4.52381,0.285714,38.7619,74.7475,21,4
Australia,228,239.627,7.69737,0.372807,232.079,7.23246,0.337719,77,GJ Maxwell,0,0,0,0,0,0,0,0,30,5,35,30,5,35,254,233,6,0,1,3.79245,0.226415,28.2264,119.68,53,0
Pakistan,211,222.621,7.38389,0.393365,235.517,7.54976,0.336493,78,Nasir Jamshed,0,0,0,0,0,0,0,0,16,10,26,16,10,26,0,250,3,0,1,3.63043,0.23913,30.2174,73.8184,46,4
Pakistan,211,222.621,7.38389,0.393365,235.517,7.54976,0.336493,78,Mohammad Hafeez,0,0,0,0,0,0,0,0,16,10,26,16,10,26,0,250,3,0,1,4.04511,0.255639,34.3534,78.0625,133,4
India,259,242.378,7.15058,0.339768,244.568,7.12741,0.30888,78,G Gambhir,0,0,0,0,0,0,0,0,12,9,21,12,9,21,251,165,6,1,1,3.99145,0.333333,37.4701,84.1944,117,4
India,259,242.378,7.15058,0.339768,244.568,7.12741,0.30888,78,V Sehwag,0,0,0,0,0,0,0,0,12,9,21,12,9,21,251,165,6,1,1,5.88636,0.238636,38.8295,108.649,88,0
India,259,242.378,7.15058,0.339768,244.568,7.12741,0.30888,79,RG Sharma,0,0,0,0,0,0,0,0,8,10,18,8,10,18,0,119,3,0,1,3.82836,0.268657,35.9179,83.083,134,4
India,259,242.378,7.15058,0.339768,244.568,7.12741,0.30888,79,S Dhawan,0,0,0,0,0,0,0,0,8,10,18,8,10,18,0,119,3,0,1,5.65217,0.362319,43.2174,88.9088,69,4
Sri Lanka,244,223.373,7.09016,0.344262,227.578,7.47541,0.385246,79,WU Tharanga,0,0,0,0,0,0,0,0,8,4,12,8,4,12,120,96,6,0,1,3.93985,0.263158,32.9699,71.6035,133,4
Sri Lanka,244,223.373,7.09016,0.344262,227.578,7.47541,0.385246,79,DPMD Jayawardene,0,0,0,0,0,0,0,0,8,4,12,8,4,12,120,96,6,0,1,3.20833,0.244792,31.6979,79.1109,192,4
Sri Lanka,244,223.373,7.09016,0.344262,227.578,7.47541,0.385246,79,KC Sangakkara,0,0,0,0,0,0,0,0,8,4,12,8,4,12,120,96,6,0,1,4.33659,0.360976,41.9854,80.6276,205,4
Sri Lanka,244,223.373,7.09016,0.344262,227.578,7.47541,0.385246,79,LD Chandimal,0,0,0,0,0,0,0,0,8,4,12,8,4,12,120,96,6,0,1,2.18478,0.184783,25.7391,73.8615,92,4
Australia,228,239.627,7.69737,0.372807,232.079,7.23246,0.337719,81,AJ Finch,0,0,0,0,0,0,0,0,4,7,11,4,7,11,0,217,3,1,1,4.52941,0.313725,37.2549,83.4431,51,4
Australia,228,239.627,7.69737,0.372807,232.079,7.23246,0.337719,81,SE Marsh,0,0,0,0,0,0,0,0,4,7,11,4,7,11,0,217,3,1,1,3.66667,0.291667,35.5417,74.7918,48,4
Australia,228,239.627,7.69737,0.372807,232.079,7.23246,0.337719,81,SR Watson,0,0,0,0,0,0,0,0,4,7,11,4,7,11,0,217,3,1,1,4.71318,0.286822,37.7907,90.0943,129,4
England,221,237.176,7.17647,0.289593,230.633,7.45701,0.384615,81,AN Cook,0,0,0,0,0,0,0,0,8,7,15,8,7,15,218,212,3,0,1,4.17045,0.272727,35.75,75.5524,88,4
England,221,237.176,7.17647,0.289593,230.633,7.45701,0.384615,81,IR Bell,0,0,0,0,0,0,0,0,8,7,15,8,7,15,218,212,3,0,1,3.63433,0.246269,35.3806,75.6623,134,4
West Indies,176,217.33,7.15909,0.3125,225.278,7.57386,0.380682,82,CH Gayle,0,0,0,0,0,0,0,0,8,10,18,8,10,18,0,232,1,1,1,4.58621,0.206897,31.1293,89.4255,116,4
West Indies,176,217.33,7.15909,0.3125,225.278,7.57386,0.380682,82,J Charles,0,0,0,0,0,0,0,0,8,10,18,8,10,18,0,232,1,1,1,3.82353,0.147059,28.2353,81.2183,34,4
West Indies,176,217.33,7.15909,0.3125,225.278,7.57386,0.380682,82,DM Bravo,0,0,0,0,0,0,0,0,8,10,18,8,10,18,0,232,1,1,1,3,0.226667,28.52,67.4551,75,4
Pakistan,211,222.621,7.38389,0.393365,235.517,7.54976,0.336493,82,Nasir Jamshed,0,0,0,0,0,0,0,0,0,0,0,0,0,0,233,195,5,0,1,3.63043,0.23913,30.2174,73.8184,46,4
Pakistan,211,222.621,7.38389,0.393365,235.517,7.54976,0.336493,82,Ahmed Shehzad,0,0,0,0,0,0,0,0,0,0,0,0,0,0,233,195,5,0,1,3.67143,0.242857,33.2714,70.8118,70,4
South Africa,190,234.274,7.4,0.373684,232.363,7.33158,0.342105,83,Q de Kock,0,0,0,0,0,0,0,0,8,11,19,8,11,19,0,280,2,1,1,5.12963,0.240741,39.1111,91.2311,54,4
South Africa,190,234.274,7.4,0.373684,232.363,7.33158,0.342105,83,HM Amla,0,0,0,0,0,0,0,0,8,11,19,8,11,19,0,280,2,1,1,5.20168,0.403361,48.7899,86.9292,119,4
India,259,242.378,7.15058,0.339768,244.568,7.12741,0.30888,83,RG Sharma,0,0,0,0,0,0,0,0,4,7,11,4,7,11,281,146,6,0,1,3.82836,0.268657,35.9179,83.083,134,4
India,259,242.378,7.15058,0.339768,244.568,7.12741,0.30888,83,S Dhawan,0,0,0,0,0,0,0,0,4,7,11,4,7,11,281,146,6,0,1,5.65217,0.362319,43.2174,88.9088,69,4
India,259,242.378,7.15058,0.339768,244.568,7.12741,0.30888,83,V Kohli,0,0,0,0,0,0,0,0,4,7,11,4,7,11,281,146,6,0,1,4.66456,0.379747,44.9937,88.3325,158,4
India,259,242.378,7.15058,0.339768,244.568,7.12741,0.30888,83,AM Rahane,0,0,0,0,0,0,0,0,4,7,11,4,7,11,281,146,6,0,1,3.55738,0.262295,32.2295,78.0159,61,4
West Indies,176,217.33,7.15909,0.3125,225.278,7.57386,0.380682,84,DR Smith,0,0,0,0,0,0,0,0,12,8,20,12,8,20,0,304,1,0,1,2.5,0.12,17.96,84.5574,50,1
West Indies,176,217.33,7.15909,0.3125,225.278,7.57386,0.380682,84,CH Gayle,0,0,0,0,0,0,0,0,12,8,20,12,8,20,0,304,1,0,1,4.58621,0.206897,31.1293,89.4255,116,4
Ireland,55,219.527,7.65455,0.290909,202.727,7.56364,0.4,84,WTS Porterfield,0,0,0,0,0,0,0,0,18,9,27,18,9,27,305,307,5,0,1,2.6,0.142857,24.6857,56.2866,35,3
Ireland,55,219.527,7.65455,0.290909,202.727,7.56364,0.4,84,PR Stirling,0,0,0,0,0,0,0,0,18,9,27,18,9,27,305,307,5,0,1,3.47826,0.173913,24.2174,88.1329,23,0
New Zealand,184,233.745,7.39674,0.36413,227.951,7.30435,0.353261,88,MJ Guptill,0,0,0,0,0,0,0,0,26,4,30,26,4,30,0,393,1,1,1,4.8087,0.313043,38.1217,82.7482,115,4
New Zealand,184,233.745,7.39674,0.36413,227.951,7.30435,0.353261,88,BB McCullum,0,0,0,0,0,0,0,0,26,4,30,26,4,30,0,393,1,1,1,3.98611,0.201389,29.9028,98.4004,144,0
West Indies,176,217.33,7.15909,0.3125,225.278,7.57386,0.380682,88,CH Gayle,0,0,0,0,0,0,0,0,14,6,20,14,6,20,394,250,1,0,1,4.58621,0.206897,31.1293,89.4255,116,4
West Indies,176,217.33,7.15909,0.3125,225.278,7.57386,0.380682,88,J Charles,0,0,0,0,0,0,0,0,14,6,20,14,6,20,394,250,1,0,1,3.82353,0.147059,28.2353,81.2183,34,4
West Indies,176,217.33,7.15909,0.3125,225.278,7.57386,0.380682,88,LMP Simmons,0,0,0,0,0,0,0,0,14,6,20,14,6,20,394,250,1,0,1,3.3125,0.28125,30.5938,71.4338,64,4
Pakistan,211,222.621,7.38389,0.393365,235.517,7.54976,0.336493,89,Nasir Jamshed,0,0,0,0,0,0,0,0,8,7,15,8,7,15,0,299,1,0,1,3.63043,0.23913,30.2174,73.8184,46,4
Pakistan,211,222.621,7.38389,0.393365,235.517,7.54976,0.336493,89,Ahmed Shehzad,0,0,0,0,0,0,0,0,8,7,15,8,7,15,0,299,1,0,1,3.67143,0.242857,33.2714,70.8118,70,4
Zimbabwe,142,212.077,7.5,0.380282,227.704,6.97887,0.316901,89,H Masakadza,0,0,0,0,0,0,0,0,16,9,25,16,9,25,300,209,3,1,1,3.11215,0.186916,26.972,70.0485,107,4
Zimbabwe,142,212.077,7.5,0.380282,227.704,6.97887,0.316901,89,V Sibanda,0,0,0,0,0,0,0,0,16,9,25,16,9,25,300,209,3,1,1,2.9697,0.181818,23.5152,63.5545,66,1
Zimbabwe,142,212.077,7.5,0.380282,227.704,6.97887,0.316901,89,BRM Taylor,0,0,0,0,0,0,0,0,16,9,25,16,9,25,300,209,3,1,1,3.3,0.26,33.56,76.3421,100,4
New Zealand,184,233.745,7.39674,0.36413,227.951,7.30435,0.353261,90,MJ Guptill,0,0,0,0,0,0,0,0,24,6,30,24,6,30,0,314,7,1,1,4.8087,0.313043,38.1217,82.7482,115,4
New Zealand,184,233.745,7.39674,0.36413,227.951,7.30435,0.353261,90,JD Ryder,0,0,0,0,0,0,0,0,24,6,30,24,6,30,0,314,7,1,1,4.88571,0.257143,34.4,97.2536,35,0
New Zealand,184,233.745,7.39674,0.36413,227.951,7.30435,0.353261,90,KS Williamson,0,0,0,0,0,0,0,0,24,6,30,24,6,30,0,314,7,1,1,4.31707,0.390244,43.0488,82.8833,82,4
India,259,242.378,7.15058,0.339768,244.568,7.12741,0.30888,90,RG Sharma,0,0,0,0,0,0,0,0,14,11,25,14,11,25,315,314,0,0,1,3.82836,0.268657,35.9179,83.083,134,4
India,259,242.378,7.15058,0.339768,244.568,7.12741,0.30888,90,S Dhawan,0,0,0,0,0,0,0,0,14,11,25,14,11,25,315,314,0,0,1,5.65217,0.362319,43.2174,88.9088,69,4
Sri Lanka,244,223.373,7.09016,0.344262,227.578,7.47541,0.385246,91,TM Dilshan,0,0,0,0,0,0,0,0,14,11,25,14,11,25,0,300,1,0,1,4.60199,0.273632,38.3632,86.0219,201,4
Sri Lanka,244,223.373,7.09016,0.344262,227.578,7.47541,0.385246,91,MDKJ Perera,0,0,0,0,0,0,0,0,14,11,25,14,11,25,0,300,1,0,1,3.30435,0.195652,25.7391,90.5199,46,0
England,221,237.176,7.17647,0.289593,230.633,7.45701,0.384615,91,AN Cook,0,0,0,0,0,0,0,0,8,4,12,8,4,12,301,293,4,1,1,4.17045,0.272727,35.75,75.5524,88,4
England,221,237.176,7.17647,0.289593,230.633,7.45701,0.384615,91,IR Bell,0,0,0,0,0,0,0,0,8,4,12,8,4,12,301,293,4,1,1,3.63433,0.246269,35.3806,75.6623,134,4
England,221,237.176,7.17647,0.289593,230.633,7.45701,0.384615,91,GS Ballance,0,0,0,0,0,0,0,0,8,4,12,8,4,12,301,293,4,1,1,1.69231,0.153846,22,66.3573,13,1
England,221,237.176,7.17647,0.289593,230.633,7.45701,0.384615,91,JE Root,0,0,0,0,0,0,0,0,8,4,12,8,4,12,301,293,4,1,1,3.68852,0.327869,41.6721,83.3443,61,4
Bangladesh,160,218.438,7.70625,0.4,211.106,7.05,0.325,94,Anamul Haque,0,0,0,0,0,0,0,0,12,7,19,12,7,19,0,326,1,1,1,4.12,0.24,36.8,69.6442,25,4
Bangladesh,160,218.438,7.70625,0.4,211.106,7.05,0.325,94,Imrul Kayes,0,0,0,0,0,0,0,0,12,7,19,12,7,19,0,326,1,1,1,3,0.207547,26.2642,63.6488,53,4
Pakistan,211,222.621,7.38389,0.393365,235.517,7.54976,0.336493,94,Ahmed Shehzad,0,0,0,0,0,0,0,0,12,10,22,12,10,22,327,329,4,0,1,3.67143,0.242857,33.2714,70.8118,70,4
Pakistan,211,222.621,7.38389,0.393365,235.517,7.54976,0.336493,94,Mohammad Hafeez,0,0,0,0,0,0,0,0,12,10,22,12,10,22,327,329,4,0,1,4.04511,0.255639,34.3534,78.0625,133,4
Pakistan,211,222.621,7.38389,0.393365,235.517,7.54976,0.336493,95,Ahmed Shehzad,0,0,0,0,0,0,0,0,8,10,18,8,10,18,0,215,1,0,1,3.67143,0.242857,33.2714,70.8118,70,4
Pakistan,211,222.621,7.38389,0.393365,235.517,7.54976,0.336493,95,Sarfraz Ahmed,0,0,0,0,0,0,0,0,8,10,18,8,10,18,0,215,1,0,1,2.04878,0.097561,25.4878,83.9357,41,4
Australia,228,239.627,7.69737,0.372807,232.079,7.23246,0.337719,95,DA Warner,0,0,0,0,0,0,0,0,24,5,29,24,5,29,216,217,3,0,1,4.20312,0.265625,35.2031,87.7336,64,4
Australia,228,239.627,7.69737,0.372807,232.079,7.23246,0.337719,95,AJ Finch,0,0,0,0,0,0,0,0,24,5,29,24,5,29,216,217,3,0,1,4.52941,0.313725,37.2549,83.4431,51,4
Australia,228,239.627,7.69737,0.372807,232.079,7.23246,0.337719,95,SPD Smith,0,0,0,0,0,0,0,0,24,5,29,24,5,29,216,217,3,0,1,3.19298,0.22807,34.5614,87.0526,57,4
West Indies,176,217.33,7.15909,0.3125,225.278,7.57386,0.380682,96,LMP Simmons,0,0,0,0,0,0,0,0,8,4,12,8,4,12,0,338,0,1,1,3.3125,0.28125,30.5938,71.4338,64,4
West Indies,176,217.33,7.15909,0.3125,225.278,7.57386,0.380682,96,CH Gayle,0,0,0,0,0,0,0,0,8,4,12,8,4,12,0,338,0,1,1,4.58621,0.206897,31.1293,89.4255,116,4
West Indies,176,217.33,7.15909,0.3125,225.278,7.57386,0.380682,96,D Ramdin,0,0,0,0,0,0,0,0,8,4,12,8,4,12,0,338,0,1,1,1.7439,0.097561,19.1951,81.1759,82,1
Bangladesh,160,218.438,7.70625,0.4,211.106,7.05,0.325,96,Tamim Iqbal,0,0,0,0,0,0,0,0,8,7,15,8,7,15,339,247,0,0,1,4.05344,0.274809,31.8015,76.8068,131,4
Bangladesh,160,218.438,7.70625,0.4,211.106,7.05,0.325,96,Anamul Haque,0,0,0,0,0,0,0,0,8,7,15,8,7,15,339,247,0,0,1,4.12,0.24,36.8,69.6442,25,4
Bangladesh,160,218.438,7.70625,0.4,211.106,7.05,0.325,96,Imrul Kayes,0,0,0,0,0,0,0,0,8,7,15,8,7,15,339,247,0,0,1,3,0.207547,26.2642,63.6488,53,4
Bangladesh,160,218.438,7.70625,0.4,211.106,7.05,0.325,96,Mushfiqur Rahim,0,0,0,0,0,0,0,0,8,7,15,8,7,15,339,247,0,0,1,2.61111,0.18254,27.7778,75.2526,126,4
Australia,228,239.627,7.69737,0.372807,232.079,7.23246,0.337719,97,AJ Finch,0,0,0,0,0,0,0,0,16,11,27,16,11,27,0,217,3,0,1,4.52941,0.313725,37.2549,83.4431,51,4
Australia,228,239.627,7.69737,0.372807,232.079,7.23246,0.337719,97,PJ Hughes,0,0,0,0,0,0,0,0,16,11,27,16,11,27,0,217,3,0,1,4.52381,0.285714,38.7619,74.7475,21,4
Australia,228,239.627,7.69737,0.372807,232.079,7.23246,0.337719,97,SPD Smith,0,0,0,0,0,0,0,0,16,11,27,16,11,27,0,217,3,0,1,3.19298,0.22807,34.5614,87.0526,57,4
South Africa,190,234.274,7.4,0.373684,232.363,7.33158,0.342105,97,HM Amla,0,0,0,0,0,0,0,0,8,12,20,8,12,20,218,221,0,0,1,5.20168,0.403361,48.7899,86.9292,119,4
South Africa,190,234.274,7.4,0.373684,232.363,7.33158,0.342105,97,Q de Kock,0,0,0,0,0,0,0,0,8,12,20,8,12,20,218,221,0,0,1,5.12963,0.240741,39.1111,91.2311,54,4
South Africa,190,234.274,7.4,0.373684,232.363,7.33158,0.342105,97,F du Plessis,0,0,0,0,0,0,0,0,8,12,20,8,12,20,218,221,0,0,1,3.45122,0.292683,34.9268,83.135,82,4
England,221,237.176,7.17647,0.289593,230.633,7.45701,0.384615,98,JJ Roy,0,0,0,0,0,0,0,0,16,10,26,16,10,26,0,302,2,1,1,4.36842,0.210526,29.3684,95.3846,19,0
England,221,237.176,7.17647,0.289593,230.633,7.45701,0.384615,98,AD Hales,0,0,0,0,0,0,0,0,16,10,26,16,10,26,0,302,2,1,1,4.2963,0.296296,34.1111,85.1201,27,4
New Zealand,184,233.745,7.39674,0.36413,227.951,7.30435,0.353261,98,MJ Guptill,0,0,0,0,0,0,0,0,8,9,17,8,9,17,303,306,5,0,1,4.8087,0.313043,38.1217,82.7482,115,4
New Zealand,184,233.745,7.39674,0.36413,227.951,7.30435,0.353261,98,BB McCullum,0,0,0,0,0,0,0,0,8,9,17,8,9,17,303,306,5,0,1,3.98611,0.201389,29.9028,98.4004,144,0
New Zealand,184,233.745,7.39674,0.36413,227.951,7.30435,0.353261,98,KS Williamson,0,0,0,0,0,0,0,0,8,9,17,8,9,17,303,306,5,0,1,4.31707,0.390244,43.0488,82.8833,82,4
India,259,242.378,7.15058,0.339768,244.568,7.12741,0.30888,99,RV Uthappa,0,0,0,0,0,0,0,0,4,5,9,4,5,9,0,105,5,0,1,3,0.117647,22.1471,89.0071,34,0
India,259,242.378,7.15058,0.339768,244.568,7.12741,0.30888,99,AM Rahane,0,0,0,0,0,0,0,0,4,5,9,4,5,9,0,105,5,0,1,3.55738,0.262295,32.2295,78.0159,61,4
India,259,242.378,7.15058,0.339768,244.568,7.12741,0.30888,99,CA Pujara,0,0,0,0,0,0,0,0,4,5,9,4,5,9,0,105,5,0,1,0.5,0,6,34.7826,4,3
Bangladesh,160,218.438,7.70625,0.4,211.106,7.05,0.325,99,Tamim Iqbal,0,0,0,0,0,0,0,0,16,1,17,16,1,17,106,58,2,1,1,4.05344,0.274809,31.8015,76.8068,131,4
Bangladesh,160,218.438,7.70625,0.4,211.106,7.05,0.325,99,Mithun Ali,0,0,0,0,0,0,0,0,16,1,17,16,1,17,106,58,2,1,1,5,0,26,60.4651,1,1
Bangladesh,160,218.438,7.70625,0.4,211.106,7.05,0.325,99,Anamul Haque,0,0,0,0,0,0,0,0,16,1,17,16,1,17,106,58,2,1,1,4.12,0.24,36.8,69.6442,25,4
Bangladesh,160,218.438,7.70625,0.4,211.106,7.05,0.325,99,Mushfiqur Rahim,0,0,0,0,0,0,0,0,16,1,17,16,1,17,106,58,2,1,1,2.61111,0.18254,27.7778,75.2526,126,4
New Zealand,184,233.745,7.39674,0.36413,227.951,7.30435,0.353261,100,MJ Guptill,0,0,0,0,0,0,0,0,8,4,12,8,4,12,0,315,0,1,1,4.8087,0.313043,38.1217,82.7482,115,4
New Zealand,184,233.745,7.39674,0.36413,227.951,7.30435,0.353261,100,BB McCullum,0,0,0,0,0,0,0,0,8,4,12,8,4,12,0,315,0,1,1,3.98611,0.201389,29.9028,98.4004,144,0
New Zealand,184,233.745,7.39674,0.36413,227.951,7.30435,0.353261,100,KS Williamson,0,0,0,0,0,0,0,0,8,4,12,8,4,12,0,315,0,1,1,4.31707,0.390244,43.0488,82.8833,82,4
Sri Lanka,244,223.373,7.09016,0.344262,227.578,7.47541,0.385246,100,HDRL Thirimanne,0,0,0,0,0,0,0,0,12,8,20,12,8,20,316,195,1,0,1,2.77778,0.246914,31.5802,71.4725,81,4
Sri Lanka,244,223.373,7.09016,0.344262,227.578,7.47541,0.385246,100,TM Dilshan,0,0,0,0,0,0,0,0,12,8,20,12,8,20,316,195,1,0,1,4.60199,0.273632,38.3632,86.0219,201,4
Sri Lanka,244,223.373,7.09016,0.344262,227.578,7.47541,0.385246,101,DPMD Jayawardene,0,0,0,0,0,0,0,0,24,10,34,24,10,34,0,302,0,1,1,3.20833,0.244792,31.6979,79.1109,192,4
Sri Lanka,244,223.373,7.09016,0.344262,227.578,7.47541,0.385246,101,TM Dilshan,0,0,0,0,0,0,0,0,24,10,34,24,10,34,0,302,0,1,1,4.60199,0.273632,38.3632,86.0219,201,4
England,221,237.176,7.17647,0.289593,230.633,7.45701,0.384615,101,AN Cook,0,0,0,0,0,0,0,0,14,10,24,14,10,24,303,215,0,0,1,4.17045,0.272727,35.75,75.5524,88,4
England,221,237.176,7.17647,0.289593,230.633,7.45701,0.384615,101,MM Ali,0,0,0,0,0,0,0,0,14,10,24,14,10,24,303,215,0,0,1,2.67647,0.117647,21.3824,94.5384,34,0
England,221,237.176,7.17647,0.289593,230.633,7.45701,0.384615,101,AD Hales,0,0,0,0,0,0,0,0,14,10,24,14,10,24,303,215,0,0,1,4.2963,0.296296,34.1111,85.1201,27,4
India,259,242.378,7.15058,0.339768,244.568,7.12741,0.30888,102,AM Rahane,0,0,0,0,0,0,0,0,0,9,9,0,9,9,0,200,0,0,1,3.55738,0.262295,32.2295,78.0159,61,4
India,259,242.378,7.15058,0.339768,244.568,7.12741,0.30888,102,S Dhawan,0,0,0,0,0,0,0,0,0,9,9,0,9,9,0,200,0,0,1,5.65217,0.362319,43.2174,88.9088,69,4
England,221,237.176,7.17647,0.289593,230.633,7.45701,0.384615,102,IR Bell,0,0,0,0,0,0,0,0,8,6,14,8,6,14,201,201,2,0,1,3.63433,0.246269,35.3806,75.6623,134,4
England,221,237.176,7.17647,0.289593,230.633,7.45701,0.384615,102,MM Ali,0,0,0,0,0,0,0,0,8,6,14,8,6,14,201,201,2,0,1,2.67647,0.117647,21.3824,94.5384,34,0
England,221,237.176,7.17647,0.289593,230.633,7.45701,0.384615,102,JWA Taylor,0,0,0,0,0,0,0,0,8,6,14,8,6,14,201,201,2,0,1,3.375,0.333333,35.9167,79.8888,24,4
West Indies,176,217.33,7.15909,0.3125,225.278,7.57386,0.380682,103,DR Smith,0,0,0,0,0,0,0,0,12,4,16,12,4,16,0,321,3,0,1,2.5,0.12,17.96,84.5574,50,1
West Indies,176,217.33,7.15909,0.3125,225.278,7.57386,0.380682,103,DJ Bravo,0,0,0,0,0,0,0,0,12,4,16,12,4,16,0,321,3,0,1,2.35514,0.11215,23.1589,80.9011,107,4
India,259,242.378,7.15058,0.339768,244.568,7.12741,0.30888,103,AM Rahane,0,0,0,0,0,0,0,0,12,9,21,12,9,21,322,197,0,1,1,3.55738,0.262295,32.2295,78.0159,61,4
India,259,242.378,7.15058,0.339768,244.568,7.12741,0.30888,103,S Dhawan,0,0,0,0,0,0,0,0,12,9,21,12,9,21,322,197,0,1,1,5.65217,0.362319,43.2174,88.9088,69,4
England,221,237.176,7.17647,0.289593,230.633,7.45701,0.384615,104,JJ Roy,0,0,0,0,0,0,0,0,20,4,24,20,4,24,0,318,7,0,1,4.36842,0.210526,29.3684,95.3846,19,0
England,221,237.176,7.17647,0.289593,230.633,7.45701,0.384615,104,AD Hales,0,0,0,0,0,0,0,0,20,4,24,20,4,24,0,318,7,0,1,4.2963,0.296296,34.1111,85.1201,27,4
South Africa,190,234.274,7.4,0.373684,232.363,7.33158,0.342105,104,Q de Kock,0,0,0,0,0,0,0,0,24,1,25,24,1,25,319,319,0,1,1,5.12963,0.240741,39.1111,91.2311,54,4
South Africa,190,234.274,7.4,0.373684,232.363,7.33158,0.342105,104,HM Amla,0,0,0,0,0,0,0,0,24,1,25,24,1,25,319,319,0,1,1,5.20168,0.403361,48.7899,86.9292,119,4
South Africa,190,234.274,7.4,0.373684,232.363,7.33158,0.342105,105,HM Amla,0,0,0,0,0,0,0,0,8,4,12,8,4,12,0,162,5,0,1,5.20168,0.403361,48.7899,86.9292,119,4
South Africa,190,234.274,7.4,0.373684,232.363,7.33158,0.342105,105,Q de Kock,0,0,0,0,0,0,0,0,8,4,12,8,4,12,0,162,5,0,1,5.12963,0.240741,39.1111,91.2311,54,4
South Africa,190,234.274,7.4,0.373684,232.363,7.33158,0.342105,105,F du Plessis,0,0,0,0,0,0,0,0,8,4,12,8,4,12,0,162,5,0,1,3.45122,0.292683,34.9268,83.135,82,4
Bangladesh,160,218.438,7.70625,0.4,211.106,7.05,0.325,105,Tamim Iqbal,0,0,0,0,0,0,0,0,26,6,32,26,6,32,163,167,1,1,1,4.05344,0.274809,31.8015,76.8068,131,4
Bangladesh,160,218.438,7.70625,0.4,211.106,7.05,0.325,105,Liton Das,0,0,0,0,0,0,0,0,26,6,32,26,6,32,163,167,1,1,1,1,0,7.66667,69.697,6,1
Bangladesh,160,218.438,7.70625,0.4,211.106,7.05,0.325,105,Soumya Sarkar,0,0,0,0,0,0,0,0,26,6,32,26,6,32,163,167,1,1,1,7.35714,0.357143,47.2857,99.1018,14,4
Bangladesh,160,218.438,7.70625,0.4,211.106,7.05,0.325,105,Mahmudullah,0,0,0,0,0,0,0,0,26,6,32,26,6,32,163,167,1,1,1,2.26531,0.153061,24.4286,70.9544,98,4
Pakistan,211,222.621,7.38389,0.393365,235.517,7.54976,0.336493,106,Ahmed Shehzad,0,0,0,0,0,0,0,0,0,13,13,0,13,13,0,316,4,0,1,3.67143,0.242857,33.2714,70.8118,70,4
Pakistan,211,222.621,7.38389,0.393365,235.517,7.54976,0.336493,106,Azhar Ali,0,0,0,0,0,0,0,0,0,13,13,0,13,13,0,316,4,0,1,3.83333,0.3,38.5333,73.6775,30,4
Sri Lanka,244,223.373,7.09016,0.344262,227.578,7.47541,0.385246,106,MDKJ Perera,0,0,0,0,0,0,0,0,12,14,26,12,14,26,317,181,2,1,1,3.30435,0.195652,25.7391,90.5199,46,0
Sri Lanka,244,223.373,7.09016,0.344262,227.578,7.47541,0.385246,106,TM Dilshan,0,0,0,0,0,0,0,0,12,14,26,12,14,26,317,181,2,1,1,4.60199,0.273632,38.3632,86.0219,201,4
India,259,242.378,7.15058,0.339768,244.568,7.12741,0.30888,107,AM Rahane,0,0,0,0,0,0,0,0,8,14,22,8,14,22,0,276,3,0,1,3.55738,0.262295,32.2295,78.0159,61,4
India,259,242.378,7.15058,0.339768,244.568,7.12741,0.30888,107,M Vijay,0,0,0,0,0,0,0,0,8,14,22,8,14,22,0,276,3,0,1,2.25,0.0625,21.1875,65.6977,16,1
Zimbabwe,142,212.077,7.5,0.380282,227.704,6.97887,0.316901,107,H Masakadza,0,0,0,0,0,0,0,0,0,7,7,0,7,7,277,193,5,1,1,3.11215,0.186916,26.972,70.0485,107,4
Zimbabwe,142,212.077,7.5,0.380282,227.704,6.97887,0.316901,107,CJ Chibhabha,0,0,0,0,0,0,0,0,0,7,7,0,7,7,277,193,5,1,1,2.56716,0.149254,23.5373,64.7373,67,1
England,221,237.176,7.17647,0.289593,230.633,7.45701,0.384615,108,JJ Roy,0,0,0,0,0,0,0,0,12,6,18,12,6,18,0,283,0,0,1,4.36842,0.210526,29.3684,95.3846,19,0
England,221,237.176,7.17647,0.289593,230.633,7.45701,0.384615,108,AD Hales,0,0,0,0,0,0,0,0,12,6,18,12,6,18,0,283,0,0,1,4.2963,0.296296,34.1111,85.1201,27,4
Pakistan,211,222.621,7.38389,0.393365,235.517,7.54976,0.336493,108,Azhar Ali,0,0,0,0,0,0,0,0,0,8,8,0,8,8,284,188,2,0,1,3.83333,0.3,38.5333,73.6775,30,4
Pakistan,211,222.621,7.38389,0.393365,235.517,7.54976,0.336493,108,Babar Azam,0,0,0,0,0,0,0,0,0,8,8,0,8,8,284,188,2,0,1,4.375,0.5,40.125,88.9197,8,4
Pakistan,211,222.621,7.38389,0.393365,235.517,7.54976,0.336493,108,Mohammad Hafeez,0,0,0,0,0,0,0,0,0,8,8,0,8,8,284,188,2,0,1,4.04511,0.255639,34.3534,78.0625,133,4
Pakistan,211,222.621,7.38389,0.393365,235.517,7.54976,0.336493,108,Iftikhar Ahmed,0,0,0,0,0,0,0,0,0,8,8,0,8,8,284,188,2,0,1,0.5,0,4,25.8065,2,3
Sri Lanka,244,223.373,7.09016,0.344262,227.578,7.47541,0.385246,109,MD Gunathilaka,0,0,0,0,0,0,0,0,12,8,20,12,8,20,0,117,4,0,1,3.6,0.2,23.4,83.5714,5,4
Sri Lanka,244,223.373,7.09016,0.344262,227.578,7.47541,0.385246,109,TM Dilshan,0,0,0,0,0,0,0,0,12,8,20,12,8,20,0,117,4,0,1,4.60199,0.273632,38.3632,86.0219,201,4
Sri Lanka,244,223.373,7.09016,0.344262,227.578,7.47541,0.385246,109,HDRL Thirimanne,0,0,0,0,0,0,0,0,12,8,20,12,8,20,0,117,4,0,1,2.77778,0.246914,31.5802,71.4725,81,4
New Zealand,184,233.745,7.39674,0.36413,227.951,7.30435,0.353261,109,MJ Guptill,0,0,0,0,0,0,0,0,52,11,63,52,11,63,118,118,8,1,1,4.8087,0.313043,38.1217,82.7482,115,4
New Zealand,184,233.745,7.39674,0.36413,227.951,7.30435,0.353261,109,TWM Latham,0,0,0,0,0,0,0,0,52,11,63,52,11,63,118,118,8,1,1,2.76471,0.147059,25.3529,75.2182,34,4
West Indies,176,217.33,7.15909,0.3125,225.278,7.57386,0.380682,110,J Charles,0,0,0,0,0,0,0,0,8,8,16,8,8,16,0,206,0,0,1,3.82353,0.147059,28.2353,81.2183,34,4
West Indies,176,217.33,7.15909,0.3125,225.278,7.57386,0.380682,110,J Blackwood,0,0,0,0,0,0,0,0,8,8,16,8,8,16,0,206,0,0,1,0.5,0,5.5,44,2,3
West Indies,176,217.33,7.15909,0.3125,225.278,7.57386,0.380682,110,ADS Fletcher,0,0,0,0,0,0,0,0,8,8,16,8,8,16,0,206,0,0,1,1.8125,0.125,13.5,62.6087,16,1
West Indies,176,217.33,7.15909,0.3125,225.278,7.57386,0.380682,110,DM Bravo,0,0,0,0,0,0,0,0,8,8,16,8,8,16,0,206,0,0,1,3,0.226667,28.52,67.4551,75,4
West Indies,176,217.33,7.15909,0.3125,225.278,7.57386,0.380682,110,MN Samuels,0,0,0,0,0,0,0,0,8,8,16,8,8,16,0,206,0,0,1,3.74757,0.23301,31.6214,74.5821,103,4
Sri Lanka,244,223.373,7.09016,0.344262,227.578,7.47541,0.385246,110,MDKJ Perera,0,0,0,0,0,0,0,0,22,12,34,22,12,34,207,180,4,1,1,3.30435,0.195652,25.7391,90.5199,46,0
Sri Lanka,244,223.373,7.09016,0.344262,227.578,7.47541,0.385246,110,TM Dilshan,0,0,0,0,0,0,0,0,22,12,34,22,12,34,207,180,4,1,1,4.60199,0.273632,38.3632,86.0219,201,4
Bangladesh,160,218.438,7.70625,0.4,211.106,7.05,0.325,111,Tamim Iqbal,0,0,0,0,0,0,0,0,12,6,18,12,6,18,0,273,1,1,1,4.05344,0.274809,31.8015,76.8068,131,4
Bangladesh,160,218.438,7.70625,0.4,211.106,7.05,0.325,111,Liton Das,0,0,0,0,0,0,0,0,12,6,18,12,6,18,0,273,1,1,1,1,0,7.66667,69.697,6,1
Bangladesh,160,218.438,7.70625,0.4,211.106,7.05,0.325,111,Mahmudullah,0,0,0,0,0,0,0,0,12,6,18,12,6,18,0,273,1,1,1,2.26531,0.153061,24.4286,70.9544,98,4
Zimbabwe,142,212.077,7.5,0.380282,227.704,6.97887,0.316901,111,CJ Chibhabha,0,0,0,0,0,0,0,0,4,8,12,4,8,12,274,128,1,0,1,2.56716,0.149254,23.5373,64.7373,67,1
Zimbabwe,142,212.077,7.5,0.380282,227.704,6.97887,0.316901,111,LM Jongwe,0,0,0,0,0,0,0,0,4,8,12,4,8,12,274,128,1,0,1,1.09091,0,11,65.7609,11,1
