Team,Total Matches Played,Runs Scored,Wickets Lost,Got All Out,Runs Conceded,Opponent Wickets Taken,Opponent All Out,Match Index,Batsman,Player Total Runs,Player Home Runs,Player Non Home Runs,Balls Faced,R0,W0,R1,W1,Current_HR,Current_NHR,Total Runs in Segment,Total HR till Segment,Total NHR till Segment,Total Runs Till Segment,Target,Final Runs Made,Extras,Home,Segment,Home Run Hitting Ability,Milestone Reaching Ability,Batting Average,Strike Rate,Matches Played,ClusterID
England,221,237.176,7.17647,0.289593,230.633,7.45701,0.384615,1,VS Solanki,36,18,18,23,220,4,38,0,12,25,37,132,163,295,0,321,26,1,10,2,0,27,101.887,2,0
England,221,237.176,7.17647,0.289593,230.633,7.45701,0.384615,1,JWM Dalrymple,16,8,8,21,220,4,38,0,12,25,37,132,163,295,0,321,26,1,10,1.41667,0.0833333,19,73.7864,24,1
England,221,237.176,7.17647,0.289593,230.633,7.45701,0.384615,1,GO Jones,0,0,0,0,220,4,38,0,12,25,37,132,163,295,0,321,26,1,10,1.5,0,15.5,110.714,6,0
England,221,237.176,7.17647,0.289593,230.633,7.45701,0.384615,1,TT Bresnan,0,0,0,0,220,4,38,0,12,25,37,132,163,295,0,321,26,1,10,1.52381,0.015873,13.8095,88.4146,63,0
England,221,237.176,7.17647,0.289593,230.633,7.45701,0.384615,1,LE Plunkett,0,0,0,0,220,4,38,0,12,25,37,132,163,295,0,321,26,1,10,1.38095,0,13.1905,113.992,21,0
India,259,242.378,7.15058,0.339768,244.568,7.12741,0.30888,2,AB Agarkar,0,0,0,1,124,4,21,4,16,14,30,62,113,175,0,191,16,0,10,0.3125,0,5.75,44.6602,16,3
India,259,242.378,7.15058,0.339768,244.568,7.12741,0.30888,2,MM Patel,0,0,0,0,124,4,21,4,16,14,30,62,113,175,0,191,16,0,10,0.363636,0,3.22727,66.9811,22,1
India,259,242.378,7.15058,0.339768,244.568,7.12741,0.30888,2,Z Khan,0,0,0,4,124,4,21,4,16,14,30,62,113,175,0,191,16,0,10,0.974359,0,8.35897,60.9346,39,1
Bangladesh,160,218.438,7.70625,0.4,211.106,7.05,0.325,2,Mushfiqur Rahim,51,24,27,97,152,4,19,1,0,8,8,98,81,179,192,192,13,0,10,2.61111,0.18254,27.7778,75.2526,126,4
Bangladesh,160,218.438,7.70625,0.4,211.106,7.05,0.325,2,Mohammad Ashraful,5,4,1,13,152,4,19,1,0,8,8,98,81,179,192,192,13,0,10,2.17722,0.113924,19.4557,63.9085,79,1
England,221,237.176,7.17647,0.289593,230.633,7.45701,0.384615,4,PD Collingwood,51,20,31,68,155,4,29,1,44,20,64,112,136,248,0,266,18,0,10,2.62366,0.193548,30.5161,76.8065,93,4
England,221,237.176,7.17647,0.289593,230.633,7.45701,0.384615,4,PA Nixon,4,0,4,6,155,4,29,1,44,20,64,112,136,248,0,266,18,0,10,1.35294,0,16,79.3003,17,1
England,221,237.176,7.17647,0.289593,230.633,7.45701,0.384615,4,RS Bopara,0,0,0,0,155,4,29,1,44,20,64,112,136,248,0,266,18,0,10,2.22115,0.144231,25.1538,75.9361,104,4
Ireland,55,219.527,7.65455,0.290909,202.727,7.56364,0.4,4,AR White,28,8,20,30,138,6,45,1,8,10,18,60,141,201,267,218,17,0,10,1.17647,0,14.1765,59.9502,17,1
Ireland,55,219.527,7.65455,0.290909,202.727,7.56364,0.4,4,D Langford-Smith,0,0,0,0,138,6,45,1,8,10,18,60,141,201,267,218,17,0,10,0.888889,0,8.66667,92.8571,9,0
Ireland,55,219.527,7.65455,0.290909,202.727,7.56364,0.4,4,WB Rankin,0,0,0,0,138,6,45,1,8,10,18,60,141,201,267,218,17,0,10,0.0833333,0,3.08333,35.9223,12,3
Ireland,55,219.527,7.65455,0.290909,202.727,7.56364,0.4,4,WK McCallan,2,0,2,1,138,6,45,1,8,10,18,60,141,201,267,218,17,0,10,0.692308,0,7.69231,56.8182,13,3
West Indies,176,217.33,7.15909,0.3125,225.278,7.57386,0.380682,6,S Chanderpaul,33,20,13,38,232,4,24,1,8,18,26,156,126,282,0,300,18,1,10,3.57143,0.396825,40.8254,68.0783,63,4
West Indies,176,217.33,7.15909,0.3125,225.278,7.57386,0.380682,6,DJ Bravo,11,4,7,8,232,4,24,1,8,18,26,156,126,282,0,300,18,1,10,2.35514,0.11215,23.1589,80.9011,107,4
West Indies,176,217.33,7.15909,0.3125,225.278,7.57386,0.380682,6,D Ramdin,0,0,0,0,232,4,24,1,8,18,26,156,126,282,0,300,18,1,10,1.7439,0.097561,19.1951,81.1759,82,1
West Indies,176,217.33,7.15909,0.3125,225.278,7.57386,0.380682,6,JE Taylor,0,0,0,0,232,4,24,1,8,18,26,156,126,282,0,300,18,1,10,0.903226,0,6.96774,83.3977,31,1
West Indies,176,217.33,7.15909,0.3125,225.278,7.57386,0.380682,6,DBL Powell,0,0,0,0,232,4,24,1,8,18,26,156,126,282,0,300,18,1,10,0.529412,0,5.76471,77.1654,17,1
West Indies,176,217.33,7.15909,0.3125,225.278,7.57386,0.380682,6,CD Collymore,0,0,0,0,232,4,24,1,8,18,26,156,126,282,0,300,18,1,10,0.333333,0,3.22222,59.1837,9,3
England,221,237.176,7.17647,0.289593,230.633,7.45701,0.384615,6,KP Pietersen,88,36,52,87,200,6,37,0,26,16,42,126,153,279,301,301,22,0,10,3.69892,0.236559,33.4946,82.2117,93,4
England,221,237.176,7.17647,0.289593,230.633,7.45701,0.384615,6,PA Nixon,15,0,15,24,200,6,37,0,26,16,42,126,153,279,301,301,22,0,10,1.35294,0,16,79.3003,17,1
England,221,237.176,7.17647,0.289593,230.633,7.45701,0.384615,6,LE Plunkett,0,0,0,0,200,6,37,0,26,16,42,126,153,279,301,301,22,0,10,1.38095,0,13.1905,113.992,21,0
England,221,237.176,7.17647,0.289593,230.633,7.45701,0.384615,6,SCJ Broad,0,0,0,0,200,6,37,0,26,16,42,126,153,279,301,301,22,0,10,0.725806,0,8.04839,74.0356,62,1
England,221,237.176,7.17647,0.289593,230.633,7.45701,0.384615,6,JM Anderson,0,0,0,0,200,6,37,0,26,16,42,126,153,279,301,301,22,0,10,0.365385,0,3.92308,52.7132,52,3
New Zealand,184,233.745,7.39674,0.36413,227.951,7.30435,0.353261,7,CD McMillan,89,46,43,88,151,7,34,1,4,6,10,88,107,195,0,218,23,0,10,3.8125,0.1875,29.75,83.9506,16,4
New Zealand,184,233.745,7.39674,0.36413,227.951,7.30435,0.353261,7,MR Gillespie,0,0,0,4,151,7,34,1,4,6,10,88,107,195,0,218,23,0,10,0.9,0,8,84.2105,10,1
Australia,228,239.627,7.69737,0.372807,232.079,7.23246,0.337719,7,NW Bracken,3,0,3,3,161,5,24,2,10,13,23,102,106,208,219,224,16,1,10,0.391304,0,4.91304,62.4309,23,1
Australia,228,239.627,7.69737,0.372807,232.079,7.23246,0.337719,7,MEK Hussey,54,24,30,68,161,5,24,2,10,13,23,102,106,208,219,224,16,1,10,2.7563,0.260504,34.084,82.4893,119,4
Australia,228,239.627,7.69737,0.372807,232.079,7.23246,0.337719,7,SR Clark,0,0,0,0,161,5,24,2,10,13,23,102,106,208,219,224,16,1,10,0.285714,0,4,54.902,7,3
England,221,237.176,7.17647,0.289593,230.633,7.45701,0.384615,8,PD Collingwood,86,20,66,111,183,5,29,0,24,24,48,106,154,260,0,270,10,0,10,2.62366,0.193548,30.5161,76.8065,93,4
England,221,237.176,7.17647,0.289593,230.633,7.45701,0.384615,8,JWM Dalrymple,16,8,8,16,183,5,29,0,24,24,48,106,154,260,0,270,10,0,10,1.41667,0.0833333,19,73.7864,24,1
England,221,237.176,7.17647,0.289593,230.633,7.45701,0.384615,8,PA Nixon,0,0,0,0,183,5,29,0,24,24,48,106,154,260,0,270,10,0,10,1.35294,0,16,79.3003,17,1
England,221,237.176,7.17647,0.289593,230.633,7.45701,0.384615,8,LE Plunkett,0,0,0,0,183,5,29,0,24,24,48,106,154,260,0,270,10,0,10,1.38095,0,13.1905,113.992,21,0
New Zealand,184,233.745,7.39674,0.36413,227.951,7.30435,0.353261,8,DL Vettori,5,4,1,4,176,3,24,3,16,21,37,88,149,237,271,256,19,0,10,1.43662,0.028169,15.7606,86.0108,71,0
New Zealand,184,233.745,7.39674,0.36413,227.951,7.30435,0.353261,8,SP Fleming,104,44,60,149,176,3,24,3,16,21,37,88,149,237,271,256,19,0,10,3.875,0.25,30.2917,70.9268,24,4
New Zealand,184,233.745,7.39674,0.36413,227.951,7.30435,0.353261,8,JEC Franklin,0,0,0,0,176,3,24,3,16,21,37,88,149,237,271,256,19,0,10,1.67308,0.0769231,18.7115,77.5299,52,1
New Zealand,184,233.745,7.39674,0.36413,227.951,7.30435,0.353261,8,SE Bond,0,0,0,0,176,3,24,3,16,21,37,88,149,237,271,256,19,0,10,0.5,0,7,71.7949,20,1
Bangladesh,160,218.438,7.70625,0.4,211.106,7.05,0.325,9,Shahriar Nafees,107,70,37,153,149,3,35,2,4,26,30,106,108,214,0,231,17,0,10,3.40541,0.162162,24.4865,69.1076,37,4
Bangladesh,160,218.438,7.70625,0.4,211.106,7.05,0.325,9,Mashrafe Mortaza,2,0,2,1,149,3,35,2,4,26,30,106,108,214,0,231,17,0,10,1.27536,0,11.1594,76.9231,69,1
Bangladesh,160,218.438,7.70625,0.4,211.106,7.05,0.325,9,Mohammad Rafique,0,0,0,0,149,3,35,2,4,26,30,106,108,214,0,231,17,0,10,0.5,0,8.16667,63.2258,12,1
India,259,242.378,7.15058,0.339768,244.568,7.12741,0.30888,10,MS Dhoni,23,4,19,51,144,5,24,1,16,24,40,92,116,208,0,223,15,1,10,3.47872,0.292553,36.7713,84.1612,188,4
India,259,242.378,7.15058,0.339768,244.568,7.12741,0.30888,10,Harbhajan Singh,4,0,4,5,144,5,24,1,16,24,40,92,116,208,0,223,15,1,10,0.901639,0,9.98361,76.4115,61,1
India,259,242.378,7.15058,0.339768,244.568,7.12741,0.30888,10,AB Agarkar,0,0,0,0,144,5,24,1,16,24,40,92,116,208,0,223,15,1,10,0.3125,0,5.75,44.6602,16,3
India,259,242.378,7.15058,0.339768,244.568,7.12741,0.30888,10,RP Singh,0,0,0,0,144,5,24,1,16,24,40,92,116,208,0,223,15,1,10,0.333333,0,5.6,39.8104,15,3
West Indies,176,217.33,7.15909,0.3125,225.278,7.57386,0.380682,10,RS Morton,30,6,24,56,157,3,24,0,16,13,29,94,116,210,224,224,14,0,10,2.2963,0.222222,28.8889,67.0103,27,4
West Indies,176,217.33,7.15909,0.3125,225.278,7.57386,0.380682,10,RR Sarwan,50,8,42,78,157,3,24,0,16,13,29,94,116,210,224,224,14,0,10,2.8254,0.222222,29.1429,69.1005,63,4
West Indies,176,217.33,7.15909,0.3125,225.278,7.57386,0.380682,10,BC Lara,0,0,0,0,157,3,24,0,16,13,29,94,116,210,224,224,14,0,10,3.35714,0.178571,29.3571,75.7604,28,4
West Indies,176,217.33,7.15909,0.3125,225.278,7.57386,0.380682,10,MN Samuels,0,0,0,0,157,3,24,0,16,13,29,94,116,210,224,224,14,0,10,3.74757,0.23301,31.6214,74.5821,103,4
West Indies,176,217.33,7.15909,0.3125,225.278,7.57386,0.380682,10,DR Smith,0,0,0,0,157,3,24,0,16,13,29,94,116,210,224,224,14,0,10,2.5,0.12,17.96,84.5574,50,1
West Indies,176,217.33,7.15909,0.3125,225.278,7.57386,0.380682,10,CS Baugh,0,0,0,0,157,3,24,0,16,13,29,94,116,210,224,224,14,0,10,1.04545,0,14,60.9901,22,1
West Indies,176,217.33,7.15909,0.3125,225.278,7.57386,0.380682,13,RS Morton,64,26,38,77,158,3,52,1,28,27,55,128,137,265,0,289,24,0,10,2.2963,0.222222,28.8889,67.0103,27,4
West Indies,176,217.33,7.15909,0.3125,225.278,7.57386,0.380682,13,DJ Bravo,9,4,5,6,158,3,52,1,28,27,55,128,137,265,0,289,24,0,10,2.35514,0.11215,23.1589,80.9011,107,4
West Indies,176,217.33,7.15909,0.3125,225.278,7.57386,0.380682,13,DR Smith,0,0,0,0,158,3,52,1,28,27,55,128,137,265,0,289,24,0,10,2.5,0.12,17.96,84.5574,50,1
Australia,228,239.627,7.69737,0.372807,232.079,7.23246,0.337719,17,JR Hopes,2,0,2,5,182,4,29,1,6,12,18,92,137,229,0,236,7,1,10,2.09259,0.0555556,21.2778,91.4809,54,0
Australia,228,239.627,7.69737,0.372807,232.079,7.23246,0.337719,17,MEK Hussey,15,0,15,23,182,4,29,1,6,12,18,92,137,229,0,236,7,1,10,2.7563,0.260504,34.084,82.4893,119,4
Australia,228,239.627,7.69737,0.372807,232.079,7.23246,0.337719,17,GB Hogg,0,0,0,0,182,4,29,1,6,12,18,92,137,229,0,236,7,1,10,0.769231,0,13.6923,69.5312,13,1
Australia,228,239.627,7.69737,0.372807,232.079,7.23246,0.337719,17,B Lee,0,0,0,0,182,4,29,1,6,12,18,92,137,229,0,236,7,1,10,1.09091,0.0227273,10.8182,81.5068,44,1
Australia,228,239.627,7.69737,0.372807,232.079,7.23246,0.337719,17,MG Johnson,0,0,0,0,182,4,29,1,6,12,18,92,137,229,0,236,7,1,10,1.18519,0.0246914,10.7901,94.181,81,0
Australia,228,239.627,7.69737,0.372807,232.079,7.23246,0.337719,17,NW Bracken,0,0,0,0,182,4,29,1,6,12,18,92,137,229,0,236,7,1,10,0.391304,0,4.91304,62.4309,23,1
Sri Lanka,244,223.373,7.09016,0.344262,227.578,7.47541,0.385246,17,KC Sangakkara,80,16,64,111,149,7,13,2,0,0,0,64,98,162,237,173,11,0,10,4.33659,0.360976,41.9854,80.6276,205,4
New Zealand,184,233.745,7.39674,0.36413,227.951,7.30435,0.353261,19,KD Mills,12,4,8,22,105,7,17,0,32,15,47,74,95,169,0,182,13,0,10,1.52542,0.0338983,12.8644,90.7895,59,0
New Zealand,184,233.745,7.39674,0.36413,227.951,7.30435,0.353261,19,GD Elliott,44,8,36,91,105,7,17,0,32,15,47,74,95,169,0,182,13,0,10,2.67188,0.203125,29.4375,79.7629,64,4
New Zealand,184,233.745,7.39674,0.36413,227.951,7.30435,0.353261,19,TG Southee,0,0,0,0,105,7,17,0,32,15,47,74,95,169,0,182,13,0,10,0.764706,0,7.03922,92.7649,51,0
England,221,237.176,7.17647,0.289593,230.633,7.45701,0.384615,19,CT Tremlett,1,0,1,10,123,7,10,1,0,3,3,60,76,136,183,160,24,1,10,0.4,0,4.2,57.5342,10,3
England,221,237.176,7.17647,0.289593,230.633,7.45701,0.384615,19,SCJ Broad,16,0,16,29,123,7,10,1,0,3,3,60,76,136,183,160,24,1,10,0.725806,0,8.04839,74.0356,62,1
England,221,237.176,7.17647,0.289593,230.633,7.45701,0.384615,19,JM Anderson,0,0,0,0,123,7,10,1,0,3,3,60,76,136,183,160,24,1,10,0.365385,0,3.92308,52.7132,52,3
New Zealand,184,233.745,7.39674,0.36413,227.951,7.30435,0.353261,21,KD Mills,1,0,1,1,144,5,29,1,34,16,50,96,127,223,0,238,15,0,10,1.52542,0.0338983,12.8644,90.7895,59,0
New Zealand,184,233.745,7.39674,0.36413,227.951,7.30435,0.353261,21,MS Sinclair,42,4,38,64,144,5,29,1,34,16,50,96,127,223,0,238,15,0,10,2.4,0.2,24.4,91.7293,5,0
New Zealand,184,233.745,7.39674,0.36413,227.951,7.30435,0.353261,21,DL Vettori,0,0,0,0,144,5,29,1,34,16,50,96,127,223,0,238,15,0,10,1.43662,0.028169,15.7606,86.0108,71,0
South Africa,190,234.274,7.4,0.373684,232.363,7.33158,0.342105,21,MV Boucher,25,16,9,24,201,4,27,1,4,1,5,130,103,233,239,242,9,1,10,2.21053,0.0877193,22.2281,89.3512,57,0
South Africa,190,234.274,7.4,0.373684,232.363,7.33158,0.342105,21,SM Pollock,0,0,0,5,201,4,27,1,4,1,5,130,103,233,239,242,9,1,10,1.58621,0.0689655,16.931,82.3826,29,1
South Africa,190,234.274,7.4,0.373684,232.363,7.33158,0.342105,22,SM Pollock,1,0,1,1,165,3,26,2,10,18,28,88,131,219,0,233,14,0,10,1.58621,0.0689655,16.931,82.3826,29,1
South Africa,190,234.274,7.4,0.373684,232.363,7.33158,0.342105,22,JH Kallis,70,12,58,121,165,3,26,2,10,18,28,88,131,219,0,233,14,0,10,3.58621,0.356322,37.2644,76.4442,87,4
South Africa,190,234.274,7.4,0.373684,232.363,7.33158,0.342105,22,JA Morkel,0,0,0,0,165,3,26,2,10,18,28,88,131,219,0,233,14,0,10,2.42424,0.0606061,19.9697,99.5468,33,0
South Africa,190,234.274,7.4,0.373684,232.363,7.33158,0.342105,22,A Nel,0,0,0,0,165,3,26,2,10,18,28,88,131,219,0,233,14,0,10,1.06667,0,7.66667,81.5603,15,1
South Africa,190,234.274,7.4,0.373684,232.363,7.33158,0.342105,22,J Botha,0,0,0,0,165,3,26,2,10,18,28,88,131,219,0,233,14,0,10,1.09756,0,11.561,82.2917,41,1
South Africa,190,234.274,7.4,0.373684,232.363,7.33158,0.342105,22,M Ntini,0,0,0,0,165,3,26,2,10,18,28,88,131,219,0,233,14,0,10,0.375,0,3.25,63.4146,16,1
Pakistan,211,222.621,7.38389,0.393365,235.517,7.54976,0.336493,22,Abdur Rehman,2,0,2,6,191,4,14,3,4,1,5,106,104,210,234,219,9,1,10,0.52381,0,6.04762,55.7018,21,3
Pakistan,211,222.621,7.38389,0.393365,235.517,7.54976,0.336493,22,Shahid Afridi,9,6,3,10,191,4,14,3,4,1,5,106,104,210,234,219,9,1,10,2.72917,0.0972222,21.4097,127.766,144,0
Pakistan,211,222.621,7.38389,0.393365,235.517,7.54976,0.336493,22,Iftikhar Anjum,0,0,0,0,191,4,14,3,4,1,5,106,104,210,234,219,9,1,10,0.666667,0,7.33333,58.7786,21,3
Pakistan,211,222.621,7.38389,0.393365,235.517,7.54976,0.336493,22,Shoaib Akhtar,0,0,0,0,191,4,14,3,4,1,5,106,104,210,234,219,9,1,10,0.421053,0,3.21053,67.033,19,1
Zimbabwe,142,212.077,7.5,0.380282,227.704,6.97887,0.316901,23,S Matsikenyeri,36,16,20,37,165,4,39,0,12,18,30,124,110,234,0,247,13,1,10,2,0.106383,19.9787,75.7869,47,1
Zimbabwe,142,212.077,7.5,0.380282,227.704,6.97887,0.316901,23,SC Williams,47,16,31,46,165,4,39,0,12,18,30,124,110,234,0,247,13,1,10,2.56923,0.276923,28.5385,80.7927,65,4
Zimbabwe,142,212.077,7.5,0.380282,227.704,6.97887,0.316901,23,E Chigumbura,0,0,0,0,165,4,39,0,12,18,30,124,110,234,0,247,13,1,10,2.28947,0.114035,22.7895,77.7844,114,4
Zimbabwe,142,212.077,7.5,0.380282,227.704,6.97887,0.316901,23,KM Dabengwa,0,0,0,0,165,4,39,0,12,18,30,124,110,234,0,247,13,1,10,1.2,0,16.7,61.1722,20,1
Zimbabwe,142,212.077,7.5,0.380282,227.704,6.97887,0.316901,23,GB Brent,0,0,0,0,165,4,39,0,12,18,30,124,110,234,0,247,13,1,10,0.75,0.0625,10.5,61.5385,16,1
Australia,228,239.627,7.69737,0.372807,232.079,7.23246,0.337719,24,MEK Hussey,35,0,35,53,182,4,29,1,18,23,41,90,162,252,0,273,21,0,10,2.7563,0.260504,34.084,82.4893,119,4
Australia,228,239.627,7.69737,0.372807,232.079,7.23246,0.337719,24,CL White,0,0,0,1,182,4,29,1,18,23,41,90,162,252,0,273,21,0,10,2.66176,0.191176,28.8235,80.1308,68,4
Australia,228,239.627,7.69737,0.372807,232.079,7.23246,0.337719,24,JR Hopes,0,0,0,0,182,4,29,1,18,23,41,90,162,252,0,273,21,0,10,2.09259,0.0555556,21.2778,91.4809,54,0
Australia,228,239.627,7.69737,0.372807,232.079,7.23246,0.337719,24,B Lee,0,0,0,0,182,4,29,1,18,23,41,90,162,252,0,273,21,0,10,1.09091,0.0227273,10.8182,81.5068,44,1
Australia,228,239.627,7.69737,0.372807,232.079,7.23246,0.337719,24,MG Johnson,0,0,0,0,182,4,29,1,18,23,41,90,162,252,0,273,21,0,10,1.18519,0.0246914,10.7901,94.181,81,0
Australia,228,239.627,7.69737,0.372807,232.079,7.23246,0.337719,27,MEK Hussey,49,4,45,71,160,3,26,1,22,25,47,68,165,233,0,254,21,1,10,2.7563,0.260504,34.084,82.4893,119,4
Australia,228,239.627,7.69737,0.372807,232.079,7.23246,0.337719,27,BJ Haddin,1,0,1,11,160,3,26,1,22,25,47,68,165,233,0,254,21,1,10,3.14737,0.147368,26.7789,81.382,95,4
Australia,228,239.627,7.69737,0.372807,232.079,7.23246,0.337719,27,CL White,0,0,0,0,160,3,26,1,22,25,47,68,165,233,0,254,21,1,10,2.66176,0.191176,28.8235,80.1308,68,4
Australia,228,239.627,7.69737,0.372807,232.079,7.23246,0.337719,27,MG Johnson,0,0,0,0,160,3,26,1,22,25,47,68,165,233,0,254,21,1,10,1.18519,0.0246914,10.7901,94.181,81,0
Bangladesh,160,218.438,7.70625,0.4,211.106,7.05,0.325,28,Mashrafe Mortaza,36,4,32,63,147,8,31,0,0,13,13,56,135,191,0,210,19,0,10,1.27536,0,11.1594,76.9231,69,1
Bangladesh,160,218.438,7.70625,0.4,211.106,7.05,0.325,28,Shakib Al Hasan,98,32,66,112,147,8,31,0,0,13,13,56,135,191,0,210,19,0,10,2.86992,0.252033,29.9106,79.0163,123,4
Bangladesh,160,218.438,7.70625,0.4,211.106,7.05,0.325,28,Shahadat Hossain,0,0,0,0,147,8,31,0,0,13,13,56,135,191,0,210,19,0,10,0.375,0,3.5625,50.4425,16,3
England,221,237.176,7.17647,0.289593,230.633,7.45701,0.384615,29,SCJ Broad,7,0,7,10,202,5,42,1,28,18,46,142,148,290,0,299,9,1,10,0.725806,0,8.04839,74.0356,62,1
England,221,237.176,7.17647,0.289593,230.633,7.45701,0.384615,29,EJG Morgan,52,30,22,38,202,5,42,1,28,18,46,142,148,290,0,299,9,1,10,3.19549,0.233083,30.0526,86.9291,133,4
England,221,237.176,7.17647,0.289593,230.633,7.45701,0.384615,29,AU Rashid,0,0,0,0,202,5,42,1,28,18,46,142,148,290,0,299,9,1,10,2.41176,0.0588235,17.2941,108.889,17,0
England,221,237.176,7.17647,0.289593,230.633,7.45701,0.384615,29,TT Bresnan,0,0,0,0,202,5,42,1,28,18,46,142,148,290,0,299,9,1,10,1.52381,0.015873,13.8095,88.4146,63,0
England,221,237.176,7.17647,0.289593,230.633,7.45701,0.384615,29,RJ Sidebottom,0,0,0,0,202,5,42,1,28,18,46,142,148,290,0,299,9,1,10,0.6875,0,7.6875,65.7754,16,1
Australia,228,239.627,7.69737,0.372807,232.079,7.23246,0.337719,29,CL White,11,8,3,6,225,4,40,2,18,12,30,164,131,295,300,302,7,0,10,2.66176,0.191176,28.8235,80.1308,68,4
Australia,228,239.627,7.69737,0.372807,232.079,7.23246,0.337719,29,MG Johnson,1,0,1,1,225,4,40,2,18,12,30,164,131,295,300,302,7,0,10,1.18519,0.0246914,10.7901,94.181,81,0
Australia,228,239.627,7.69737,0.372807,232.079,7.23246,0.337719,30,BJ Haddin,15,4,11,18,188,4,22,2,0,23,23,84,149,233,0,249,16,1,10,3.14737,0.147368,26.7789,81.382,95,4
Australia,228,239.627,7.69737,0.372807,232.079,7.23246,0.337719,30,JR Hopes,0,0,0,1,188,4,22,2,0,23,23,84,149,233,0,249,16,1,10,2.09259,0.0555556,21.2778,91.4809,54,0
South Africa,190,234.274,7.4,0.373684,232.363,7.33158,0.342105,30,JP Duminy,29,8,21,29,160,4,25,1,26,23,49,66,168,234,250,244,10,0,10,2.3252,0.186992,29.9675,80.2351,123,4
South Africa,190,234.274,7.4,0.373684,232.363,7.33158,0.342105,30,MV Boucher,5,0,5,13,160,4,25,1,26,23,49,66,168,234,250,244,10,0,10,2.21053,0.0877193,22.2281,89.3512,57,0
South Africa,190,234.274,7.4,0.373684,232.363,7.33158,0.342105,30,JA Morkel,0,0,0,0,160,4,25,1,26,23,49,66,168,234,250,244,10,0,10,2.42424,0.0606061,19.9697,99.5468,33,0
Sri Lanka,244,223.373,7.09016,0.344262,227.578,7.47541,0.385246,33,AD Mathews,16,0,16,19,87,5,23,0,6,17,23,14,119,133,0,152,19,0,10,2.64122,0.198473,28.6794,82.3362,131,4
Sri Lanka,244,223.373,7.09016,0.344262,227.578,7.47541,0.385246,33,KMDN Kulasekara,0,0,0,0,87,5,23,0,6,17,23,14,119,133,0,152,19,0,10,1.21,0.04,11.8,80.9328,100,1
Sri Lanka,244,223.373,7.09016,0.344262,227.578,7.47541,0.385246,33,M Muralitharan,0,0,0,0,87,5,23,0,6,17,23,14,119,133,0,152,19,0,10,0.69697,0,5.63636,99.4652,33,0
Sri Lanka,244,223.373,7.09016,0.344262,227.578,7.47541,0.385246,33,BAW Mendis,0,0,0,0,87,5,23,0,6,17,23,14,119,133,0,152,19,0,10,0.447368,0,4.47368,66.4062,38,1
Sri Lanka,244,223.373,7.09016,0.344262,227.578,7.47541,0.385246,33,CRD Fernando,0,0,0,0,87,5,23,0,6,17,23,14,119,133,0,152,19,0,10,0.571429,0,5.42857,64.7727,21,1
South Africa,190,234.274,7.4,0.373684,232.363,7.33158,0.342105,35,AB de Villiers,111,48,63,80,234,3,54,0,34,18,52,142,198,340,0,354,14,1,10,5.04969,0.403727,47.2174,98.8428,161,4
South Africa,190,234.274,7.4,0.373684,232.363,7.33158,0.342105,35,AN Petersen,31,8,23,27,234,3,54,0,34,18,52,142,198,340,0,354,14,1,10,3.11111,0.222222,27.6667,81.6393,18,4
South Africa,190,234.274,7.4,0.373684,232.363,7.33158,0.342105,35,MV Boucher,0,0,0,0,234,3,54,0,34,18,52,142,198,340,0,354,14,1,10,2.21053,0.0877193,22.2281,89.3512,57,0
South Africa,190,234.274,7.4,0.373684,232.363,7.33158,0.342105,35,R McLaren,0,0,0,0,234,3,54,0,34,18,52,142,198,340,0,354,14,1,10,1.2,0.025,11.975,69.8251,40,1
Bangladesh,160,218.438,7.70625,0.4,211.106,7.05,0.325,36,Shakib Al Hasan,39,0,39,53,161,5,28,0,16,22,38,72,155,227,0,246,19,0,10,2.86992,0.252033,29.9106,79.0163,123,4
Bangladesh,160,218.438,7.70625,0.4,211.106,7.05,0.325,36,Mahmudullah,34,16,18,37,161,5,28,0,16,22,38,72,155,227,0,246,19,0,10,2.26531,0.153061,24.4286,70.9544,98,4
Bangladesh,160,218.438,7.70625,0.4,211.106,7.05,0.325,36,Naeem Islam,0,0,0,0,161,5,28,0,16,22,38,72,155,227,0,246,19,0,10,1.88889,0.111111,18.6889,67.496,45,1
Bangladesh,160,218.438,7.70625,0.4,211.106,7.05,0.325,36,Abdur Razzak,0,0,0,0,161,5,28,0,16,22,38,72,155,227,0,246,19,0,10,0.849315,0.0136986,8.39726,73.8554,73,1
Bangladesh,160,218.438,7.70625,0.4,211.106,7.05,0.325,36,Syed Rasel,0,0,0,0,161,5,28,0,16,22,38,72,155,227,0,246,19,0,10,0.222222,0,2.88889,37.6812,18,3
Bangladesh,160,218.438,7.70625,0.4,211.106,7.05,0.325,36,Rubel Hossain,0,0,0,0,161,5,28,0,16,22,38,72,155,227,0,246,19,0,10,0.32,0,2.68,52.3438,25,3
New Zealand,184,233.745,7.39674,0.36413,227.951,7.30435,0.353261,37,SE Bond,8,4,4,9,136,8,11,1,0,3,3,36,114,150,0,155,5,0,10,0.5,0,7,71.7949,20,1
New Zealand,184,233.745,7.39674,0.36413,227.951,7.30435,0.353261,37,IG Butler,5,0,5,25,136,8,11,1,0,3,3,36,114,150,0,155,5,0,10,1.14286,0,11.1429,62.9032,7,1
Pakistan,211,222.621,7.38389,0.393365,235.517,7.54976,0.336493,38,Fawad Alam,53,16,37,60,139,4,26,2,22,13,35,64,136,200,0,212,12,0,10,1.85294,0.176471,26.5588,72.6468,34,4
Pakistan,211,222.621,7.38389,0.393365,235.517,7.54976,0.336493,38,Sarfraz Ahmed,5,0,5,10,139,4,26,2,22,13,35,64,136,200,0,212,12,0,10,2.04878,0.097561,25.4878,83.9357,41,4
Pakistan,211,222.621,7.38389,0.393365,235.517,7.54976,0.336493,38,Naved-ul-Hasan,0,0,0,0,139,4,26,2,22,13,35,64,136,200,0,212,12,0,10,1.15,0,11.35,83.4559,20,1
Pakistan,211,222.621,7.38389,0.393365,235.517,7.54976,0.336493,38,Iftikhar Anjum,0,0,0,0,139,4,26,2,22,13,35,64,136,200,0,212,12,0,10,0.666667,0,7.33333,58.7786,21,3
Australia,228,239.627,7.69737,0.372807,232.079,7.23246,0.337719,38,MEK Hussey,27,4,23,39,145,6,25,1,16,17,33,74,129,203,213,213,10,1,10,2.7563,0.260504,34.084,82.4893,119,4
Australia,228,239.627,7.69737,0.372807,232.079,7.23246,0.337719,38,NM Hauritz,0,0,0,3,145,6,25,1,16,17,33,74,129,203,213,213,10,1,10,1.04,0.04,11.64,93.5691,25,0
Sri Lanka,244,223.373,7.09016,0.344262,227.578,7.47541,0.385246,39,KMDN Kulasekara,10,4,6,17,147,6,30,3,6,4,10,88,99,187,0,212,25,0,10,1.21,0.04,11.8,80.9328,100,1
Sri Lanka,244,223.373,7.09016,0.344262,227.578,7.47541,0.385246,39,BAW Mendis,2,0,2,8,147,6,30,3,6,4,10,88,99,187,0,212,25,0,10,0.447368,0,4.47368,66.4062,38,1
New Zealand,184,233.745,7.39674,0.36413,227.951,7.30435,0.353261,40,KD Mills,8,4,4,9,141,5,27,3,4,16,20,72,116,188,0,200,12,0,10,1.52542,0.0338983,12.8644,90.7895,59,0
New Zealand,184,233.745,7.39674,0.36413,227.951,7.30435,0.353261,40,JS Patel,3,0,3,4,141,5,27,3,4,16,20,72,116,188,0,200,12,0,10,0.7,0,8.4,60,10,3
New Zealand,184,233.745,7.39674,0.36413,227.951,7.30435,0.353261,40,SE Bond,0,0,0,0,141,5,27,3,4,16,20,72,116,188,0,200,12,0,10,0.5,0,7,71.7949,20,1
Australia,228,239.627,7.69737,0.372807,232.079,7.23246,0.337719,40,SR Watson,93,52,41,127,161,4,29,0,12,0,12,118,84,202,201,206,4,0,10,4.71318,0.286822,37.7907,90.0943,129,4
Australia,228,239.627,7.69737,0.372807,232.079,7.23246,0.337719,42,MEK Hussey,8,0,8,15,153,4,31,1,12,22,34,90,128,218,0,231,13,0,10,2.7563,0.260504,34.084,82.4893,119,4
Australia,228,239.627,7.69737,0.372807,232.079,7.23246,0.337719,42,JR Hopes,7,4,3,5,153,4,31,1,12,22,34,90,128,218,0,231,13,0,10,2.09259,0.0555556,21.2778,91.4809,54,0
Australia,228,239.627,7.69737,0.372807,232.079,7.23246,0.337719,42,NM Hauritz,0,0,0,0,153,4,31,1,12,22,34,90,128,218,0,231,13,0,10,1.04,0.04,11.64,93.5691,25,0
Australia,228,239.627,7.69737,0.372807,232.079,7.23246,0.337719,42,CJ McKay,0,0,0,0,153,4,31,1,12,22,34,90,128,218,0,231,13,0,10,0.615385,0,6.88462,55.0769,26,3
Bangladesh,160,218.438,7.70625,0.4,211.106,7.05,0.325,43,Mahmudullah,14,0,14,24,176,4,27,1,22,21,43,82,164,246,0,260,14,1,10,2.26531,0.153061,24.4286,70.9544,98,4
Bangladesh,160,218.438,7.70625,0.4,211.106,7.05,0.325,43,Naeem Islam,2,0,2,3,176,4,27,1,22,21,43,82,164,246,0,260,14,1,10,1.88889,0.111111,18.6889,67.496,45,1
Bangladesh,160,218.438,7.70625,0.4,211.106,7.05,0.325,43,Suhrawadi Shuvo,0,0,0,0,176,4,27,1,22,21,43,82,164,246,0,260,14,1,10,1,0,9.7,70.2899,10,1
England,221,237.176,7.17647,0.289593,230.633,7.45701,0.384615,43,EJG Morgan,78,22,56,90,193,5,24,2,22,13,35,106,146,252,261,261,9,0,10,3.19549,0.233083,30.0526,86.9291,133,4
England,221,237.176,7.17647,0.289593,230.633,7.45701,0.384615,43,GP Swann,1,0,1,1,193,5,24,2,22,13,35,106,146,252,261,261,9,0,10,1.08696,0,10.3043,90.631,46,0
England,221,237.176,7.17647,0.289593,230.633,7.45701,0.384615,43,JC Tredwell,0,0,0,0,193,5,24,2,22,13,35,106,146,252,261,261,9,0,10,0.52,0,6.52,65.9919,25,1
South Africa,190,234.274,7.4,0.373684,232.363,7.33158,0.342105,44,AN Petersen,29,12,17,28,201,4,30,0,32,16,48,134,145,279,0,295,16,1,10,3.11111,0.222222,27.6667,81.6393,18,4
South Africa,190,234.274,7.4,0.373684,232.363,7.33158,0.342105,44,JA Morkel,18,6,12,24,201,4,30,0,32,16,48,134,145,279,0,295,16,1,10,2.42424,0.0606061,19.9697,99.5468,33,0
South Africa,190,234.274,7.4,0.373684,232.363,7.33158,0.342105,44,R McLaren,0,0,0,0,201,4,30,0,32,16,48,134,145,279,0,295,16,1,10,1.2,0.025,11.975,69.8251,40,1
Zimbabwe,142,212.077,7.5,0.380282,227.704,6.97887,0.316901,44,T Taibu,73,24,49,95,151,5,41,0,28,16,44,96,140,236,296,250,14,0,10,2.36364,0.254545,29.4,71.0145,55,4
Zimbabwe,142,212.077,7.5,0.380282,227.704,6.97887,0.316901,44,S Matsikenyeri,73,28,45,85,151,5,41,0,28,16,44,96,140,236,296,250,14,0,10,2,0.106383,19.9787,75.7869,47,1
Zimbabwe,142,212.077,7.5,0.380282,227.704,6.97887,0.316901,44,AG Cremer,0,0,0,0,151,5,41,0,28,16,44,96,140,236,296,250,14,0,10,0.766667,0,10.5,54.6875,30,3
England,221,237.176,7.17647,0.289593,230.633,7.45701,0.384615,46,PD Collingwood,3,0,3,3,243,2,30,2,10,21,31,134,170,304,0,327,23,0,10,2.62366,0.193548,30.5161,76.8065,93,4
England,221,237.176,7.17647,0.289593,230.633,7.45701,0.384615,46,MJ Prior,4,4,0,2,243,2,30,2,10,21,31,134,170,304,0,327,23,0,10,2.27083,0.0625,21.6875,76.4879,48,4
England,221,237.176,7.17647,0.289593,230.633,7.45701,0.384615,46,TT Bresnan,0,0,0,0,243,2,30,2,10,21,31,134,170,304,0,327,23,0,10,1.52381,0.015873,13.8095,88.4146,63,0
England,221,237.176,7.17647,0.289593,230.633,7.45701,0.384615,46,MH Yardy,0,0,0,0,243,2,30,2,10,21,31,134,170,304,0,327,23,0,10,0.875,0.0833333,13.5833,66.5306,24,1
England,221,237.176,7.17647,0.289593,230.633,7.45701,0.384615,46,GP Swann,0,0,0,0,243,2,30,2,10,21,31,134,170,304,0,327,23,0,10,1.08696,0,10.3043,90.631,46,0
Ireland,55,219.527,7.65455,0.290909,202.727,7.56364,0.4,46,KJ O'Brien,106,88,18,60,233,5,28,1,20,15,35,186,110,296,328,329,33,0,10,2.64706,0.0588235,22.3824,79.4363,34,4
Ireland,55,219.527,7.65455,0.290909,202.727,7.56364,0.4,46,JF Mooney,12,8,4,15,233,5,28,1,20,15,35,186,110,296,328,329,33,0,10,1.47619,0,13.7619,72.796,21,1
Ireland,55,219.527,7.65455,0.290909,202.727,7.56364,0.4,46,DT Johnston,0,0,0,0,233,5,28,1,20,15,35,186,110,296,328,329,33,0,10,1.27273,0,12.1818,74.2382,22,1
Sri Lanka,244,223.373,7.09016,0.344262,227.578,7.47541,0.385246,47,NLTC Perera,1,0,1,1,225,0,49,1,20,18,38,154,158,312,0,327,15,1,10,1.65333,0.0666667,14.32,105.397,75,0
Sri Lanka,244,223.373,7.09016,0.344262,227.578,7.47541,0.385246,47,TM Dilshan,140,66,74,130,225,0,49,1,20,18,38,154,158,312,0,327,15,1,10,4.60199,0.273632,38.3632,86.0219,201,4
Sri Lanka,244,223.373,7.09016,0.344262,227.578,7.47541,0.385246,47,DPMD Jayawardene,0,0,0,0,225,0,49,1,20,18,38,154,158,312,0,327,15,1,10,3.20833,0.244792,31.6979,79.1109,192,4
Sri Lanka,244,223.373,7.09016,0.344262,227.578,7.47541,0.385246,47,KC Sangakkara,0,0,0,0,225,0,49,1,20,18,38,154,158,312,0,327,15,1,10,4.33659,0.360976,41.9854,80.6276,205,4
Sri Lanka,244,223.373,7.09016,0.344262,227.578,7.47541,0.385246,47,AD Mathews,0,0,0,0,225,0,49,1,20,18,38,154,158,312,0,327,15,1,10,2.64122,0.198473,28.6794,82.3362,131,4
Sri Lanka,244,223.373,7.09016,0.344262,227.578,7.47541,0.385246,47,LPC Silva,0,0,0,0,225,0,49,1,20,18,38,154,158,312,0,327,15,1,10,2.55556,0.244444,26.0222,69.4543,45,4
Sri Lanka,244,223.373,7.09016,0.344262,227.578,7.47541,0.385246,47,TT Samaraweera,0,0,0,0,225,0,49,1,20,18,38,154,158,312,0,327,15,1,10,2.19231,0.0769231,23.4231,73.8182,26,4
England,221,237.176,7.17647,0.289593,230.633,7.45701,0.384615,48,TT Bresnan,8,0,8,16,178,7,22,1,12,9,21,94,127,221,0,243,22,0,10,1.52381,0.015873,13.8095,88.4146,63,0
England,221,237.176,7.17647,0.289593,230.633,7.45701,0.384615,48,GP Swann,2,0,2,4,178,7,22,1,12,9,21,94,127,221,0,243,22,0,10,1.08696,0,10.3043,90.631,46,0
England,221,237.176,7.17647,0.289593,230.633,7.45701,0.384615,48,CT Tremlett,0,0,0,0,178,7,22,1,12,9,21,94,127,221,0,243,22,0,10,0.4,0,4.2,57.5342,10,3
England,221,237.176,7.17647,0.289593,230.633,7.45701,0.384615,49,MJ Prior,3,0,3,5,169,3,19,2,12,20,32,48,172,220,0,229,9,0,10,2.27083,0.0625,21.6875,76.4879,48,4
England,221,237.176,7.17647,0.289593,230.633,7.45701,0.384615,49,IJL Trott,74,4,70,104,169,3,19,2,12,20,32,48,172,220,0,229,9,0,10,3.3871,0.403226,43.7903,75.2494,62,4
England,221,237.176,7.17647,0.289593,230.633,7.45701,0.384615,49,LJ Wright,0,0,0,0,169,3,19,2,12,20,32,48,172,220,0,229,9,0,10,1.92105,0.0263158,17.2368,81.875,38,1
India,259,242.378,7.15058,0.339768,244.568,7.12741,0.30888,50,SK Raina,102,42,60,116,187,6,38,2,4,6,10,100,135,235,0,245,10,0,10,3.11111,0.216374,28.9064,91.8944,171,0
India,259,242.378,7.15058,0.339768,244.568,7.12741,0.30888,50,S Sreesanth,0,0,0,0,187,6,38,2,4,6,10,100,135,235,0,245,10,0,10,0.125,0,2.4375,32.5,16,3
India,259,242.378,7.15058,0.339768,244.568,7.12741,0.30888,50,A Nehra,0,0,0,1,187,6,38,2,4,6,10,100,135,235,0,245,10,0,10,0.263158,0,2.84211,43.2,19,3
Sri Lanka,244,223.373,7.09016,0.344262,227.578,7.47541,0.385246,50,S Randiv,14,4,10,22,193,5,25,0,16,9,25,100,143,243,246,249,6,0,10,1.6875,0.0625,15.875,69.9725,16,1
Sri Lanka,244,223.373,7.09016,0.344262,227.578,7.47541,0.385246,50,DPMD Jayawardene,55,8,47,76,193,5,25,0,16,9,25,100,143,243,246,249,6,0,10,3.20833,0.244792,31.6979,79.1109,192,4
Sri Lanka,244,223.373,7.09016,0.344262,227.578,7.47541,0.385246,50,NLTC Perera,0,0,0,0,193,5,25,0,16,9,25,100,143,243,246,249,6,0,10,1.65333,0.0666667,14.32,105.397,75,0
West Indies,176,217.33,7.15909,0.3125,225.278,7.57386,0.380682,51,N Deonarine,33,14,19,37,156,5,36,0,24,22,46,92,146,238,0,252,14,1,10,2.09091,0.136364,20.9545,65.7632,22,1
West Indies,176,217.33,7.15909,0.3125,225.278,7.57386,0.380682,51,KA Pollard,18,10,8,14,156,5,36,0,24,22,46,92,146,238,0,252,14,1,10,2.70513,0.115385,24.5,88.0645,78,4
West Indies,176,217.33,7.15909,0.3125,225.278,7.57386,0.380682,51,DJG Sammy,0,0,0,0,156,5,36,0,24,22,46,92,146,238,0,252,14,1,10,2.25,0.09,18.25,95.8005,100,0
South Africa,190,234.274,7.4,0.373684,232.363,7.33158,0.342105,51,J Botha,18,0,18,29,183,5,20,1,24,13,37,74,166,240,253,255,15,0,10,1.09756,0,11.561,82.2917,41,1
South Africa,190,234.274,7.4,0.373684,232.363,7.33158,0.342105,51,R McLaren,1,0,1,8,183,5,20,1,24,13,37,74,166,240,253,255,15,0,10,1.2,0.025,11.975,69.8251,40,1
South Africa,190,234.274,7.4,0.373684,232.363,7.33158,0.342105,51,RE van der Merwe,0,0,0,0,183,5,20,1,24,13,37,74,166,240,253,255,15,0,10,0.714286,0,5.57143,95.122,7,0
South Africa,190,234.274,7.4,0.373684,232.363,7.33158,0.342105,51,CK Langeveldt,0,0,0,0,183,5,20,1,24,13,37,74,166,240,253,255,15,0,10,0.571429,0,4.71429,59.4595,14,3
South Africa,190,234.274,7.4,0.373684,232.363,7.33158,0.342105,51,LL Tsotsobe,0,0,0,0,183,5,20,1,24,13,37,74,166,240,253,255,15,0,10,0.444444,0,3.16667,50.8929,18,3
England,221,237.176,7.17647,0.289593,230.633,7.45701,0.384615,52,MH Yardy,16,8,8,13,213,5,31,1,24,15,39,112,171,283,0,299,16,0,10,0.875,0.0833333,13.5833,66.5306,24,1
England,221,237.176,7.17647,0.289593,230.633,7.45701,0.384615,52,PD Collingwood,15,6,9,17,213,5,31,1,24,15,39,112,171,283,0,299,16,0,10,2.62366,0.193548,30.5161,76.8065,93,4
England,221,237.176,7.17647,0.289593,230.633,7.45701,0.384615,52,A Shahzad,0,0,0,0,213,5,31,1,24,15,39,112,171,283,0,299,16,0,10,0.375,0,4.875,62.9032,8,1
England,221,237.176,7.17647,0.289593,230.633,7.45701,0.384615,52,CT Tremlett,0,0,0,0,213,5,31,1,24,15,39,112,171,283,0,299,16,0,10,0.4,0,4.2,57.5342,10,3
Australia,228,239.627,7.69737,0.372807,232.079,7.23246,0.337719,52,SPD Smith,32,8,24,38,190,7,24,0,20,24,44,90,168,258,300,278,20,1,10,3.19298,0.22807,34.5614,87.0526,57,4
Australia,228,239.627,7.69737,0.372807,232.079,7.23246,0.337719,52,B Lee,9,4,5,12,190,7,24,0,20,24,44,90,168,258,300,278,20,1,10,1.09091,0.0227273,10.8182,81.5068,44,1
South Africa,190,234.274,7.4,0.373684,232.363,7.33158,0.342105,55,HM Amla,101,28,73,112,159,6,27,0,8,21,29,48,167,215,0,228,13,0,10,5.20168,0.403361,48.7899,86.9292,119,4
South Africa,190,234.274,7.4,0.373684,232.363,7.33158,0.342105,55,J Botha,11,4,7,15,159,6,27,0,8,21,29,48,167,215,0,228,13,0,10,1.09756,0,11.561,82.2917,41,1
South Africa,190,234.274,7.4,0.373684,232.363,7.33158,0.342105,55,M Morkel,0,0,0,0,159,6,27,0,8,21,29,48,167,215,0,228,13,0,10,0.6,0,5.28571,72.2656,35,1
Pakistan,211,222.621,7.38389,0.393365,235.517,7.54976,0.336493,55,Fawad Alam,43,12,31,55,133,5,39,2,10,25,35,60,147,207,229,226,19,0,10,1.85294,0.176471,26.5588,72.6468,34,4
Pakistan,211,222.621,7.38389,0.393365,235.517,7.54976,0.336493,55,Wahab Riaz,5,4,1,2,133,5,39,2,10,25,35,60,147,207,229,226,19,0,10,1.29167,0.0416667,10.9792,79.1291,48,1
Pakistan,211,222.621,7.38389,0.393365,235.517,7.54976,0.336493,55,Saeed Ajmal,0,0,0,0,133,5,39,2,10,25,35,60,147,207,229,226,19,0,10,0.34375,0,4.60938,58.3004,64,3
Pakistan,211,222.621,7.38389,0.393365,235.517,7.54976,0.336493,55,Shoaib Akhtar,0,0,0,0,133,5,39,2,10,25,35,60,147,207,229,226,19,0,10,0.421053,0,3.21053,67.033,19,1
South Africa,190,234.274,7.4,0.373684,232.363,7.33158,0.342105,56,HM Amla,115,36,79,135,203,3,35,3,0,1,1,88,151,239,0,250,11,1,10,5.20168,0.403361,48.7899,86.9292,119,4
South Africa,190,234.274,7.4,0.373684,232.363,7.33158,0.342105,56,RJ Peterson,4,4,0,1,203,3,35,3,0,1,1,88,151,239,0,250,11,1,10,1.62069,0.0344828,15.7931,83.5766,29,1
South Africa,190,234.274,7.4,0.373684,232.363,7.33158,0.342105,56,DW Steyn,0,0,0,0,203,3,35,3,0,1,1,88,151,239,0,250,11,1,10,0.75,0,6.52273,61.588,44,1
South Africa,190,234.274,7.4,0.373684,232.363,7.33158,0.342105,56,M Morkel,0,0,0,0,203,3,35,3,0,1,1,88,151,239,0,250,11,1,10,0.6,0,5.28571,72.2656,35,1
South Africa,190,234.274,7.4,0.373684,232.363,7.33158,0.342105,56,LL Tsotsobe,0,0,0,0,203,3,35,3,0,1,1,88,151,239,0,250,11,1,10,0.444444,0,3.16667,50.8929,18,3
England,221,237.176,7.17647,0.289593,230.633,7.45701,0.384615,58,GP Swann,0,0,0,0,212,5,14,3,0,20,20,58,188,246,0,268,22,1,10,1.08696,0,10.3043,90.631,46,0
England,221,237.176,7.17647,0.289593,230.633,7.45701,0.384615,58,JM Anderson,0,0,0,0,212,5,14,3,0,20,20,58,188,246,0,268,22,1,10,0.365385,0,3.92308,52.7132,52,3
England,221,237.176,7.17647,0.289593,230.633,7.45701,0.384615,58,JW Dernbach,0,0,0,0,212,5,14,3,0,20,20,58,188,246,0,268,22,1,10,0.125,0,2.375,47.5,8,3
Sri Lanka,244,223.373,7.09016,0.344262,227.578,7.47541,0.385246,58,BMAJ Mendis,46,16,30,50,183,5,28,0,14,14,28,94,145,239,269,252,13,0,10,1.43243,0.027027,15.1622,82.8656,37,1
Sri Lanka,244,223.373,7.09016,0.344262,227.578,7.47541,0.385246,58,AD Mathews,46,16,30,54,183,5,28,0,14,14,28,94,145,239,269,252,13,0,10,2.64122,0.198473,28.6794,82.3362,131,4
Sri Lanka,244,223.373,7.09016,0.344262,227.578,7.47541,0.385246,58,KMDN Kulasekara,0,0,0,0,183,5,28,0,14,14,28,94,145,239,269,252,13,0,10,1.21,0.04,11.8,80.9328,100,1
Sri Lanka,244,223.373,7.09016,0.344262,227.578,7.47541,0.385246,58,SL Malinga,0,0,0,0,183,5,28,0,14,14,28,94,145,239,269,252,13,0,10,0.617284,0.0123457,4.97531,74.6296,81,1
Zimbabwe,142,212.077,7.5,0.380282,227.704,6.97887,0.316901,59,P Utseya,12,0,12,22,148,5,22,1,8,15,23,76,117,193,0,209,16,0,10,0.842105,0.0263158,11.8289,55.8385,76,3
Zimbabwe,142,212.077,7.5,0.380282,227.704,6.97887,0.316901,59,KM Dabengwa,0,0,0,0,148,5,22,1,8,15,23,76,117,193,0,209,16,0,10,1.2,0,16.7,61.1722,20,1
Zimbabwe,142,212.077,7.5,0.380282,227.704,6.97887,0.316901,59,KO Meth,0,0,0,0,148,5,22,1,8,15,23,76,117,193,0,209,16,0,10,0.8,0,6.4,61.5385,5,1
Zimbabwe,142,212.077,7.5,0.380282,227.704,6.97887,0.316901,59,RW Price,0,0,0,0,148,5,22,1,8,15,23,76,117,193,0,209,16,0,10,0.666667,0,7.16667,57.2062,36,3
Bangladesh,160,218.438,7.70625,0.4,211.106,7.05,0.325,59,Mashrafe Mortaza,5,4,1,11,154,6,11,1,12,13,25,84,106,190,210,200,10,1,10,1.27536,0,11.1594,76.9231,69,1
Bangladesh,160,218.438,7.70625,0.4,211.106,7.05,0.325,59,Shakib Al Hasan,53,24,29,58,154,6,11,1,12,13,25,84,106,190,210,200,10,1,10,2.86992,0.252033,29.9106,79.0163,123,4
Bangladesh,160,218.438,7.70625,0.4,211.106,7.05,0.325,59,Abdur Razzak,0,0,0,0,154,6,11,1,12,13,25,84,106,190,210,200,10,1,10,0.849315,0.0136986,8.39726,73.8554,73,1
Bangladesh,160,218.438,7.70625,0.4,211.106,7.05,0.325,59,Shafiul Islam,0,0,0,0,154,6,11,1,12,13,25,84,106,190,210,200,10,1,10,0.535714,0,4.42857,57.6744,28,3
West Indies,176,217.33,7.15909,0.3125,225.278,7.57386,0.380682,60,R Rampaul,0,0,0,3,176,3,9,4,24,7,31,100,116,216,0,240,24,1,10,1.30303,0.030303,9.90909,77.4882,33,1
West Indies,176,217.33,7.15909,0.3125,225.278,7.57386,0.380682,60,DJG Sammy,5,4,1,6,176,3,9,4,24,7,31,100,116,216,0,240,24,1,10,2.25,0.09,18.25,95.8005,100,0
West Indies,176,217.33,7.15909,0.3125,225.278,7.57386,0.380682,60,D Bishoo,0,0,0,0,176,3,9,4,24,7,31,100,116,216,0,240,24,1,10,0.285714,0,1.42857,37.037,7,3
South Africa,190,234.274,7.4,0.373684,232.363,7.33158,0.342105,61,DA Miller,2,0,2,7,160,3,21,1,4,17,21,72,130,202,0,222,20,1,10,2.57353,0.132353,24.9412,97.2477,68,0
South Africa,190,234.274,7.4,0.373684,232.363,7.33158,0.342105,61,JP Duminy,33,4,29,56,160,3,21,1,4,17,21,72,130,202,0,222,20,1,10,2.3252,0.186992,29.9675,80.2351,123,4
South Africa,190,234.274,7.4,0.373684,232.363,7.33158,0.342105,61,MV Boucher,0,0,0,0,160,3,21,1,4,17,21,72,130,202,0,222,20,1,10,2.21053,0.0877193,22.2281,89.3512,57,0
South Africa,190,234.274,7.4,0.373684,232.363,7.33158,0.342105,61,J Botha,0,0,0,0,160,3,21,1,4,17,21,72,130,202,0,222,20,1,10,1.09756,0,11.561,82.2917,41,1
Australia,228,239.627,7.69737,0.372807,232.079,7.23246,0.337719,61,MEK Hussey,38,4,34,59,163,5,30,2,10,3,13,104,102,206,223,227,21,0,10,2.7563,0.260504,34.084,82.4893,119,4
Australia,228,239.627,7.69737,0.372807,232.079,7.23246,0.337719,61,PJ Cummins,0,0,0,1,163,5,30,2,10,3,13,104,102,206,223,227,21,0,10,0.571429,0,4.85714,53.9683,7,3
Australia,228,239.627,7.69737,0.372807,232.079,7.23246,0.337719,62,MG Johnson,1,0,1,2,164,5,33,1,0,0,0,96,101,197,0,211,14,0,10,1.18519,0.0246914,10.7901,94.181,81,0
Australia,228,239.627,7.69737,0.372807,232.079,7.23246,0.337719,62,JW Hastings,0,0,0,0,164,5,33,1,0,0,0,96,101,197,0,211,14,0,10,1.76923,0,13.8462,95.2381,13,0
Australia,228,239.627,7.69737,0.372807,232.079,7.23246,0.337719,62,XJ Doherty,0,0,0,0,164,5,33,1,0,0,0,96,101,197,0,211,14,0,10,0.190476,0,4.28571,52.0231,21,3
Australia,228,239.627,7.69737,0.372807,232.079,7.23246,0.337719,62,JL Pattinson,0,0,0,0,164,5,33,1,0,0,0,96,101,197,0,211,14,0,10,0.285714,0,5.85714,51.25,7,3
Australia,228,239.627,7.69737,0.372807,232.079,7.23246,0.337719,62,BJ Haddin,8,4,4,14,164,5,33,1,0,0,0,96,101,197,0,211,14,0,10,3.14737,0.147368,26.7789,81.382,95,4
Sri Lanka,244,223.373,7.09016,0.344262,227.578,7.47541,0.385246,62,AD Mathews,20,4,16,45,166,4,15,1,8,2,10,90,101,191,212,213,22,1,10,2.64122,0.198473,28.6794,82.3362,131,4
Sri Lanka,244,223.373,7.09016,0.344262,227.578,7.47541,0.385246,62,RMS Eranga,0,0,0,0,166,4,15,1,8,2,10,90,101,191,212,213,22,1,10,0.444444,0,3.77778,51.5152,9,3
Sri Lanka,244,223.373,7.09016,0.344262,227.578,7.47541,0.385246,62,BMAJ Mendis,3,0,3,8,166,4,15,1,8,2,10,90,101,191,212,213,22,1,10,1.43243,0.027027,15.1622,82.8656,37,1
Australia,228,239.627,7.69737,0.372807,232.079,7.23246,0.337719,63,DT Christian,9,4,5,19,194,5,14,2,10,20,30,72,166,238,0,252,14,1,10,1.44444,0,15.1111,86.901,18,0
Australia,228,239.627,7.69737,0.372807,232.079,7.23246,0.337719,63,B Lee,2,0,2,9,194,5,14,2,10,20,30,72,166,238,0,252,14,1,10,1.09091,0.0227273,10.8182,81.5068,44,1
Australia,228,239.627,7.69737,0.372807,232.079,7.23246,0.337719,63,XJ Doherty,0,0,0,0,194,5,14,2,10,20,30,72,166,238,0,252,14,1,10,0.190476,0,4.28571,52.0231,21,3
New Zealand,184,233.745,7.39674,0.36413,227.951,7.30435,0.353261,64,AM Ellis,10,0,10,22,181,7,30,0,6,3,9,126,94,220,0,230,10,1,10,1,0,12.75,80.9524,12,1
New Zealand,184,233.745,7.39674,0.36413,227.951,7.30435,0.353261,64,TG Southee,28,20,8,27,181,7,30,0,6,3,9,126,94,220,0,230,10,1,10,0.764706,0,7.03922,92.7649,51,0
New Zealand,184,233.745,7.39674,0.36413,227.951,7.30435,0.353261,64,TS Nethula,0,0,0,0,181,7,30,0,6,3,9,126,94,220,0,230,10,1,10,0.333333,0,4,109.091,3,0
Zimbabwe,142,212.077,7.5,0.380282,227.704,6.97887,0.316901,65,MN Waller,12,10,2,7,155,4,28,2,0,2,2,72,113,185,0,199,14,1,10,2.07895,0.0789474,19.3684,68.9784,38,1
Zimbabwe,142,212.077,7.5,0.380282,227.704,6.97887,0.316901,65,RW Price,0,0,0,0,155,4,28,2,0,2,2,72,113,185,0,199,14,1,10,0.666667,0,7.16667,57.2062,36,3
Zimbabwe,142,212.077,7.5,0.380282,227.704,6.97887,0.316901,65,KM Jarvis,0,0,0,0,155,4,28,2,0,2,2,72,113,185,0,199,14,1,10,0.333333,0,3.75,36.2903,12,3
Zimbabwe,142,212.077,7.5,0.380282,227.704,6.97887,0.316901,65,P Utseya,0,0,0,0,155,4,28,2,0,2,2,72,113,185,0,199,14,1,10,0.842105,0.0263158,11.8289,55.8385,76,3
Bangladesh,160,218.438,7.70625,0.4,211.106,7.05,0.325,67,Nasir Hossain,24,0,24,37,145,7,36,0,18,12,30,86,125,211,0,220,9,1,10,2.75,0.159091,27.0455,79.3863,44,4
Bangladesh,160,218.438,7.70625,0.4,211.106,7.05,0.325,67,Shafiul Islam,0,0,0,0,145,7,36,0,18,12,30,86,125,211,0,220,9,1,10,0.535714,0,4.42857,57.6744,28,3
South Africa,190,234.274,7.4,0.373684,232.363,7.33158,0.342105,68,RJ Peterson,1,0,1,3,149,4,17,2,26,15,41,72,135,207,0,220,13,0,10,1.62069,0.0344828,15.7931,83.5766,29,1
South Africa,190,234.274,7.4,0.373684,232.363,7.33158,0.342105,68,D Elgar,28,0,28,53,149,4,17,2,26,15,41,72,135,207,0,220,13,0,10,1,0,19.6,60.4938,5,1
South Africa,190,234.274,7.4,0.373684,232.363,7.33158,0.342105,68,R McLaren,0,0,0,0,149,4,17,2,26,15,41,72,135,207,0,220,13,0,10,1.2,0.025,11.975,69.8251,40,1
South Africa,190,234.274,7.4,0.373684,232.363,7.33158,0.342105,68,DW Steyn,0,0,0,0,149,4,17,2,26,15,41,72,135,207,0,220,13,0,10,0.75,0,6.52273,61.588,44,1
England,221,237.176,7.17647,0.289593,230.633,7.45701,0.384615,68,EJG Morgan,24,8,16,30,152,3,21,1,26,2,28,96,105,201,221,224,23,1,10,3.19549,0.233083,30.0526,86.9291,133,4
England,221,237.176,7.17647,0.289593,230.633,7.45701,0.384615,68,C Kieswetter,5,4,1,8,152,3,21,1,26,2,28,96,105,201,221,224,23,1,10,3.43243,0.135135,26.4324,88.0288,37,4
West Indies,176,217.33,7.15909,0.3125,225.278,7.57386,0.380682,69,R Rampaul,69,50,19,53,198,9,20,0,22,15,37,150,105,255,0,269,14,0,10,1.30303,0.030303,9.90909,77.4882,33,1
West Indies,176,217.33,7.15909,0.3125,225.278,7.57386,0.380682,69,KAJ Roach,4,0,4,19,198,9,20,0,22,15,37,150,105,255,0,269,14,0,10,0.526316,0,5.68421,50.5855,38,3
India,259,242.378,7.15058,0.339768,244.568,7.12741,0.30888,69,RG Sharma,78,34,44,90,199,3,36,1,10,11,21,120,136,256,270,270,14,1,10,3.82836,0.268657,35.9179,83.083,134,4
India,259,242.378,7.15058,0.339768,244.568,7.12741,0.30888,69,SK Raina,0,0,0,0,199,3,36,1,10,11,21,120,136,256,270,270,14,1,10,3.11111,0.216374,28.9064,91.8944,171,0
India,259,242.378,7.15058,0.339768,244.568,7.12741,0.30888,69,RA Jadeja,0,0,0,0,199,3,36,1,10,11,21,120,136,256,270,270,14,1,10,2.12941,0.117647,21.7529,82.4342,85,4
West Indies,176,217.33,7.15909,0.3125,225.278,7.57386,0.380682,70,AD Russell,27,12,15,27,167,5,51,0,46,17,63,178,103,281,0,294,13,1,10,3.38095,0.0952381,23.2857,129.536,42,0
West Indies,176,217.33,7.15909,0.3125,225.278,7.57386,0.380682,70,KA Pollard,77,50,27,60,167,5,51,0,46,17,63,178,103,281,0,294,13,1,10,2.70513,0.115385,24.5,88.0645,78,4
West Indies,176,217.33,7.15909,0.3125,225.278,7.57386,0.380682,70,DJG Sammy,0,0,0,0,167,5,51,0,46,17,63,178,103,281,0,294,13,1,10,2.25,0.09,18.25,95.8005,100,0
Australia,228,239.627,7.69737,0.372807,232.079,7.23246,0.337719,70,XJ Doherty,1,0,1,3,185,7,53,1,0,0,0,144,94,238,295,252,14,0,10,0.190476,0,4.28571,52.0231,21,3
Australia,228,239.627,7.69737,0.372807,232.079,7.23246,0.337719,70,BW Hilfenhaus,0,0,0,0,185,7,53,1,0,0,0,144,94,238,295,252,14,0,10,0.222222,0,3.22222,40.8451,9,3
Australia,228,239.627,7.69737,0.372807,232.079,7.23246,0.337719,70,B Lee,59,50,9,45,185,7,53,1,0,0,0,144,94,238,295,252,14,0,10,1.09091,0.0227273,10.8182,81.5068,44,1
West Indies,176,217.33,7.15909,0.3125,225.278,7.57386,0.380682,71,AD Russell,4,0,4,5,162,5,26,2,32,18,50,128,110,238,0,264,26,1,10,3.38095,0.0952381,23.2857,129.536,42,0
West Indies,176,217.33,7.15909,0.3125,225.278,7.57386,0.380682,71,DJG Sammy,10,4,6,19,162,5,26,2,32,18,50,128,110,238,0,264,26,1,10,2.25,0.09,18.25,95.8005,100,0
West Indies,176,217.33,7.15909,0.3125,225.278,7.57386,0.380682,71,SP Narine,0,0,0,0,162,5,26,2,32,18,50,128,110,238,0,264,26,1,10,1.05882,0,8.55882,76.378,34,1
West Indies,176,217.33,7.15909,0.3125,225.278,7.57386,0.380682,71,TL Best,0,0,0,0,162,5,26,2,32,18,50,128,110,238,0,264,26,1,10,0.375,0,4,42.6667,8,3
New Zealand,184,233.745,7.39674,0.36413,227.951,7.30435,0.353261,71,DAJ Bracewell,1,0,1,1,165,6,31,1,6,14,20,86,130,216,265,240,24,0,10,0.428571,0,8.42857,65.5556,7,1
New Zealand,184,233.745,7.39674,0.36413,227.951,7.30435,0.353261,71,LRPL Taylor,98,48,50,106,165,6,31,1,6,14,20,86,130,216,265,240,24,0,10,3.68382,0.301471,36.7206,79.3959,136,4
New Zealand,184,233.745,7.39674,0.36413,227.951,7.30435,0.353261,71,TG Southee,0,0,0,0,165,6,31,1,6,14,20,86,130,216,265,240,24,0,10,0.764706,0,7.03922,92.7649,51,0
New Zealand,184,233.745,7.39674,0.36413,227.951,7.30435,0.353261,71,TA Boult,0,0,0,0,165,6,31,1,6,14,20,86,130,216,265,240,24,0,10,0.727273,0,5.27273,77.3333,11,1
India,259,242.378,7.15058,0.339768,244.568,7.12741,0.30888,72,MS Dhoni,28,16,12,23,204,6,34,0,22,18,40,114,164,278,0,294,16,0,10,3.47872,0.292553,36.7713,84.1612,188,4
India,259,242.378,7.15058,0.339768,244.568,7.12741,0.30888,72,IK Pathan,21,8,13,18,204,6,34,0,22,18,40,114,164,278,0,294,16,0,10,1.875,0.025,16.85,78.2811,40,1
India,259,242.378,7.15058,0.339768,244.568,7.12741,0.30888,72,R Ashwin,0,0,0,0,204,6,34,0,22,18,40,114,164,278,0,294,16,0,10,1.16364,0.0181818,11.9455,84.7742,55,1
Sri Lanka,244,223.373,7.09016,0.344262,227.578,7.47541,0.385246,72,SL Malinga,2,0,2,5,208,6,29,3,8,0,8,114,131,245,295,274,29,1,10,0.617284,0.0123457,4.97531,74.6296,81,1
Australia,228,239.627,7.69737,0.372807,232.079,7.23246,0.337719,73,AC Voges,3,0,3,3,232,3,41,1,18,19,37,170,140,310,0,315,5,0,10,2.29167,0.125,29.625,84.142,24,4
Australia,228,239.627,7.69737,0.372807,232.079,7.23246,0.337719,73,MJ Clarke,105,56,49,103,232,3,41,1,18,19,37,170,140,310,0,315,5,0,10,3.10294,0.301471,35.9265,74.0303,136,4
Australia,228,239.627,7.69737,0.372807,232.079,7.23246,0.337719,73,MS Wade,0,0,0,0,232,3,41,1,18,19,37,170,140,310,0,315,5,0,10,1.86275,0.117647,20.3333,78.2642,51,1
Australia,228,239.627,7.69737,0.372807,232.079,7.23246,0.337719,73,JP Faulkner,0,0,0,0,232,3,41,1,18,19,37,170,140,310,0,315,5,0,10,2.88235,0.147059,24.1471,109.613,34,0
Australia,228,239.627,7.69737,0.372807,232.079,7.23246,0.337719,73,MG Johnson,0,0,0,0,232,3,41,1,18,19,37,170,140,310,0,315,5,0,10,1.18519,0.0246914,10.7901,94.181,81,0
India,259,242.378,7.15058,0.339768,244.568,7.12741,0.30888,76,MS Dhoni,24,12,12,23,239,4,31,1,30,17,47,166,151,317,0,331,14,0,10,3.47872,0.292553,36.7713,84.1612,188,4
India,259,242.378,7.15058,0.339768,244.568,7.12741,0.30888,76,RA Jadeja,13,8,5,14,239,4,31,1,30,17,47,166,151,317,0,331,14,0,10,2.12941,0.117647,21.7529,82.4342,85,4
India,259,242.378,7.15058,0.339768,244.568,7.12741,0.30888,76,R Ashwin,0,0,0,0,239,4,31,1,30,17,47,166,151,317,0,331,14,0,10,1.16364,0.0181818,11.9455,84.7742,55,1
South Africa,190,234.274,7.4,0.373684,232.363,7.33158,0.342105,76,R McLaren,48,34,14,42,243,8,22,1,20,11,31,146,150,296,332,305,9,0,10,1.2,0.025,11.975,69.8251,40,1
South Africa,190,234.274,7.4,0.373684,232.363,7.33158,0.342105,76,M Morkel,0,0,0,2,243,8,22,1,20,11,31,146,150,296,332,305,9,0,10,0.6,0,5.28571,72.2656,35,1
Sri Lanka,244,223.373,7.09016,0.344262,227.578,7.47541,0.385246,77,DPMD Jayawardene,63,32,31,67,164,5,33,0,16,22,38,82,153,235,0,253,18,0,10,3.20833,0.244792,31.6979,79.1109,192,4
Sri Lanka,244,223.373,7.09016,0.344262,227.578,7.47541,0.385246,77,LD Chandimal,24,6,18,28,164,5,33,0,16,22,38,82,153,235,0,253,18,0,10,2.18478,0.184783,25.7391,73.8615,92,4
Sri Lanka,244,223.373,7.09016,0.344262,227.578,7.47541,0.385246,77,KMDN Kulasekara,0,0,0,0,164,5,33,0,16,22,38,82,153,235,0,253,18,0,10,1.21,0.04,11.8,80.9328,100,1
Sri Lanka,244,223.373,7.09016,0.344262,227.578,7.47541,0.385246,77,HMRKB Herath,0,0,0,0,164,5,33,0,16,22,38,82,153,235,0,253,18,0,10,0.444444,0,5.18519,61.674,27,1
Sri Lanka,244,223.373,7.09016,0.344262,227.578,7.47541,0.385246,77,SL Malinga,0,0,0,0,164,5,33,0,16,22,38,82,153,235,0,253,18,0,10,0.617284,0.0123457,4.97531,74.6296,81,1
Pakistan,211,222.621,7.38389,0.393365,235.517,7.54976,0.336493,78,Shoaib Malik,21,8,13,25,199,4,26,2,8,11,19,122,122,244,0,250,6,0,10,2.77551,0.193878,28.7041,81.4418,98,4
Pakistan,211,222.621,7.38389,0.393365,235.517,7.54976,0.336493,78,Umar Gul,8,6,2,10,199,4,26,2,8,11,19,122,122,244,0,250,6,0,10,0.77193,0,7.14035,68.2886,57,1
Pakistan,211,222.621,7.38389,0.393365,235.517,7.54976,0.336493,78,Saeed Ajmal,0,0,0,0,199,4,26,2,8,11,19,122,122,244,0,250,6,0,10,0.34375,0,4.60938,58.3004,64,3
Pakistan,211,222.621,7.38389,0.393365,235.517,7.54976,0.336493,78,Mohammad Irfan,0,0,0,0,199,4,26,2,8,11,19,122,122,244,0,250,6,0,10,0.233333,0,1.56667,30.9211,30,3
India,259,242.378,7.15058,0.339768,244.568,7.12741,0.30888,78,MS Dhoni,33,4,29,74,117,9,9,0,18,3,21,46,101,147,251,165,18,1,10,3.47872,0.292553,36.7713,84.1612,188,4
India,259,242.378,7.15058,0.339768,244.568,7.12741,0.30888,78,I Sharma,2,0,2,10,117,9,9,0,18,3,21,46,101,147,251,165,18,1,10,0.24,0,2.84,34.1346,25,3
Australia,228,239.627,7.69737,0.372807,232.079,7.23246,0.337719,81,JP Faulkner,9,4,5,11,150,5,22,2,8,24,32,56,148,204,0,217,13,1,10,2.88235,0.147059,24.1471,109.613,34,0
Australia,228,239.627,7.69737,0.372807,232.079,7.23246,0.337719,81,NM Coulter-Nile,3,0,3,7,150,5,22,2,8,24,32,56,148,204,0,217,13,1,10,0.571429,0,8.57143,69.7674,7,1
Australia,228,239.627,7.69737,0.372807,232.079,7.23246,0.337719,81,XJ Doherty,0,0,0,0,150,5,22,2,8,24,32,56,148,204,0,217,13,1,10,0.190476,0,4.28571,52.0231,21,3
Australia,228,239.627,7.69737,0.372807,232.079,7.23246,0.337719,81,CJ McKay,0,0,0,0,150,5,22,2,8,24,32,56,148,204,0,217,13,1,10,0.615385,0,6.88462,55.0769,26,3
England,221,237.176,7.17647,0.289593,230.633,7.45701,0.384615,81,TT Bresnan,12,6,6,10,152,5,31,1,4,14,18,78,123,201,218,212,11,0,10,1.52381,0.015873,13.8095,88.4146,63,0
England,221,237.176,7.17647,0.289593,230.633,7.45701,0.384615,81,RS Bopara,19,8,11,35,152,5,31,1,4,14,18,78,123,201,218,212,11,0,10,2.22115,0.144231,25.1538,75.9361,104,4
England,221,237.176,7.17647,0.289593,230.633,7.45701,0.384615,81,SCJ Broad,0,0,0,0,152,5,31,1,4,14,18,78,123,201,218,212,11,0,10,0.725806,0,8.04839,74.0356,62,1
England,221,237.176,7.17647,0.289593,230.633,7.45701,0.384615,81,CJ Jordan,0,0,0,0,152,5,31,1,4,14,18,78,123,201,218,212,11,0,10,0.833333,0,8.22222,84.0909,18,1
England,221,237.176,7.17647,0.289593,230.633,7.45701,0.384615,81,JC Tredwell,0,0,0,0,152,5,31,1,4,14,18,78,123,201,218,212,11,0,10,0.52,0,6.52,65.9919,25,1
West Indies,176,217.33,7.15909,0.3125,225.278,7.57386,0.380682,82,DJ Bravo,29,12,17,43,131,5,24,0,22,17,39,80,114,194,0,232,38,1,10,2.35514,0.11215,23.1589,80.9011,107,4
West Indies,176,217.33,7.15909,0.3125,225.278,7.57386,0.380682,82,KA Pollard,9,0,9,13,131,5,24,0,22,17,39,80,114,194,0,232,38,1,10,2.70513,0.115385,24.5,88.0645,78,4
West Indies,176,217.33,7.15909,0.3125,225.278,7.57386,0.380682,82,DJG Sammy,0,0,0,0,131,5,24,0,22,17,39,80,114,194,0,232,38,1,10,2.25,0.09,18.25,95.8005,100,0
West Indies,176,217.33,7.15909,0.3125,225.278,7.57386,0.380682,82,KAJ Roach,0,0,0,0,131,5,24,0,22,17,39,80,114,194,0,232,38,1,10,0.526316,0,5.68421,50.5855,38,3
West Indies,176,217.33,7.15909,0.3125,225.278,7.57386,0.380682,82,SP Narine,0,0,0,0,131,5,24,0,22,17,39,80,114,194,0,232,38,1,10,1.05882,0,8.55882,76.378,34,1
Pakistan,211,222.621,7.38389,0.393365,235.517,7.54976,0.336493,82,Umar Akmal,29,8,21,37,141,6,18,2,18,4,22,82,99,181,233,195,14,0,10,2.76842,0.2,27.5053,82.7947,95,4
Pakistan,211,222.621,7.38389,0.393365,235.517,7.54976,0.336493,82,Asad Ali,1,0,1,4,141,6,18,2,18,4,22,82,99,181,233,195,14,0,10,0.5,0,5,62.5,2,1
South Africa,190,234.274,7.4,0.373684,232.363,7.33158,0.342105,83,JP Duminy,20,4,16,27,210,2,20,2,30,11,41,102,169,271,0,280,9,1,10,2.3252,0.186992,29.9675,80.2351,123,4
South Africa,190,234.274,7.4,0.373684,232.363,7.33158,0.342105,83,JH Kallis,1,0,1,2,210,2,20,2,30,11,41,102,169,271,0,280,9,1,10,3.58621,0.356322,37.2644,76.4442,87,4
South Africa,190,234.274,7.4,0.373684,232.363,7.33158,0.342105,83,R McLaren,0,0,0,0,210,2,20,2,30,11,41,102,169,271,0,280,9,1,10,1.2,0.025,11.975,69.8251,40,1
South Africa,190,234.274,7.4,0.373684,232.363,7.33158,0.342105,83,VD Philander,0,0,0,0,210,2,20,2,30,11,41,102,169,271,0,280,9,1,10,0.8125,0,8.8125,66.5094,16,1
West Indies,176,217.33,7.15909,0.3125,225.278,7.57386,0.380682,84,AD Russell,1,0,1,1,175,5,60,1,42,17,59,184,110,294,0,304,10,0,10,3.38095,0.0952381,23.2857,129.536,42,0
West Indies,176,217.33,7.15909,0.3125,225.278,7.57386,0.380682,84,LMP Simmons,69,42,27,67,175,5,60,1,42,17,59,184,110,294,0,304,10,0,10,3.3125,0.28125,30.5938,71.4338,64,4
Ireland,55,219.527,7.65455,0.290909,202.727,7.56364,0.4,84,JF Mooney,1,0,1,1,270,3,18,3,4,2,6,172,122,294,305,307,13,0,10,1.47619,0,13.7619,72.796,21,1
Ireland,55,219.527,7.65455,0.290909,202.727,7.56364,0.4,84,NJ O'Brien,78,44,34,60,270,3,18,3,4,2,6,172,122,294,305,307,13,0,10,2.55882,0.176471,25.5882,69.378,34,4
New Zealand,184,233.745,7.39674,0.36413,227.951,7.30435,0.353261,88,GD Elliott,10,4,6,5,234,3,66,1,74,9,83,246,137,383,0,393,10,1,10,2.67188,0.203125,29.4375,79.7629,64,4
New Zealand,184,233.745,7.39674,0.36413,227.951,7.30435,0.353261,88,MJ Guptill,188,120,68,149,234,3,66,1,74,9,83,246,137,383,0,393,10,1,10,4.8087,0.313043,38.1217,82.7482,115,4
New Zealand,184,233.745,7.39674,0.36413,227.951,7.30435,0.353261,88,L Ronchi,0,0,0,0,234,3,66,1,74,9,83,246,137,383,0,393,10,1,10,2.92157,0.0784314,22.1961,115.392,51,0
New Zealand,184,233.745,7.39674,0.36413,227.951,7.30435,0.353261,88,DL Vettori,0,0,0,0,234,3,66,1,74,9,83,246,137,383,0,393,10,1,10,1.43662,0.028169,15.7606,86.0108,71,0
Pakistan,211,222.621,7.38389,0.393365,235.517,7.54976,0.336493,89,Mohammad Hafeez,103,50,53,116,179,3,37,1,32,26,58,134,140,274,0,299,25,0,10,4.04511,0.255639,34.3534,78.0625,133,4
Pakistan,211,222.621,7.38389,0.393365,235.517,7.54976,0.336493,89,Shahid Afridi,14,10,4,11,179,3,37,1,32,26,58,134,140,274,0,299,25,0,10,2.72917,0.0972222,21.4097,127.766,144,0
New Zealand,184,233.745,7.39674,0.36413,227.951,7.30435,0.353261,90,TG Southee,1,0,1,4,214,5,48,3,22,9,31,164,129,293,0,314,21,1,10,0.764706,0,7.03922,92.7649,51,0
New Zealand,184,233.745,7.39674,0.36413,227.951,7.30435,0.353261,90,MJ McClenaghan,1,0,1,2,214,5,48,3,22,9,31,164,129,293,0,314,21,1,10,0.928571,0,7.71429,75.5245,14,1
India,259,242.378,7.15058,0.339768,244.568,7.12741,0.30888,90,RA Jadeja,34,18,16,30,220,6,36,1,30,10,40,178,118,296,315,314,18,0,10,2.12941,0.117647,21.7529,82.4342,85,4
India,259,242.378,7.15058,0.339768,244.568,7.12741,0.30888,90,B Kumar,0,0,0,0,220,6,36,1,30,10,40,178,118,296,315,314,18,0,10,0.75,0,7.39286,72.1254,28,1
India,259,242.378,7.15058,0.339768,244.568,7.12741,0.30888,90,Mohammed Shami,0,0,0,0,220,6,36,1,30,10,40,178,118,296,315,314,18,0,10,0.684211,0,5.68421,88.5246,19,0
India,259,242.378,7.15058,0.339768,244.568,7.12741,0.30888,90,VR Aaron,0,0,0,0,220,6,36,1,30,10,40,178,118,296,315,314,18,0,10,0.333333,0,2.66667,53.3333,3,3
Sri Lanka,244,223.373,7.09016,0.344262,227.578,7.47541,0.385246,91,AD Mathews,15,8,7,22,204,3,28,1,26,22,48,132,148,280,0,300,20,0,10,2.64122,0.198473,28.6794,82.3362,131,4
Sri Lanka,244,223.373,7.09016,0.344262,227.578,7.47541,0.385246,91,HDRL Thirimanne,8,4,4,10,204,3,28,1,26,22,48,132,148,280,0,300,20,0,10,2.77778,0.246914,31.5802,71.4725,81,4
Sri Lanka,244,223.373,7.09016,0.344262,227.578,7.47541,0.385246,91,SMA Priyanjan,0,0,0,0,204,3,28,1,26,22,48,132,148,280,0,300,20,0,10,2.5,0.1,20.95,78.6116,20,4
Sri Lanka,244,223.373,7.09016,0.344262,227.578,7.47541,0.385246,91,KMDN Kulasekara,0,0,0,0,204,3,28,1,26,22,48,132,148,280,0,300,20,0,10,1.21,0.04,11.8,80.9328,100,1
Sri Lanka,244,223.373,7.09016,0.344262,227.578,7.47541,0.385246,91,SMSM Senanayake,0,0,0,0,204,3,28,1,26,22,48,132,148,280,0,300,20,0,10,1.0625,0,8.625,87.0662,32,1
Sri Lanka,244,223.373,7.09016,0.344262,227.578,7.47541,0.385246,91,BAW Mendis,0,0,0,0,204,3,28,1,26,22,48,132,148,280,0,300,20,0,10,0.447368,0,4.47368,66.4062,38,1
England,221,237.176,7.17647,0.289593,230.633,7.45701,0.384615,91,JC Buttler,79,44,35,56,200,5,35,1,24,24,48,88,195,283,301,293,10,1,10,3.47458,0.186441,29.9153,115.359,59,0
England,221,237.176,7.17647,0.289593,230.633,7.45701,0.384615,91,CJ Jordan,0,0,0,1,200,5,35,1,24,24,48,88,195,283,301,293,10,1,10,0.833333,0,8.22222,84.0909,18,1
England,221,237.176,7.17647,0.289593,230.633,7.45701,0.384615,91,JC Tredwell,0,0,0,0,200,5,35,1,24,24,48,88,195,283,301,293,10,1,10,0.52,0,6.52,65.9919,25,1
Bangladesh,160,218.438,7.70625,0.4,211.106,7.05,0.325,94,Mushfiqur Rahim,32,24,8,21,192,2,50,1,44,19,63,172,133,305,0,326,21,1,10,2.61111,0.18254,27.7778,75.2526,126,4
Bangladesh,160,218.438,7.70625,0.4,211.106,7.05,0.325,94,Shakib Al Hasan,0,0,0,0,192,2,50,1,44,19,63,172,133,305,0,326,21,1,10,2.86992,0.252033,29.9106,79.0163,123,4
Pakistan,211,222.621,7.38389,0.393365,235.517,7.54976,0.336493,94,Fawad Alam,50,16,34,59,208,4,62,1,26,20,46,176,140,316,327,329,13,0,10,1.85294,0.176471,26.5588,72.6468,34,4
Pakistan,211,222.621,7.38389,0.393365,235.517,7.54976,0.336493,94,Shahid Afridi,51,44,7,19,208,4,62,1,26,20,46,176,140,316,327,329,13,0,10,2.72917,0.0972222,21.4097,127.766,144,0
Pakistan,211,222.621,7.38389,0.393365,235.517,7.54976,0.336493,94,Umar Akmal,0,0,0,0,208,4,62,1,26,20,46,176,140,316,327,329,13,0,10,2.76842,0.2,27.5053,82.7947,95,4
Pakistan,211,222.621,7.38389,0.393365,235.517,7.54976,0.336493,95,Fawad Alam,14,4,10,27,178,5,15,1,0,12,12,68,137,205,0,215,10,0,10,1.85294,0.176471,26.5588,72.6468,34,4
Pakistan,211,222.621,7.38389,0.393365,235.517,7.54976,0.336493,95,Wahab Riaz,2,0,2,7,178,5,15,1,0,12,12,68,137,205,0,215,10,0,10,1.29167,0.0416667,10.9792,79.1291,48,1
Pakistan,211,222.621,7.38389,0.393365,235.517,7.54976,0.336493,95,Zulfiqar Babar,0,0,0,0,178,5,15,1,0,12,12,68,137,205,0,215,10,0,10,0.6,0,7,87.5,5,0
Pakistan,211,222.621,7.38389,0.393365,235.517,7.54976,0.336493,95,Mohammad Irfan,0,0,0,0,178,5,15,1,0,12,12,68,137,205,0,215,10,0,10,0.233333,0,1.56667,30.9211,30,3
West Indies,176,217.33,7.15909,0.3125,225.278,7.57386,0.380682,96,DJG Sammy,1,0,1,1,239,2,56,2,10,23,33,190,138,328,0,338,10,1,10,2.25,0.09,18.25,95.8005,100,0
West Indies,176,217.33,7.15909,0.3125,225.278,7.57386,0.380682,96,D Ramdin,148,92,56,107,239,2,56,2,10,23,33,190,138,328,0,338,10,1,10,1.7439,0.097561,19.1951,81.1759,82,1
West Indies,176,217.33,7.15909,0.3125,225.278,7.57386,0.380682,96,DJ Bravo,0,0,0,0,239,2,56,2,10,23,33,190,138,328,0,338,10,1,10,2.35514,0.11215,23.1589,80.9011,107,4
West Indies,176,217.33,7.15909,0.3125,225.278,7.57386,0.380682,96,JO Holder,0,0,0,0,239,2,56,2,10,23,33,190,138,328,0,338,10,1,10,2.13636,0.0909091,16.9091,97.8947,22,0
Bangladesh,160,218.438,7.70625,0.4,211.106,7.05,0.325,96,Sohag Gazi,12,8,4,14,164,5,32,1,18,16,34,120,110,230,339,247,17,0,10,1.46667,0,12.1333,87.9227,15,0
Bangladesh,160,218.438,7.70625,0.4,211.106,7.05,0.325,96,Nasir Hossain,24,12,12,26,164,5,32,1,18,16,34,120,110,230,339,247,17,0,10,2.75,0.159091,27.0455,79.3863,44,4
Bangladesh,160,218.438,7.70625,0.4,211.106,7.05,0.325,96,Mashrafe Mortaza,0,0,0,0,164,5,32,1,18,16,34,120,110,230,339,247,17,0,10,1.27536,0,11.1594,76.9231,69,1
Bangladesh,160,218.438,7.70625,0.4,211.106,7.05,0.325,96,Abdur Razzak,0,0,0,0,164,5,32,1,18,16,34,120,110,230,339,247,17,0,10,0.849315,0.0136986,8.39726,73.8554,73,1
Australia,228,239.627,7.69737,0.372807,232.079,7.23246,0.337719,97,MA Starc,17,6,11,35,138,8,17,0,22,21,43,78,120,198,0,217,19,0,10,0.692308,0,8.46154,70.0637,13,1
Australia,228,239.627,7.69737,0.372807,232.079,7.23246,0.337719,97,JP Faulkner,8,0,8,19,138,8,17,0,22,21,43,78,120,198,0,217,19,0,10,2.88235,0.147059,24.1471,109.613,34,0
England,221,237.176,7.17647,0.289593,230.633,7.45701,0.384615,98,MA Wood,2,0,2,3,250,5,32,4,0,1,1,148,135,283,0,302,19,1,10,1,0,8.33333,86.2069,3,1
England,221,237.176,7.17647,0.289593,230.633,7.45701,0.384615,98,ST Finn,0,0,0,1,250,5,32,4,0,1,1,148,135,283,0,302,19,1,10,0.583333,0,5.41667,59.633,24,3
New Zealand,184,233.745,7.39674,0.36413,227.951,7.30435,0.353261,98,LRPL Taylor,109,48,61,124,238,4,32,1,10,8,18,132,156,288,303,306,18,0,10,3.68382,0.301471,36.7206,79.3959,136,4
New Zealand,184,233.745,7.39674,0.36413,227.951,7.30435,0.353261,98,L Ronchi,4,0,4,3,238,4,32,1,10,8,18,132,156,288,303,306,18,0,10,2.92157,0.0784314,22.1961,115.392,51,0
New Zealand,184,233.745,7.39674,0.36413,227.951,7.30435,0.353261,98,BM Wheeler,0,0,0,0,238,4,32,1,10,8,18,132,156,288,303,306,18,0,10,1.75,0,14.5,123.404,4,0
New Zealand,184,233.745,7.39674,0.36413,227.951,7.30435,0.353261,98,TG Southee,0,0,0,0,238,4,32,1,10,8,18,132,156,288,303,306,18,0,10,0.764706,0,7.03922,92.7649,51,0
New Zealand,184,233.745,7.39674,0.36413,227.951,7.30435,0.353261,100,L Ronchi,7,4,3,4,220,3,41,1,16,21,37,140,158,298,0,315,17,1,10,2.92157,0.0784314,22.1961,115.392,51,0
New Zealand,184,233.745,7.39674,0.36413,227.951,7.30435,0.353261,100,LRPL Taylor,89,34,55,100,220,3,41,1,16,21,37,140,158,298,0,315,17,1,10,3.68382,0.301471,36.7206,79.3959,136,4
New Zealand,184,233.745,7.39674,0.36413,227.951,7.30435,0.353261,100,GD Elliott,0,0,0,0,220,3,41,1,16,21,37,140,158,298,0,315,17,1,10,2.67188,0.203125,29.4375,79.7629,64,4
New Zealand,184,233.745,7.39674,0.36413,227.951,7.30435,0.353261,100,DL Vettori,0,0,0,0,220,3,41,1,16,21,37,140,158,298,0,315,17,1,10,1.43662,0.028169,15.7606,86.0108,71,0
Sri Lanka,244,223.373,7.09016,0.344262,227.578,7.47541,0.385246,101,NLTC Perera,8,0,8,8,203,3,35,1,34,20,54,126,166,292,0,302,10,1,10,1.65333,0.0666667,14.32,105.397,75,0
Sri Lanka,244,223.373,7.09016,0.344262,227.578,7.47541,0.385246,101,LD Chandimal,48,14,34,43,203,3,35,1,34,20,54,126,166,292,0,302,10,1,10,2.18478,0.184783,25.7391,73.8615,92,4
Sri Lanka,244,223.373,7.09016,0.344262,227.578,7.47541,0.385246,101,BMAJ Mendis,0,0,0,0,203,3,35,1,34,20,54,126,166,292,0,302,10,1,10,1.43243,0.027027,15.1622,82.8656,37,1
England,221,237.176,7.17647,0.289593,230.633,7.45701,0.384615,101,JC Tredwell,16,10,6,19,182,7,21,2,0,2,2,64,141,205,303,215,10,0,10,0.52,0,6.52,65.9919,25,1
England,221,237.176,7.17647,0.289593,230.633,7.45701,0.384615,101,HF Gurney,5,0,5,8,182,7,21,2,0,2,2,64,141,205,303,215,10,0,10,0.166667,0,2.5,45.4545,6,3
India,259,242.378,7.15058,0.339768,244.568,7.12741,0.30888,102,Mohammed Shami,5,4,1,4,154,6,13,3,18,9,27,76,118,194,0,200,6,0,10,0.684211,0,5.68421,88.5246,19,0
India,259,242.378,7.15058,0.339768,244.568,7.12741,0.30888,102,MM Sharma,0,0,0,1,154,6,13,3,18,9,27,76,118,194,0,200,6,0,10,0.625,0,3.75,56.6038,8,3
England,221,237.176,7.17647,0.289593,230.633,7.45701,0.384615,102,JC Buttler,67,28,39,77,156,5,30,1,0,6,6,56,136,192,201,201,9,0,10,3.47458,0.186441,29.9153,115.359,59,0
England,221,237.176,7.17647,0.289593,230.633,7.45701,0.384615,102,SCJ Broad,0,0,0,0,156,5,30,1,0,6,6,56,136,192,201,201,9,0,10,0.725806,0,8.04839,74.0356,62,1
England,221,237.176,7.17647,0.289593,230.633,7.45701,0.384615,102,CR Woakes,1,0,1,4,156,5,30,1,0,6,6,56,136,192,201,201,9,0,10,1.09375,0,15.1562,76.8621,32,1
West Indies,176,217.33,7.15909,0.3125,225.278,7.57386,0.380682,103,MN Samuels,100,50,50,100,212,3,40,0,24,15,39,164,127,291,0,321,30,0,10,3.74757,0.23301,31.6214,74.5821,103,4
West Indies,176,217.33,7.15909,0.3125,225.278,7.57386,0.380682,103,D Ramdin,61,32,29,59,212,3,40,0,24,15,39,164,127,291,0,321,30,0,10,1.7439,0.097561,19.1951,81.1759,82,1
West Indies,176,217.33,7.15909,0.3125,225.278,7.57386,0.380682,103,KA Pollard,0,0,0,0,212,3,40,0,24,15,39,164,127,291,0,321,30,0,10,2.70513,0.115385,24.5,88.0645,78,4
West Indies,176,217.33,7.15909,0.3125,225.278,7.57386,0.380682,103,AD Russell,0,0,0,0,212,3,40,0,24,15,39,164,127,291,0,321,30,0,10,3.38095,0.0952381,23.2857,129.536,42,0
West Indies,176,217.33,7.15909,0.3125,225.278,7.57386,0.380682,103,DJG Sammy,0,0,0,0,212,3,40,0,24,15,39,164,127,291,0,321,30,0,10,2.25,0.09,18.25,95.8005,100,0
England,221,237.176,7.17647,0.289593,230.633,7.45701,0.384615,104,BA Stokes,44,28,16,29,224,4,40,1,20,19,39,166,137,303,0,318,15,0,10,2.23529,0.117647,20.1471,90.0131,34,0
England,221,237.176,7.17647,0.289593,230.633,7.45701,0.384615,104,MM Ali,2,0,2,7,224,4,40,1,20,19,39,166,137,303,0,318,15,0,10,2.67647,0.117647,21.3824,94.5384,34,0
England,221,237.176,7.17647,0.289593,230.633,7.45701,0.384615,104,CJ Jordan,0,0,0,0,224,4,40,1,20,19,39,166,137,303,0,318,15,0,10,0.833333,0,8.22222,84.0909,18,1
England,221,237.176,7.17647,0.289593,230.633,7.45701,0.384615,104,DJ Willey,0,0,0,0,224,4,40,1,20,19,39,166,137,303,0,318,15,0,10,0.571429,0,8.28571,86.5672,7,1
England,221,237.176,7.17647,0.289593,230.633,7.45701,0.384615,104,AU Rashid,0,0,0,0,224,4,40,1,20,19,39,166,137,303,0,318,15,0,10,2.41176,0.0588235,17.2941,108.889,17,0
South Africa,190,234.274,7.4,0.373684,232.363,7.33158,0.342105,104,F du Plessis,21,12,9,24,249,2,41,0,10,2,12,180,122,302,319,319,17,1,10,3.45122,0.292683,34.9268,83.135,82,4
South Africa,190,234.274,7.4,0.373684,232.363,7.33158,0.342105,104,HM Amla,127,64,63,134,249,2,41,0,10,2,12,180,122,302,319,319,17,1,10,5.20168,0.403361,48.7899,86.9292,119,4
South Africa,190,234.274,7.4,0.373684,232.363,7.33158,0.342105,104,AB de Villiers,0,0,0,0,249,2,41,0,10,2,12,180,122,302,319,319,17,1,10,5.04969,0.403727,47.2174,98.8428,161,4
South Africa,190,234.274,7.4,0.373684,232.363,7.33158,0.342105,105,F Behardien,35,14,21,41,120,7,33,2,0,2,2,62,93,155,0,162,7,0,10,2.0303,0.0909091,21.2424,91.395,33,0
South Africa,190,234.274,7.4,0.373684,232.363,7.33158,0.342105,105,Imran Tahir,0,0,0,1,120,7,33,2,0,2,2,62,93,155,0,162,7,0,10,0.625,0,5.0625,65.8537,16,1
Pakistan,211,222.621,7.38389,0.393365,235.517,7.54976,0.336493,106,Mohammad Rizwan,2,0,2,2,211,3,37,1,26,27,53,110,191,301,0,316,15,0,10,2.76923,0.230769,26.7692,92.8,13,0
Pakistan,211,222.621,7.38389,0.393365,235.517,7.54976,0.336493,106,Shoaib Malik,22,8,14,19,211,3,37,1,26,27,53,110,191,301,0,316,15,0,10,2.77551,0.193878,28.7041,81.4418,98,4
India,259,242.378,7.15058,0.339768,244.568,7.12741,0.30888,107,KM Jadhav,61,24,37,72,158,4,39,0,44,22,66,114,149,263,0,276,13,0,10,4.5,0.25,36.25,103.571,4,0
India,259,242.378,7.15058,0.339768,244.568,7.12741,0.30888,107,MK Pandey,67,22,45,82,158,4,39,0,44,22,66,114,149,263,0,276,13,0,10,5,0.666667,59.6667,101.705,3,4
India,259,242.378,7.15058,0.339768,244.568,7.12741,0.30888,107,STR Binny,0,0,0,0,158,4,39,0,44,22,66,114,149,263,0,276,13,0,10,2.4,0.1,20.5,95.7944,10,0
England,221,237.176,7.17647,0.289593,230.633,7.45701,0.384615,108,JE Root,63,12,51,75,223,2,27,0,8,19,27,108,169,277,0,283,6,0,10,3.68852,0.327869,41.6721,83.3443,61,4
England,221,237.176,7.17647,0.289593,230.633,7.45701,0.384615,108,JC Buttler,0,0,0,0,223,2,27,0,8,19,27,108,169,277,0,283,6,0,10,3.47458,0.186441,29.9153,115.359,59,0
England,221,237.176,7.17647,0.289593,230.633,7.45701,0.384615,108,EJG Morgan,24,10,14,21,223,2,27,0,8,19,27,108,169,277,0,283,6,0,10,3.19549,0.233083,30.0526,86.9291,133,4
England,221,237.176,7.17647,0.289593,230.633,7.45701,0.384615,108,JWA Taylor,0,0,0,0,223,2,27,0,8,19,27,108,169,277,0,283,6,0,10,3.375,0.333333,35.9167,79.8888,24,4
England,221,237.176,7.17647,0.289593,230.633,7.45701,0.384615,108,MM Ali,0,0,0,0,223,2,27,0,8,19,27,108,169,277,0,283,6,0,10,2.67647,0.117647,21.3824,94.5384,34,0
Pakistan,211,222.621,7.38389,0.393365,235.517,7.54976,0.336493,108,Yasir Shah,9,4,5,10,133,7,29,2,6,1,7,44,125,169,284,188,19,0,10,1.16667,0,12.6667,91.5663,6,0
Pakistan,211,222.621,7.38389,0.393365,235.517,7.54976,0.336493,108,Mohammad Irfan,0,0,0,0,133,7,29,2,6,1,7,44,125,169,284,188,19,0,10,0.233333,0,1.56667,30.9211,30,3
Bangladesh,160,218.438,7.70625,0.4,211.106,7.05,0.325,111,Mushfiqur Rahim,98,38,60,103,182,4,35,0,26,15,41,128,130,258,0,273,15,1,10,2.61111,0.18254,27.7778,75.2526,126,4
Bangladesh,160,218.438,7.70625,0.4,211.106,7.05,0.325,111,Sabbir Rahman,54,28,26,56,182,4,35,0,26,15,41,128,130,258,0,273,15,1,10,3.23529,0.117647,25.6471,98.1982,17,0
Bangladesh,160,218.438,7.70625,0.4,211.106,7.05,0.325,111,Nasir Hossain,0,0,0,0,182,4,35,0,26,15,41,128,130,258,0,273,15,1,10,2.75,0.159091,27.0455,79.3863,44,4
Bangladesh,160,218.438,7.70625,0.4,211.106,7.05,0.325,111,Mashrafe Mortaza,0,0,0,0,182,4,35,0,26,15,41,128,130,258,0,273,15,1,10,1.27536,0,11.1594,76.9231,69,1
Bangladesh,160,218.438,7.70625,0.4,211.106,7.05,0.325,111,Arafat Sunny,0,0,0,0,182,4,35,0,26,15,41,128,130,258,0,273,15,1,10,0.5,0,4.7,50,10,3
