Team,Total Matches Played,Runs Scored,Wickets Lost,Got All Out,Runs Conceded,Opponent Wickets Taken,Opponent All Out,Batsman,Player Total Runs,Player Home Runs,Player Non Home Runs,Balls Faced,R0,W0,R1,W1,Current_HR,Current_NHR,Total Runs in Segment,Total HR till Segment,Total NHR till Segment,Total Runs Till Segment,Target,Final Runs Made,Extras,Home,Segment,Home Run Hitting Ability,Milestone Reaching Ability,Batting Average,Strike Rate,Matches Played,ClusterID,Predicted_NHR,Abs_Error
England,221,237.176,7.17647,0.289593,230.633,7.45701,0.384615,IR Bell,0,0,0,0,0,0,0,0,12,15,27,12,15,27,0,271,2,1,1,3.63433,0.246269,35.3806,75.6623,134,4,7.9139,7.0861
Pakistan,211,222.621,7.38389,0.393365,235.517,7.54976,0.336493,Mohammad Hafeez,0,0,0,0,0,0,0,0,14,9,23,14,9,23,272,274,2,0,1,4.04511,0.255639,34.3534,78.0625,133,4,7.87558,1.12442
England,221,237.176,7.17647,0.289593,230.633,7.45701,0.384615,AJ Strauss,0,0,0,0,0,0,0,0,24,3,27,24,3,27,155,155,3,1,1,3.93243,0.27027,33.9054,79.8028,74,4,8.53874,-5.53874
England,221,237.176,7.17647,0.289593,230.633,7.45701,0.384615,ME Trescothick,0,0,0,0,0,0,0,0,4,11,15,4,11,15,258,237,0,1,1,6.625,0.375,49.5,87.4172,8,4,8.50741,2.49259
Sri Lanka,244,223.373,7.09016,0.344262,227.578,7.47541,0.385246,ST Jayasuriya,0,0,0,0,0,0,0,0,12,6,18,12,6,18,0,319,0,0,1,4.91549,0.211268,33.9859,98.4898,71,0,7.46273,-1.46273
Sri Lanka,244,223.373,7.09016,0.344262,227.578,7.47541,0.385246,WU Tharanga,0,0,0,0,0,0,0,0,30,7,37,30,7,37,262,265,1,0,1,3.93985,0.263158,32.9699,71.6035,133,4,7.28315,-0.283152
Sri Lanka,244,223.373,7.09016,0.344262,227.578,7.47541,0.385246,WU Tharanga,0,0,0,0,0,0,0,0,12,7,19,12,7,19,0,318,6,0,1,3.93985,0.263158,32.9699,71.6035,133,4,7.29478,-0.294781
India,259,242.378,7.15058,0.339768,244.568,7.12741,0.30888,R Dravid,0,0,0,0,0,0,0,0,8,6,14,8,6,14,0,217,1,0,1,2.83721,0.255814,29.8605,72.7067,43,4,8.02085,-2.02085
West Indies,176,217.33,7.15909,0.3125,225.278,7.57386,0.380682,CH Gayle,0,0,0,0,0,0,0,0,24,0,24,24,0,24,0,255,3,1,1,4.58621,0.206897,31.1293,89.4255,116,4,6.4592,-6.4592
Pakistan,211,222.621,7.38389,0.393365,235.517,7.54976,0.336493,Mohammad Hafeez,0,0,0,0,0,0,0,0,18,2,20,18,2,20,242,187,1,0,1,4.04511,0.255639,34.3534,78.0625,133,4,5.03109,-3.03109
Ireland,55,219.527,7.65455,0.290909,202.727,7.56364,0.4,JP Bray,0,0,0,0,0,0,0,0,10,5,15,10,5,15,0,221,2,0,1,2.7,0.1,23.4,63.0728,10,1,5.75996,-0.759959
New Zealand,184,233.745,7.39674,0.36413,227.951,7.30435,0.353261,L Vincent,0,0,0,0,0,0,0,0,12,4,16,12,4,16,210,210,3,0,1,3.125,0.25,27.8125,67.5266,16,4,7.47924,-3.47924
Bangladesh,160,218.438,7.70625,0.4,211.106,7.05,0.325,Mushfiqur Rahim,0,0,0,0,0,0,0,0,8,8,16,8,8,16,192,192,8,0,1,2.61111,0.18254,27.7778,75.2526,126,4,7.39861,0.601389
Ireland,55,219.527,7.65455,0.290909,202.727,7.56364,0.4,WTS Porterfield,0,0,0,0,0,0,0,0,4,10,14,4,10,14,133,133,1,0,1,2.6,0.142857,24.6857,56.2866,35,3,7.96004,2.03996
Pakistan,211,222.621,7.38389,0.393365,235.517,7.54976,0.336493,Kamran Akmal,0,0,0,0,0,0,0,0,12,11,23,12,11,23,0,349,2,0,1,3.01124,0.11236,23.0787,81.4433,89,4,7.17136,3.82864
Sri Lanka,244,223.373,7.09016,0.344262,227.578,7.47541,0.385246,ST Jayasuriya,0,0,0,0,0,0,0,0,0,9,9,0,9,9,0,254,10,0,1,4.91549,0.211268,33.9859,98.4898,71,0,7.46273,1.53727
South Africa,190,234.274,7.4,0.373684,232.363,7.33158,0.342105,AB de Villiers,0,0,0,0,0,0,0,0,30,7,37,30,7,37,378,294,3,0,1,5.04969,0.403727,47.2174,98.8428,161,4,9.6666,-2.6666
West Indies,176,217.33,7.15909,0.3125,225.278,7.57386,0.380682,S Chanderpaul,0,0,0,0,0,0,0,0,0,5,5,0,5,5,0,177,2,1,1,3.57143,0.396825,40.8254,68.0783,63,4,6.4592,-1.4592
New Zealand,184,233.745,7.39674,0.36413,227.951,7.30435,0.353261,HJH Marshall,0,0,0,0,0,0,0,0,8,7,15,8,7,15,178,179,1,0,1,1.1,0.1,11.4,69.5122,10,1,7.65185,-0.651848
England,221,237.176,7.17647,0.289593,230.633,7.45701,0.384615,EC Joyce,0,0,0,0,0,0,0,0,8,7,15,8,7,15,0,266,7,0,1,3.08571,0.2,28.3429,68.6505,35,4,7.75548,-0.755482
Ireland,55,219.527,7.65455,0.290909,202.727,7.56364,0.4,WTS Porterfield,0,0,0,0,0,0,0,0,0,7,7,0,7,7,267,218,4,0,1,2.6,0.142857,24.6857,56.2866,35,3,7.30397,-0.303966
Bangladesh,160,218.438,7.70625,0.4,211.106,7.05,0.325,Aftab Ahmed,0,0,0,0,0,0,0,0,10,12,22,10,12,22,0,104,2,0,1,2.44118,0.0882353,19.1471,73.8095,34,1,8.20551,3.79449
Bangladesh,160,218.438,7.70625,0.4,211.106,7.05,0.325,Javed Omar,0,0,0,0,0,0,0,0,8,6,14,8,6,14,0,174,0,0,1,2.66667,0.166667,24.3333,48.0263,6,3,8.00813,-2.00813
Ireland,55,219.527,7.65455,0.290909,202.727,7.56364,0.4,JP Bray,0,0,0,0,0,0,0,0,4,5,9,4,5,9,0,152,0,0,1,2.7,0.1,23.4,63.0728,10,1,5.75996,-0.759959
South Africa,190,234.274,7.4,0.373684,232.363,7.33158,0.342105,AB de Villiers,0,0,0,0,0,0,0,0,12,6,18,12,6,18,153,165,1,0,1,5.04969,0.403727,47.2174,98.8428,161,4,9.17507,-3.17507
Sri Lanka,244,223.373,7.09016,0.344262,227.578,7.47541,0.385246,WU Tharanga,0,0,0,0,0,0,0,0,8,10,18,8,10,18,0,235,1,0,1,3.93985,0.263158,32.9699,71.6035,133,4,7.29478,2.70522
England,221,237.176,7.17647,0.289593,230.633,7.45701,0.384615,MP Vaughan,0,0,0,0,0,0,0,0,4,7,11,4,7,11,236,233,0,0,1,2.6,0.1,20.6,66.4516,10,1,8.14361,-1.14361
Bangladesh,160,218.438,7.70625,0.4,211.106,7.05,0.325,Javed Omar,0,0,0,0,0,0,0,0,8,3,11,8,3,11,0,251,2,0,1,2.66667,0.166667,24.3333,48.0263,6,3,8.00813,-5.00813
England,221,237.176,7.17647,0.289593,230.633,7.45701,0.384615,MP Vaughan,0,0,0,0,0,0,0,0,4,12,16,4,12,16,0,247,2,0,1,2.6,0.1,20.6,66.4516,10,1,7.92709,4.07291
New Zealand,184,233.745,7.39674,0.36413,227.951,7.30435,0.353261,SP Fleming,0,0,0,0,0,0,0,0,0,3,3,0,3,3,0,219,1,0,1,3.875,0.25,30.2917,70.9268,24,4,7.05619,-4.05619
Sri Lanka,244,223.373,7.09016,0.344262,227.578,7.47541,0.385246,WU Tharanga,0,0,0,0,0,0,0,0,8,10,18,8,10,18,220,222,14,0,1,3.93985,0.263158,32.9699,71.6035,133,4,7.98484,2.01516
Sri Lanka,244,223.373,7.09016,0.344262,227.578,7.47541,0.385246,ST Jayasuriya,0,0,0,0,0,0,0,0,8,10,18,8,10,18,220,222,14,0,1,4.91549,0.211268,33.9859,98.4898,71,0,8.22192,1.77808
Sri Lanka,244,223.373,7.09016,0.344262,227.578,7.47541,0.385246,KC Sangakkara,0,0,0,0,0,0,0,0,8,10,18,8,10,18,220,222,14,0,1,4.33659,0.360976,41.9854,80.6276,205,4,7.98484,2.01516
South Africa,190,234.274,7.4,0.373684,232.363,7.33158,0.342105,GC Smith,0,0,0,0,0,0,0,0,0,3,3,0,3,3,0,193,2,0,1,3.97,0.29,33.57,79.6819,100,4,7.75548,-4.75548
Ireland,55,219.527,7.65455,0.290909,202.727,7.56364,0.4,WTS Porterfield,0,0,0,0,0,0,0,0,4,15,19,4,15,19,0,243,4,0,1,2.6,0.142857,24.6857,56.2866,35,3,5.51713,9.48287
Sri Lanka,244,223.373,7.09016,0.344262,227.578,7.47541,0.385246,ST Jayasuriya,0,0,0,0,0,0,0,0,8,9,17,8,9,17,0,226,9,0,1,4.91549,0.211268,33.9859,98.4898,71,0,7.46273,1.53727
Sri Lanka,244,223.373,7.09016,0.344262,227.578,7.47541,0.385246,KC Sangakkara,0,0,0,0,0,0,0,0,8,9,17,8,9,17,0,226,9,0,1,4.33659,0.360976,41.9854,80.6276,205,4,7.29478,1.70522
Ireland,55,219.527,7.65455,0.290909,202.727,7.56364,0.4,WTS Porterfield,0,0,0,0,0,0,0,0,4,6,10,4,6,10,0,77,1,0,1,2.6,0.142857,24.6857,56.2866,35,3,5.51713,0.482871
Australia,228,239.627,7.69737,0.372807,232.079,7.23246,0.337719,AC Gilchrist,0,0,0,0,0,0,0,0,24,6,30,24,6,30,0,348,2,0,1,4.3,0.275,31.425,96.1009,40,0,8.09344,-2.09344
New Zealand,184,233.745,7.39674,0.36413,227.951,7.30435,0.353261,SP Fleming,0,0,0,0,0,0,0,0,14,14,28,14,14,28,349,133,1,0,1,3.875,0.25,30.2917,70.9268,24,4,11.4104,2.58962
New Zealand,184,233.745,7.39674,0.36413,227.951,7.30435,0.353261,LRPL Taylor,0,0,0,0,0,0,0,0,0,6,6,0,6,6,290,208,4,0,1,3.68382,0.301471,36.7206,79.3959,136,4,7.55801,-1.55801
South Africa,190,234.274,7.4,0.373684,232.363,7.33158,0.342105,AB de Villiers,0,0,0,0,0,0,0,0,4,3,7,4,3,7,0,149,1,0,1,5.04969,0.403727,47.2174,98.8428,161,4,7.75548,-4.75548
Sri Lanka,244,223.373,7.09016,0.344262,227.578,7.47541,0.385246,ST Jayasuriya,0,0,0,0,0,0,0,0,12,4,16,12,4,16,282,215,2,0,1,4.91549,0.211268,33.9859,98.4898,71,0,8.26821,-4.26821
South Africa,190,234.274,7.4,0.373684,232.363,7.33158,0.342105,JH Kallis,0,0,0,0,0,0,0,0,8,10,18,8,10,18,0,248,4,1,1,3.58621,0.356322,37.2644,76.4442,87,4,7.50981,2.49019
India,259,242.378,7.15058,0.339768,244.568,7.12741,0.30888,W Jaffer,0,0,0,0,0,0,0,0,8,8,16,8,8,16,249,91,1,0,1,1,0,5,43.4783,2,3,8.79956,-0.799557
India,259,242.378,7.15058,0.339768,244.568,7.12741,0.30888,M Kaif,0,0,0,0,0,0,0,0,8,8,16,8,8,16,249,91,1,0,1,1.77778,0.222222,23.8889,61.4286,9,1,8.79956,-0.799557
India,259,242.378,7.15058,0.339768,244.568,7.12741,0.30888,SR Tendulkar,0,0,0,0,0,0,0,0,8,8,16,8,8,16,249,91,1,0,1,5.89773,0.363636,45.6023,84.5376,88,4,8.79956,-0.799557
South Africa,190,234.274,7.4,0.373684,232.363,7.33158,0.342105,GC Smith,0,0,0,0,0,0,0,0,8,1,9,8,1,9,0,274,1,1,1,3.97,0.29,33.57,79.6819,100,4,7.50981,-6.50981
South Africa,190,234.274,7.4,0.373684,232.363,7.33158,0.342105,GC Smith,0,0,0,0,0,0,0,0,4,3,7,4,3,7,0,243,0,1,1,3.97,0.29,33.57,79.6819,100,4,7.50981,-4.50981
South Africa,190,234.274,7.4,0.373684,232.363,7.33158,0.342105,LE Bosman,0,0,0,0,0,0,0,0,4,3,7,4,3,7,0,243,0,1,1,4.18182,0.181818,27.1818,97.7124,11,0,7.23992,-4.23992
Australia,228,239.627,7.69737,0.372807,232.079,7.23246,0.337719,ML Hayden,0,0,0,0,0,0,0,0,16,10,26,16,10,26,0,289,2,1,1,6.37838,0.378378,50.6757,83.3333,37,4,8.22214,1.77786
New Zealand,184,233.745,7.39674,0.36413,227.951,7.30435,0.353261,BB McCullum,0,0,0,0,0,0,0,0,4,6,10,4,6,10,290,184,0,0,1,3.98611,0.201389,29.9028,98.4004,144,0,7.76262,-1.76262
Australia,228,239.627,7.69737,0.372807,232.079,7.23246,0.337719,ML Hayden,0,0,0,0,0,0,0,0,4,4,8,4,4,8,219,224,4,1,1,6.37838,0.378378,50.6757,83.3333,37,4,8.83063,-4.83063
Australia,228,239.627,7.69737,0.372807,232.079,7.23246,0.337719,MJ Clarke,0,0,0,0,0,0,0,0,4,4,8,4,4,8,219,224,4,1,1,3.10294,0.301471,35.9265,74.0303,136,4,8.83063,-4.83063
New Zealand,184,233.745,7.39674,0.36413,227.951,7.30435,0.353261,L Vincent,0,0,0,0,0,0,0,0,4,8,12,4,8,12,344,335,1,0,1,3.125,0.25,27.8125,67.5266,16,4,8.9794,-0.979399
New Zealand,184,233.745,7.39674,0.36413,227.951,7.30435,0.353261,SP Fleming,0,0,0,0,0,0,0,0,4,13,17,4,13,17,0,290,2,0,1,3.875,0.25,30.2917,70.9268,24,4,7.05619,5.94381
New Zealand,184,233.745,7.39674,0.36413,227.951,7.30435,0.353261,PG Fulton,0,0,0,0,0,0,0,0,4,13,17,4,13,17,0,290,2,0,1,2.75,0.1875,27.4062,67.4615,32,4,7.05619,5.94381
Australia,228,239.627,7.69737,0.372807,232.079,7.23246,0.337719,ML Hayden,0,0,0,0,0,0,0,0,16,10,26,16,10,26,291,291,1,1,1,6.37838,0.378378,50.6757,83.3333,37,4,8.47193,1.52807
Australia,228,239.627,7.69737,0.372807,232.079,7.23246,0.337719,AC Gilchrist,0,0,0,0,0,0,0,0,8,8,16,8,8,16,243,246,16,1,1,4.3,0.275,31.425,96.1009,40,0,9.01815,-1.01815
England,221,237.176,7.17647,0.289593,230.633,7.45701,0.384615,AJ Strauss,0,0,0,0,0,0,0,0,6,7,13,6,7,13,0,110,1,0,1,3.93243,0.27027,33.9054,79.8028,74,4,7.75548,-0.755482
England,221,237.176,7.17647,0.289593,230.633,7.45701,0.384615,MB Loye,0,0,0,0,0,0,0,0,6,7,13,6,7,13,0,110,1,0,1,3.42857,0,20.2857,74.7368,7,1,7.92709,-0.927094
Australia,228,239.627,7.69737,0.372807,232.079,7.23246,0.337719,AC Gilchrist,0,0,0,0,0,0,0,0,16,6,22,16,6,22,111,111,5,1,1,4.3,0.275,31.425,96.1009,40,0,9.19493,-3.19493
England,221,237.176,7.17647,0.289593,230.633,7.45701,0.384615,EC Joyce,0,0,0,0,0,0,0,0,4,9,13,4,9,13,0,292,4,0,1,3.08571,0.2,28.3429,68.6505,35,4,7.75548,1.24452
Australia,228,239.627,7.69737,0.372807,232.079,7.23246,0.337719,ML Hayden,0,0,0,0,0,0,0,0,8,6,14,8,6,14,293,200,5,1,1,6.37838,0.378378,50.6757,83.3333,37,4,8.47193,-2.47193
New Zealand,184,233.745,7.39674,0.36413,227.951,7.30435,0.353261,BB McCullum,0,0,0,0,0,0,0,0,22,3,25,22,3,25,0,205,0,0,1,3.98611,0.201389,29.9028,98.4004,144,0,7.22414,-4.22414
New Zealand,184,233.745,7.39674,0.36413,227.951,7.30435,0.353261,SP Fleming,0,0,0,0,0,0,0,0,4,4,8,4,4,8,0,210,4,0,1,3.875,0.25,30.2917,70.9268,24,4,7.05619,-3.05619
New Zealand,184,233.745,7.39674,0.36413,227.951,7.30435,0.353261,PG Fulton,0,0,0,0,0,0,0,0,4,4,8,4,4,8,0,210,4,0,1,2.75,0.1875,27.4062,67.4615,32,4,7.05619,-3.05619
England,221,237.176,7.17647,0.289593,230.633,7.45701,0.384615,AJ Strauss,0,0,0,0,0,0,0,0,8,9,17,8,9,17,211,120,2,0,1,3.93243,0.27027,33.9054,79.8028,74,4,8.33739,0.662613
New Zealand,184,233.745,7.39674,0.36413,227.951,7.30435,0.353261,L Vincent,0,0,0,0,0,0,0,0,16,7,23,16,7,23,0,318,9,0,1,3.125,0.25,27.8125,67.5266,16,4,7.05619,-0.0561924
England,221,237.176,7.17647,0.289593,230.633,7.45701,0.384615,IR Bell,0,0,0,0,0,0,0,0,18,7,25,18,7,25,319,260,2,0,1,3.63433,0.246269,35.3806,75.6623,134,4,7.68589,-0.685887
Australia,228,239.627,7.69737,0.372807,232.079,7.23246,0.337719,ML Hayden,0,0,0,0,0,0,0,0,16,7,23,16,7,23,0,252,6,1,1,6.37838,0.378378,50.6757,83.3333,37,4,8.22214,-1.22214
England,221,237.176,7.17647,0.289593,230.633,7.45701,0.384615,IR Bell,0,0,0,0,0,0,0,0,8,6,14,8,6,14,253,253,0,0,1,3.63433,0.246269,35.3806,75.6623,134,4,7.8445,-1.8445
England,221,237.176,7.17647,0.289593,230.633,7.45701,0.384615,MB Loye,0,0,0,0,0,0,0,0,16,3,19,16,3,19,0,246,4,0,1,3.42857,0,20.2857,74.7368,7,1,7.92709,-4.92709
Australia,228,239.627,7.69737,0.372807,232.079,7.23246,0.337719,ML Hayden,0,0,0,0,0,0,0,0,12,17,29,12,17,29,247,152,6,1,1,6.37838,0.378378,50.6757,83.3333,37,4,10.4906,6.50943
Bangladesh,160,218.438,7.70625,0.4,211.106,7.05,0.325,Shahriar Nafees,0,0,0,0,0,0,0,0,4,5,9,4,5,9,303,265,10,0,1,3.40541,0.162162,24.4865,69.1076,37,4,6.99071,-1.99071
Sri Lanka,244,223.373,7.09016,0.344262,227.578,7.47541,0.385246,ST Jayasuriya,0,0,0,0,0,0,0,0,8,7,15,8,7,15,0,285,4,0,1,4.91549,0.211268,33.9859,98.4898,71,0,7.46273,-0.462727
Zimbabwe,142,212.077,7.5,0.380282,227.704,6.97887,0.316901,H Masakadza,0,0,0,0,0,0,0,0,4,6,10,4,6,10,286,141,3,0,1,3.11215,0.186916,26.972,70.0485,107,4,6.65402,-0.654018
Bangladesh,160,218.438,7.70625,0.4,211.106,7.05,0.325,Aftab Ahmed,0,0,0,0,0,0,0,0,8,5,13,8,5,13,0,161,1,0,1,2.44118,0.0882353,19.1471,73.8095,34,1,8.20551,-3.20551
West Indies,176,217.33,7.15909,0.3125,225.278,7.57386,0.380682,CH Gayle,0,0,0,0,0,0,0,0,12,6,18,12,6,18,162,164,2,0,1,4.58621,0.206897,31.1293,89.4255,116,4,8.21456,-2.21456
West Indies,176,217.33,7.15909,0.3125,225.278,7.57386,0.380682,S Chanderpaul,0,0,0,0,0,0,0,0,12,6,18,12,6,18,162,164,2,0,1,3.57143,0.396825,40.8254,68.0783,63,4,8.21456,-2.21456
Zimbabwe,142,212.077,7.5,0.380282,227.704,6.97887,0.316901,CJ Chibhabha,0,0,0,0,0,0,0,0,8,11,19,8,11,19,232,130,1,0,1,2.56716,0.149254,23.5373,64.7373,67,1,7.17223,3.82777
West Indies,176,217.33,7.15909,0.3125,225.278,7.57386,0.380682,WW Hinds,0,0,0,0,0,0,0,0,8,1,9,8,1,9,0,80,6,0,1,1.11111,0,12,38.9892,9,3,6.42326,-5.42326
Sri Lanka,244,223.373,7.09016,0.344262,227.578,7.47541,0.385246,DPMD Jayawardene,0,0,0,0,0,0,0,0,16,6,22,16,6,22,81,83,2,0,1,3.20833,0.244792,31.6979,79.1109,192,4,6.95564,-0.955639
Sri Lanka,244,223.373,7.09016,0.344262,227.578,7.47541,0.385246,ST Jayasuriya,0,0,0,0,0,0,0,0,16,6,22,16,6,22,81,83,2,0,1,4.91549,0.211268,33.9859,98.4898,71,0,7.1429,-1.1429
New Zealand,184,233.745,7.39674,0.36413,227.951,7.30435,0.353261,SP Fleming,0,0,0,0,0,0,0,0,12,7,19,12,7,19,0,195,3,0,1,3.875,0.25,30.2917,70.9268,24,4,7.05619,-0.0561924
South Africa,190,234.274,7.4,0.373684,232.363,7.33158,0.342105,GC Smith,0,0,0,0,0,0,0,0,4,7,11,4,7,11,196,108,1,0,1,3.97,0.29,33.57,79.6819,100,4,8.80751,-1.80751
South Africa,190,234.274,7.4,0.373684,232.363,7.33158,0.342105,HH Gibbs,0,0,0,0,0,0,0,0,4,7,11,4,7,11,196,108,1,0,1,4.61538,0.307692,35.6923,83.4157,52,4,8.80751,-1.80751
Sri Lanka,244,223.373,7.09016,0.344262,227.578,7.47541,0.385246,ST Jayasuriya,0,0,0,0,0,0,0,0,8,13,21,8,13,21,0,253,2,0,1,4.91549,0.211268,33.9859,98.4898,71,0,7.46273,5.53727
Australia,228,239.627,7.69737,0.372807,232.079,7.23246,0.337719,SR Watson,0,0,0,0,0,0,0,0,12,8,20,12,8,20,235,224,5,0,1,4.71318,0.286822,37.7907,90.0943,129,4,8.13622,-0.136217
New Zealand,184,233.745,7.39674,0.36413,227.951,7.30435,0.353261,SP Fleming,0,0,0,0,0,0,0,0,0,5,5,0,5,5,0,165,11,0,1,3.875,0.25,30.2917,70.9268,24,4,7.05619,-2.05619
New Zealand,184,233.745,7.39674,0.36413,227.951,7.30435,0.353261,NJ Astle,0,0,0,0,0,0,0,0,0,5,5,0,5,5,0,165,11,0,1,2.8,0.1,20,67.5676,10,1,7.05619,-2.05619
Sri Lanka,244,223.373,7.09016,0.344262,227.578,7.47541,0.385246,ST Jayasuriya,0,0,0,0,0,0,0,0,4,4,8,4,4,8,220,141,2,0,1,4.91549,0.211268,33.9859,98.4898,71,0,8.22192,-4.22192
Sri Lanka,244,223.373,7.09016,0.344262,227.578,7.47541,0.385246,DPMD Jayawardene,0,0,0,0,0,0,0,0,4,4,8,4,4,8,220,141,2,0,1,3.20833,0.244792,31.6979,79.1109,192,4,7.98484,-3.98484
India,259,242.378,7.15058,0.339768,244.568,7.12741,0.30888,V Sehwag,0,0,0,0,0,0,0,0,12,8,20,12,8,20,0,223,2,1,1,5.88636,0.238636,38.8295,108.649,88,0,6.73412,1.26588
South Africa,190,234.274,7.4,0.373684,232.363,7.33158,0.342105,HH Dippenaar,0,0,0,0,0,0,0,0,4,5,9,4,5,9,0,213,2,0,1,1.8,0.2,22,54.1872,5,3,7.69211,-2.69211
Pakistan,211,222.621,7.38389,0.393365,235.517,7.54976,0.336493,Imran Farhat,0,0,0,0,0,0,0,0,0,9,9,0,9,9,214,89,4,0,1,3.03333,0.266667,27.0333,62.9658,30,4,7.29199,1.70801
England,221,237.176,7.17647,0.289593,230.633,7.45701,0.384615,IR Bell,0,0,0,0,0,0,0,0,12,17,29,12,17,29,273,276,4,0,1,3.63433,0.246269,35.3806,75.6623,134,4,7.91583,9.08417
India,259,242.378,7.15058,0.339768,244.568,7.12741,0.30888,V Sehwag,0,0,0,0,0,0,0,0,16,9,25,16,9,25,0,249,4,1,1,5.88636,0.238636,38.8295,108.649,88,0,6.73412,2.26588
Australia,228,239.627,7.69737,0.372807,232.079,7.23246,0.337719,AC Gilchrist,0,0,0,0,0,0,0,0,8,10,18,8,10,18,250,252,10,0,1,4.3,0.275,31.425,96.1009,40,0,7.64667,2.35333
South Africa,190,234.274,7.4,0.373684,232.363,7.33158,0.342105,GC Smith,0,0,0,0,0,0,0,0,16,9,25,16,9,25,0,258,2,0,1,3.97,0.29,33.57,79.6819,100,4,7.75548,1.24452
Australia,228,239.627,7.69737,0.372807,232.079,7.23246,0.337719,AC Gilchrist,0,0,0,0,0,0,0,0,4,10,14,4,10,14,139,116,3,0,1,4.3,0.275,31.425,96.1009,40,0,8.57447,1.42553
Pakistan,211,222.621,7.38389,0.393365,235.517,7.54976,0.336493,Mohammad Hafeez,0,0,0,0,0,0,0,0,12,18,30,12,18,30,393,228,0,0,1,4.04511,0.255639,34.3534,78.0625,133,4,11.3911,6.60887
Pakistan,211,222.621,7.38389,0.393365,235.517,7.54976,0.336493,Kamran Akmal,0,0,0,0,0,0,0,0,12,18,30,12,18,30,393,228,0,0,1,3.01124,0.11236,23.0787,81.4433,89,4,11.3911,6.60887
South Africa,190,234.274,7.4,0.373684,232.363,7.33158,0.342105,GC Smith,0,0,0,0,0,0,0,0,24,7,31,24,7,31,352,210,0,1,1,3.97,0.29,33.57,79.6819,100,4,8.70397,-1.70397
Pakistan,211,222.621,7.38389,0.393365,235.517,7.54976,0.336493,Imran Nazir,0,0,0,0,0,0,0,0,0,3,3,0,3,3,0,107,0,0,1,4.66667,0.133333,29,96.0265,15,0,7.52279,-4.52279
Pakistan,211,222.621,7.38389,0.393365,235.517,7.54976,0.336493,Mohammad Hafeez,0,0,0,0,0,0,0,0,10,4,14,10,4,14,0,153,5,0,1,4.04511,0.255639,34.3534,78.0625,133,4,7.17136,-3.17136
Pakistan,211,222.621,7.38389,0.393365,235.517,7.54976,0.336493,Younis Khan,0,0,0,0,0,0,0,0,10,4,14,10,4,14,0,153,5,0,1,2.64655,0.215517,28.5,73.2713,116,4,7.17136,-3.17136
Sri Lanka,244,223.373,7.09016,0.344262,227.578,7.47541,0.385246,WU Tharanga,0,0,0,0,0,0,0,0,4,10,14,4,10,14,0,112,0,0,1,3.93985,0.263158,32.9699,71.6035,133,4,7.29478,2.70522
New Zealand,184,233.745,7.39674,0.36413,227.951,7.30435,0.353261,LRPL Taylor,0,0,0,0,0,0,0,0,16,6,22,16,6,22,113,110,6,1,1,3.68382,0.301471,36.7206,79.3959,136,4,8.12692,-2.12692
New Zealand,184,233.745,7.39674,0.36413,227.951,7.30435,0.353261,DL Vettori,0,0,0,0,0,0,0,0,16,6,22,16,6,22,113,110,6,1,1,1.43662,0.028169,15.7606,86.0108,71,0,7.30869,-1.30869
New Zealand,184,233.745,7.39674,0.36413,227.951,7.30435,0.353261,HJH Marshall,0,0,0,0,0,0,0,0,16,1,17,16,1,17,263,73,0,1,1,1.1,0.1,11.4,69.5122,10,1,6.77756,-5.77756
New Zealand,184,233.745,7.39674,0.36413,227.951,7.30435,0.353261,L Vincent,0,0,0,0,0,0,0,0,14,12,26,14,12,26,337,340,1,1,1,3.125,0.25,27.8125,67.5266,16,4,11.8098,0.190156
New Zealand,184,233.745,7.39674,0.36413,227.951,7.30435,0.353261,SP Fleming,0,0,0,0,0,0,0,0,14,12,26,14,12,26,337,340,1,1,1,3.875,0.25,30.2917,70.9268,24,4,11.8098,0.190156
New Zealand,184,233.745,7.39674,0.36413,227.951,7.30435,0.353261,L Vincent,0,0,0,0,0,0,0,0,16,7,23,16,7,23,347,350,7,1,1,3.125,0.25,27.8125,67.5266,16,4,9.33692,-2.33692
New Zealand,184,233.745,7.39674,0.36413,227.951,7.30435,0.353261,SP Fleming,0,0,0,0,0,0,0,0,16,7,23,16,7,23,347,350,7,1,1,3.875,0.25,30.2917,70.9268,24,4,9.33692,-2.33692
Zimbabwe,142,212.077,7.5,0.380282,227.704,6.97887,0.316901,T Duffin,0,0,0,0,0,0,0,0,0,5,5,0,5,5,0,201,3,0,1,4,0.25,35.75,62.1739,4,4,5.77377,-0.773766
West Indies,176,217.33,7.15909,0.3125,225.278,7.57386,0.380682,RR Sarwan,0,0,0,0,0,0,0,0,24,7,31,24,7,31,310,141,6,0,1,2.8254,0.222222,29.1429,69.1005,63,4,6.28583,0.714173
Australia,228,239.627,7.69737,0.372807,232.079,7.23246,0.337719,SM Katich,0,0,0,0,0,0,0,0,12,6,18,12,6,18,0,272,2,0,1,2.33333,0,18.6667,50.4505,3,3,6.88205,-0.882047
India,259,242.378,7.15058,0.339768,244.568,7.12741,0.30888,SK Raina,0,0,0,0,0,0,0,0,12,5,17,12,5,17,0,162,6,0,1,3.11111,0.216374,28.9064,91.8944,171,0,8.38985,-3.38985
India,259,242.378,7.15058,0.339768,244.568,7.12741,0.30888,R Dravid,0,0,0,0,0,0,0,0,4,12,16,4,12,16,214,195,4,0,1,2.83721,0.255814,29.8605,72.7067,43,4,8.33739,3.66261
Australia,228,239.627,7.69737,0.372807,232.079,7.23246,0.337719,SR Watson,0,0,0,0,0,0,0,0,4,5,9,4,5,9,0,240,2,0,1,4.71318,0.286822,37.7907,90.0943,129,4,7.75388,-2.75388
Australia,228,239.627,7.69737,0.372807,232.079,7.23246,0.337719,SM Katich,0,0,0,0,0,0,0,0,4,5,9,4,5,9,0,240,2,0,1,2.33333,0,18.6667,50.4505,3,3,6.88205,-1.88205
Zimbabwe,142,212.077,7.5,0.380282,227.704,6.97887,0.316901,T Duffin,0,0,0,0,0,0,0,0,4,9,13,4,9,13,419,247,7,0,1,4,0.25,35.75,62.1739,4,4,8.60473,0.395274
West Indies,176,217.33,7.15909,0.3125,225.278,7.57386,0.380682,MN Samuels,0,0,0,0,0,0,0,0,0,4,4,0,4,4,0,151,1,0,1,3.74757,0.23301,31.6214,74.5821,103,4,5.87734,-1.87734
Pakistan,211,222.621,7.38389,0.393365,235.517,7.54976,0.336493,Imran Farhat,0,0,0,0,0,0,0,0,0,4,4,0,4,4,0,209,3,1,1,3.03333,0.266667,27.0333,62.9658,30,4,7.1076,-3.1076
West Indies,176,217.33,7.15909,0.3125,225.278,7.57386,0.380682,LMP Simmons,0,0,0,0,0,0,0,0,16,3,19,16,3,19,210,212,5,0,1,3.3125,0.28125,30.5938,71.4338,64,4,5.71384,-2.71384
West Indies,176,217.33,7.15909,0.3125,225.278,7.57386,0.380682,MN Samuels,0,0,0,0,0,0,0,0,16,3,19,16,3,19,210,212,5,0,1,3.74757,0.23301,31.6214,74.5821,103,4,5.71384,-2.71384
West Indies,176,217.33,7.15909,0.3125,225.278,7.57386,0.380682,S Chanderpaul,0,0,0,0,0,0,0,0,12,10,22,12,10,22,0,238,0,0,1,3.57143,0.396825,40.8254,68.0783,63,4,5.87734,4.12266
Pakistan,211,222.621,7.38389,0.393365,235.517,7.54976,0.336493,Mohammad Hafeez,0,0,0,0,0,0,0,0,12,3,15,12,3,15,239,239,3,0,1,4.04511,0.255639,34.3534,78.0625,133,4,7.75814,-4.75814
West Indies,176,217.33,7.15909,0.3125,225.278,7.57386,0.380682,S Chanderpaul,0,0,0,0,0,0,0,0,4,5,9,4,5,9,226,146,3,0,1,3.57143,0.396825,40.8254,68.0783,63,4,5.35666,-0.356656
England,221,237.176,7.17647,0.289593,230.633,7.45701,0.384615,AN Cook,0,0,0,0,0,0,0,0,8,5,13,8,5,13,290,196,2,1,1,4.17045,0.272727,35.75,75.5524,88,4,7.69462,-2.69462
England,221,237.176,7.17647,0.289593,230.633,7.45701,0.384615,AN Cook,0,0,0,0,0,0,0,0,8,8,16,8,8,16,0,281,2,1,1,4.17045,0.272727,35.75,75.5524,88,4,7.9139,0.0861001
India,259,242.378,7.15058,0.339768,244.568,7.12741,0.30888,KD Karthik,0,0,0,0,0,0,0,0,16,2,18,16,2,18,0,212,4,0,1,2.46429,0.107143,21.6786,71.8769,56,1,8.38985,-6.38985
England,221,237.176,7.17647,0.289593,230.633,7.45701,0.384615,MJ Prior,0,0,0,0,0,0,0,0,16,14,30,16,14,30,213,213,1,1,1,2.27083,0.0625,21.6875,76.4879,48,4,8.17118,5.82882
England,221,237.176,7.17647,0.289593,230.633,7.45701,0.384615,AN Cook,0,0,0,0,0,0,0,0,0,12,12,0,12,12,325,242,0,1,1,4.17045,0.272727,35.75,75.5524,88,4,9.86317,2.13683
India,259,242.378,7.15058,0.339768,244.568,7.12741,0.30888,SC Ganguly,0,0,0,0,0,0,0,0,12,9,21,12,9,21,0,187,0,0,1,4.56,0.36,36.8,68.2999,25,4,8.02085,0.979147
England,221,237.176,7.17647,0.289593,230.633,7.45701,0.384615,IR Bell,0,0,0,0,0,0,0,0,0,11,11,0,11,11,188,188,12,1,1,3.63433,0.246269,35.3806,75.6623,134,4,8.34379,2.65621
South Africa,190,234.274,7.4,0.373684,232.363,7.33158,0.342105,LE Bosman,0,0,0,0,0,0,0,0,12,9,21,12,9,21,153,156,3,1,1,4.18182,0.181818,27.1818,97.7124,11,0,8.00418,0.995821
South Africa,190,234.274,7.4,0.373684,232.363,7.33158,0.342105,HH Dippenaar,0,0,0,0,0,0,0,0,12,9,21,12,9,21,153,156,3,1,1,1.8,0.2,22,54.1872,5,3,8.13466,0.865343
Zimbabwe,142,212.077,7.5,0.380282,227.704,6.97887,0.316901,S Matsikenyeri,0,0,0,0,0,0,0,0,4,4,8,4,4,8,0,217,6,0,1,2,0.106383,19.9787,75.7869,47,1,6.3628,-2.3628
Zimbabwe,142,212.077,7.5,0.380282,227.704,6.97887,0.316901,S Matsikenyeri,0,0,0,0,0,0,0,0,4,10,14,4,10,14,221,194,4,0,1,2,0.106383,19.9787,75.7869,47,1,8.16908,1.83092
Zimbabwe,142,212.077,7.5,0.380282,227.704,6.97887,0.316901,TMK Mawoyo,0,0,0,0,0,0,0,0,4,9,13,4,9,13,0,146,4,0,1,0.571429,0,8.28571,34.9398,7,3,6.3088,2.6912
West Indies,176,217.33,7.15909,0.3125,225.278,7.57386,0.380682,MN Samuels,0,0,0,0,0,0,0,0,16,4,20,16,4,20,269,270,15,0,1,3.74757,0.23301,31.6214,74.5821,103,4,6.96728,-2.96728
India,259,242.378,7.15058,0.339768,244.568,7.12741,0.30888,SC Ganguly,0,0,0,0,0,0,0,0,20,8,28,20,8,28,0,341,1,1,1,4.56,0.36,36.8,68.2999,25,4,7.08899,0.911011
Sri Lanka,244,223.373,7.09016,0.344262,227.578,7.47541,0.385246,WU Tharanga,0,0,0,0,0,0,0,0,14,8,22,14,8,22,0,257,4,0,1,3.93985,0.263158,32.9699,71.6035,133,4,7.29478,0.705219
Sri Lanka,244,223.373,7.09016,0.344262,227.578,7.47541,0.385246,MS Atapattu,0,0,0,0,0,0,0,0,14,8,22,14,8,22,0,257,4,0,1,2.63636,0,24.4545,66.9154,11,4,7.29478,0.705219
India,259,242.378,7.15058,0.339768,244.568,7.12741,0.30888,SC Ganguly,0,0,0,0,0,0,0,0,24,3,27,24,3,27,231,233,8,1,1,4.56,0.36,36.8,68.2999,25,4,8.04591,-5.04591
India,259,242.378,7.15058,0.339768,244.568,7.12741,0.30888,G Gambhir,0,0,0,0,0,0,0,0,28,6,34,28,6,34,251,251,1,0,1,3.99145,0.333333,37.4701,84.1944,117,4,8.06734,-2.06734
India,259,242.378,7.15058,0.339768,244.568,7.12741,0.30888,V Sehwag,0,0,0,0,0,0,0,0,28,6,34,28,6,34,251,251,1,0,1,5.88636,0.238636,38.8295,108.649,88,0,7.23147,-1.23147
India,259,242.378,7.15058,0.339768,244.568,7.12741,0.30888,G Gambhir,0,0,0,0,0,0,0,0,12,8,20,12,8,20,0,284,3,0,1,3.99145,0.333333,37.4701,84.1944,117,4,8.02085,-0.020853
England,221,237.176,7.17647,0.289593,230.633,7.45701,0.384615,P Mustard,0,0,0,0,0,0,0,0,16,9,25,16,9,25,270,150,0,0,1,3.33333,0.111111,23.8889,88.1148,9,0,8.12045,0.879555
England,221,237.176,7.17647,0.289593,230.633,7.45701,0.384615,AN Cook,0,0,0,0,0,0,0,0,4,6,10,4,6,10,0,234,0,0,1,4.17045,0.272727,35.75,75.5524,88,4,7.75548,-1.75548
England,221,237.176,7.17647,0.289593,230.633,7.45701,0.384615,P Mustard,0,0,0,0,0,0,0,0,4,6,10,4,6,10,0,234,0,0,1,3.33333,0.111111,23.8889,88.1148,9,0,8.09504,-2.09504
England,221,237.176,7.17647,0.289593,230.633,7.45701,0.384615,IR Bell,0,0,0,0,0,0,0,0,4,6,10,4,6,10,0,234,0,0,1,3.63433,0.246269,35.3806,75.6623,134,4,7.75548,-1.75548
Sri Lanka,244,223.373,7.09016,0.344262,227.578,7.47541,0.385246,WU Tharanga,0,0,0,0,0,0,0,0,8,10,18,8,10,18,235,169,1,1,1,3.93985,0.263158,32.9699,71.6035,133,4,8.22529,1.77471
Sri Lanka,244,223.373,7.09016,0.344262,227.578,7.47541,0.385246,ST Jayasuriya,0,0,0,0,0,0,0,0,4,1,5,4,1,5,0,211,4,1,1,4.91549,0.211268,33.9859,98.4898,71,0,7.45349,-6.45349
Sri Lanka,244,223.373,7.09016,0.344262,227.578,7.47541,0.385246,MDK Perera,0,0,0,0,0,0,0,0,14,16,30,14,16,30,0,211,3,1,1,1,0,11,54.321,4,3,7.45349,8.54651
England,221,237.176,7.17647,0.289593,230.633,7.45701,0.384615,IR Bell,0,0,0,0,0,0,0,0,0,6,6,0,6,6,212,104,1,0,1,3.63433,0.246269,35.3806,75.6623,134,4,8.33739,-2.33739
Australia,228,239.627,7.69737,0.372807,232.079,7.23246,0.337719,ML Hayden,0,0,0,0,0,0,0,0,26,24,50,26,24,50,255,255,1,1,1,6.37838,0.378378,50.6757,83.3333,37,4,8.97577,15.0242
New Zealand,184,233.745,7.39674,0.36413,227.951,7.30435,0.353261,BB McCullum,0,0,0,0,0,0,0,0,4,5,9,4,5,9,283,168,0,0,1,3.98611,0.201389,29.9028,98.4004,144,0,7.76262,-2.76262
Sri Lanka,244,223.373,7.09016,0.344262,227.578,7.47541,0.385246,ST Jayasuriya,0,0,0,0,0,0,0,0,8,9,17,8,9,17,254,125,1,0,1,4.91549,0.211268,33.9859,98.4898,71,0,8.17848,0.821518
Australia,228,239.627,7.69737,0.372807,232.079,7.23246,0.337719,AC Gilchrist,0,0,0,0,0,0,0,0,20,10,30,20,10,30,0,159,7,1,1,4.3,0.275,31.425,96.1009,40,0,8.18114,1.81886
India,259,242.378,7.15058,0.339768,244.568,7.12741,0.30888,SR Tendulkar,0,0,0,0,0,0,0,0,20,9,29,20,9,29,160,160,1,0,1,5.89773,0.363636,45.6023,84.5376,88,4,8.46067,0.539327
Sri Lanka,244,223.373,7.09016,0.344262,227.578,7.47541,0.385246,TM Dilshan,0,0,0,0,0,0,0,0,20,8,28,20,8,28,237,173,8,0,1,4.60199,0.273632,38.3632,86.0219,201,4,7.79106,0.208939
India,259,242.378,7.15058,0.339768,244.568,7.12741,0.30888,IK Pathan,0,0,0,0,0,0,0,0,12,8,20,12,8,20,204,153,1,0,1,1.875,0.025,16.85,78.2811,40,1,8.33739,-0.337387
Sri Lanka,244,223.373,7.09016,0.344262,227.578,7.47541,0.385246,TM Dilshan,0,0,0,0,0,0,0,0,4,3,7,4,3,7,0,238,0,0,1,4.60199,0.273632,38.3632,86.0219,201,4,7.29478,-4.29478
Australia,228,239.627,7.69737,0.372807,232.079,7.23246,0.337719,AC Gilchrist,0,0,0,0,0,0,0,0,4,8,12,4,8,12,0,184,0,1,1,4.3,0.275,31.425,96.1009,40,0,8.18114,-0.181139
Sri Lanka,244,223.373,7.09016,0.344262,227.578,7.47541,0.385246,KC Sangakkara,0,0,0,0,0,0,0,0,0,8,8,0,8,8,185,77,0,0,1,4.33659,0.360976,41.9854,80.6276,205,4,8.15744,-0.157441
Sri Lanka,244,223.373,7.09016,0.344262,227.578,7.47541,0.385246,DPMD Jayawardene,0,0,0,0,0,0,0,0,0,8,8,0,8,8,185,77,0,0,1,3.20833,0.244792,31.6979,79.1109,192,4,8.15744,-0.157441
India,259,242.378,7.15058,0.339768,244.568,7.12741,0.30888,SR Tendulkar,0,0,0,0,0,0,0,0,16,8,24,16,8,24,318,299,2,0,1,5.89773,0.363636,45.6023,84.5376,88,4,8.59407,-0.594072
Sri Lanka,244,223.373,7.09016,0.344262,227.578,7.47541,0.385246,ST Jayasuriya,0,0,0,0,0,0,0,0,4,8,12,4,8,12,0,221,0,0,1,4.91549,0.211268,33.9859,98.4898,71,0,7.46273,0.537273
Sri Lanka,244,223.373,7.09016,0.344262,227.578,7.47541,0.385246,KC Sangakkara,0,0,0,0,0,0,0,0,4,8,12,4,8,12,0,221,0,0,1,4.33659,0.360976,41.9854,80.6276,205,4,7.29478,0.705219
Australia,228,239.627,7.69737,0.372807,232.079,7.23246,0.337719,MJ Clarke,0,0,0,0,0,0,0,0,12,9,21,12,9,21,0,239,2,1,1,3.10294,0.301471,35.9265,74.0303,136,4,8.22214,0.777863
India,259,242.378,7.15058,0.339768,244.568,7.12741,0.30888,RV Uthappa,0,0,0,0,0,0,0,0,0,13,13,0,13,13,0,258,1,0,1,3,0.117647,22.1471,89.0071,34,0,8.38985,4.61015
Australia,228,239.627,7.69737,0.372807,232.079,7.23246,0.337719,ML Hayden,0,0,0,0,0,0,0,0,4,9,13,4,9,13,259,249,0,1,1,6.37838,0.378378,50.6757,83.3333,37,4,8.53635,0.463649
South Africa,190,234.274,7.4,0.373684,232.363,7.33158,0.342105,MN van Wyk,0,0,0,0,0,0,0,0,0,5,5,0,5,5,0,226,2,0,1,3.33333,0.266667,27.2,66.9951,15,4,7.75548,-2.75548
India,259,242.378,7.15058,0.339768,244.568,7.12741,0.30888,SR Tendulkar,0,0,0,0,0,0,0,0,16,4,20,16,4,20,227,227,1,0,1,5.89773,0.363636,45.6023,84.5376,88,4,7.07523,-3.07523
India,259,242.378,7.15058,0.339768,244.568,7.12741,0.30888,SC Ganguly,0,0,0,0,0,0,0,0,12,8,20,12,8,20,149,152,2,0,1,4.56,0.36,36.8,68.2999,25,4,8,0
Sri Lanka,244,223.373,7.09016,0.344262,227.578,7.47541,0.385246,ST Jayasuriya,0,0,0,0,0,0,0,0,12,9,21,12,9,21,138,141,6,1,1,4.91549,0.211268,33.9859,98.4898,71,0,8.81307,0.186927
Bangladesh,160,218.438,7.70625,0.4,211.106,7.05,0.325,Mushfiqur Rahim,0,0,0,0,0,0,0,0,4,6,10,4,6,10,197,157,14,0,1,2.61111,0.18254,27.7778,75.2526,126,4,7.39861,-1.39861
England,221,237.176,7.17647,0.289593,230.633,7.45701,0.384615,IR Bell,0,0,0,0,0,0,0,0,18,5,23,18,5,23,0,307,4,1,1,3.63433,0.246269,35.3806,75.6623,134,4,7.9139,-2.9139
New Zealand,184,233.745,7.39674,0.36413,227.951,7.30435,0.353261,BB McCullum,0,0,0,0,0,0,0,0,18,12,30,18,12,30,308,193,4,0,1,3.98611,0.201389,29.9028,98.4004,144,0,8.6238,3.3762
New Zealand,184,233.745,7.39674,0.36413,227.951,7.30435,0.353261,JM How,0,0,0,0,0,0,0,0,8,5,13,8,5,13,246,246,1,0,1,3.34615,0.192308,29.9231,64.9416,26,4,7.02261,-2.02261
England,221,237.176,7.17647,0.289593,230.633,7.45701,0.384615,MJ Prior,0,0,0,0,0,0,0,0,12,13,25,12,13,25,0,275,2,1,1,2.27083,0.0625,21.6875,76.4879,48,4,7.9139,5.0861
South Africa,190,234.274,7.4,0.373684,232.363,7.33158,0.342105,HH Gibbs,0,0,0,0,0,0,0,0,8,14,22,8,14,22,276,255,3,0,1,4.61538,0.307692,35.6923,83.4157,52,4,9.04321,4.95679
South Africa,190,234.274,7.4,0.373684,232.363,7.33158,0.342105,GC Smith,0,0,0,0,0,0,0,0,8,14,22,8,14,22,276,255,3,0,1,3.97,0.29,33.57,79.6819,100,4,9.04321,4.95679
South Africa,190,234.274,7.4,0.373684,232.363,7.33158,0.342105,JH Kallis,0,0,0,0,0,0,0,0,12,8,20,12,8,20,0,83,1,0,1,3.58621,0.356322,37.2644,76.4442,87,4,7.75548,0.244518
England,221,237.176,7.17647,0.289593,230.633,7.45701,0.384615,IR Bell,0,0,0,0,0,0,0,0,8,9,17,8,9,17,84,85,4,1,1,3.63433,0.246269,35.3806,75.6623,134,4,11.2674,-2.2674
South Africa,190,234.274,7.4,0.373684,232.363,7.33158,0.342105,HH Gibbs,0,0,0,0,0,0,0,0,0,9,9,0,9,9,297,170,1,0,1,4.61538,0.307692,35.6923,83.4157,52,4,9.2114,-0.211398
South Africa,190,234.274,7.4,0.373684,232.363,7.33158,0.342105,HH Gibbs,0,0,0,0,0,0,0,0,24,7,31,24,7,31,0,183,5,0,1,4.61538,0.307692,35.6923,83.4157,52,4,7.75548,-0.755482
India,259,242.378,7.15058,0.339768,244.568,7.12741,0.30888,RV Uthappa,0,0,0,0,0,0,0,0,4,9,13,4,9,13,291,243,2,1,1,3,0.117647,22.1471,89.0071,34,0,7.47072,1.52928
Australia,228,239.627,7.69737,0.372807,232.079,7.23246,0.337719,MJ Clarke,0,0,0,0,0,0,0,0,26,7,33,26,7,33,0,317,1,0,1,3.10294,0.301471,35.9265,74.0303,136,4,7.75388,-0.753881
Australia,228,239.627,7.69737,0.372807,232.079,7.23246,0.337719,RT Ponting,0,0,0,0,0,0,0,0,4,10,14,4,10,14,0,193,10,0,1,4.17431,0.33945,38.1009,80.8606,109,4,7.75388,2.24612
India,259,242.378,7.15058,0.339768,244.568,7.12741,0.30888,Yuvraj Singh,0,0,0,0,0,0,0,0,8,1,9,8,1,9,194,195,7,1,1,4.05833,0.258333,32.525,83.8093,120,4,7.76709,-6.76709
Pakistan,211,222.621,7.38389,0.393365,235.517,7.54976,0.336493,Salman Butt,0,0,0,0,0,0,0,0,16,4,20,16,4,20,0,239,2,0,1,5.4359,0.384615,42.3846,78.8645,39,4,7.17136,-3.17136
Pakistan,211,222.621,7.38389,0.393365,235.517,7.54976,0.336493,Kamran Akmal,0,0,0,0,0,0,0,0,16,4,20,16,4,20,0,239,2,0,1,3.01124,0.11236,23.0787,81.4433,89,4,7.17136,-3.17136
Pakistan,211,222.621,7.38389,0.393365,235.517,7.54976,0.336493,Salman Butt,0,0,0,0,0,0,0,0,12,9,21,12,9,21,322,322,13,0,1,5.4359,0.384615,42.3846,78.8645,39,4,8.33665,0.663346
India,259,242.378,7.15058,0.339768,244.568,7.12741,0.30888,RV Uthappa,0,0,0,0,0,0,0,0,16,5,21,16,5,21,307,275,3,1,1,3,0.117647,22.1471,89.0071,34,0,6.77877,-1.77877
New Zealand,184,233.745,7.39674,0.36413,227.951,7.30435,0.353261,BB McCullum,0,0,0,0,0,0,0,0,8,10,18,8,10,18,210,210,0,0,1,3.98611,0.201389,29.9028,98.4004,144,0,7.71633,2.28367
New Zealand,184,233.745,7.39674,0.36413,227.951,7.30435,0.353261,BB McCullum,0,0,0,0,0,0,0,0,4,8,12,4,8,12,0,238,4,0,1,3.98611,0.201389,29.9028,98.4004,144,0,7.22414,0.775861
West Indies,176,217.33,7.15909,0.3125,225.278,7.57386,0.380682,DS Smith,0,0,0,0,0,0,0,0,4,11,15,4,11,15,0,175,6,0,1,2.61765,0.147059,23.5588,71.2,34,4,5.87734,5.12266
West Indies,176,217.33,7.15909,0.3125,225.278,7.57386,0.380682,RS Morton,0,0,0,0,0,0,0,0,4,7,11,4,7,11,256,169,2,0,1,2.2963,0.222222,28.8889,67.0103,27,4,7.69146,-0.691458
West Indies,176,217.33,7.15909,0.3125,225.278,7.57386,0.380682,BA Parchment,0,0,0,0,0,0,0,0,12,5,17,12,5,17,0,252,1,0,1,2.33333,0,17.8333,54.0404,6,3,6.42326,-1.42326
South Africa,190,234.274,7.4,0.373684,232.363,7.33158,0.342105,HH Gibbs,0,0,0,0,0,0,0,0,12,4,16,12,4,16,264,266,2,1,1,4.61538,0.307692,35.6923,83.4157,52,4,7.47282,-3.47282
Pakistan,211,222.621,7.38389,0.393365,235.517,7.54976,0.336493,Mohammad Hafeez,0,0,0,0,0,0,0,0,12,8,20,12,8,20,295,249,0,1,1,4.04511,0.255639,34.3534,78.0625,133,4,7.51062,0.489382
South Africa,190,234.274,7.4,0.373684,232.363,7.33158,0.342105,AB de Villiers,0,0,0,0,0,0,0,0,8,11,19,8,11,19,266,240,5,0,1,5.04969,0.403727,47.2174,98.8428,161,4,8.11927,2.88073
Pakistan,211,222.621,7.38389,0.393365,235.517,7.54976,0.336493,Younis Khan,0,0,0,0,0,0,0,0,0,6,6,0,6,6,0,230,1,1,1,2.64655,0.215517,28.5,73.2713,116,4,7.1076,-1.1076
South Africa,190,234.274,7.4,0.373684,232.363,7.33158,0.342105,HH Gibbs,0,0,0,0,0,0,0,0,12,16,28,12,16,28,231,233,1,0,1,4.61538,0.307692,35.6923,83.4157,52,4,8.2099,7.7901
Pakistan,211,222.621,7.38389,0.393365,235.517,7.54976,0.336493,Imran Nazir,0,0,0,0,0,0,0,0,28,2,30,28,2,30,234,219,1,1,1,4.66667,0.133333,29,96.0265,15,0,6.83934,-4.83934
New Zealand,184,233.745,7.39674,0.36413,227.951,7.30435,0.353261,BB McCullum,0,0,0,0,0,0,0,0,8,8,16,8,8,16,0,335,5,1,1,3.98611,0.201389,29.9028,98.4004,144,0,6.81018,1.18982
Bangladesh,160,218.438,7.70625,0.4,211.106,7.05,0.325,Tamim Iqbal,0,0,0,0,0,0,0,0,4,3,7,4,3,7,0,93,0,0,1,4.05344,0.274809,31.8015,76.8068,131,4,8.00813,-5.00813
Bangladesh,160,218.438,7.70625,0.4,211.106,7.05,0.325,Junaid Siddique,0,0,0,0,0,0,0,0,4,3,7,4,3,7,0,93,0,0,1,2.16279,0.116279,20.0233,68.225,43,1,8.20551,-5.20551
Bangladesh,160,218.438,7.70625,0.4,211.106,7.05,0.325,Mohammad Ashraful,0,0,0,0,0,0,0,0,4,3,7,4,3,7,0,93,0,0,1,2.17722,0.113924,19.4557,63.9085,79,1,8.20551,-5.20551
England,221,237.176,7.17647,0.289593,230.633,7.45701,0.384615,AN Cook,0,0,0,0,0,0,0,0,0,9,9,0,9,9,0,130,3,0,1,4.17045,0.272727,35.75,75.5524,88,4,7.75548,1.24452
England,221,237.176,7.17647,0.289593,230.633,7.45701,0.384615,P Mustard,0,0,0,0,0,0,0,0,0,9,9,0,9,9,0,130,3,0,1,3.33333,0.111111,23.8889,88.1148,9,0,8.09504,0.90496
England,221,237.176,7.17647,0.289593,230.633,7.45701,0.384615,P Mustard,0,0,0,0,0,0,0,0,20,5,25,20,5,25,0,340,1,0,1,3.33333,0.111111,23.8889,88.1148,9,0,8.09504,-3.09504
New Zealand,184,233.745,7.39674,0.36413,227.951,7.30435,0.353261,BB McCullum,0,0,0,0,0,0,0,0,18,16,34,18,16,34,341,340,2,1,1,3.98611,0.201389,29.9028,98.4004,144,0,12.177,3.82304
England,221,237.176,7.17647,0.289593,230.633,7.45701,0.384615,P Mustard,0,0,0,0,0,0,0,0,0,8,8,0,8,8,0,242,1,0,1,3.33333,0.111111,23.8889,88.1148,9,0,8.09504,-0.0950403
Zimbabwe,142,212.077,7.5,0.380282,227.704,6.97887,0.316901,V Sibanda,0,0,0,0,0,0,0,0,12,4,16,12,4,16,0,206,5,1,1,2.9697,0.181818,23.5152,63.5545,66,1,6.27492,-2.27492
Zimbabwe,142,212.077,7.5,0.380282,227.704,6.97887,0.316901,H Masakadza,0,0,0,0,0,0,0,0,8,2,10,8,2,10,0,247,0,1,1,3.11215,0.186916,26.972,70.0485,107,4,6.39467,-4.39467
South Africa,190,234.274,7.4,0.373684,232.363,7.33158,0.342105,GC Smith,0,0,0,0,0,0,0,0,8,9,17,8,9,17,0,323,4,0,1,3.97,0.29,33.57,79.6819,100,4,7.75548,1.24452
West Indies,176,217.33,7.15909,0.3125,225.278,7.57386,0.380682,S Chanderpaul,0,0,0,0,0,0,0,0,4,7,11,4,7,11,275,244,1,0,1,3.57143,0.396825,40.8254,68.0783,63,4,6.96728,0.0327249
West Indies,176,217.33,7.15909,0.3125,225.278,7.57386,0.380682,BA Parchment,0,0,0,0,0,0,0,0,4,9,13,4,9,13,233,234,3,0,1,2.33333,0,17.8333,54.0404,6,3,5.32509,3.67491
Sri Lanka,244,223.373,7.09016,0.344262,227.578,7.47541,0.385246,WU Tharanga,0,0,0,0,0,0,0,0,8,4,12,8,4,12,0,235,1,0,1,3.93985,0.263158,32.9699,71.6035,133,4,7.29478,-3.29478
West Indies,176,217.33,7.15909,0.3125,225.278,7.57386,0.380682,CH Gayle,0,0,0,0,0,0,0,0,8,6,14,8,6,14,236,236,0,1,1,4.58621,0.206897,31.1293,89.4255,116,4,4.54663,1.45337
West Indies,176,217.33,7.15909,0.3125,225.278,7.57386,0.380682,DS Smith,0,0,0,0,0,0,0,0,8,6,14,8,6,14,236,236,0,1,1,2.61765,0.147059,23.5588,71.2,34,4,4.54663,1.45337
West Indies,176,217.33,7.15909,0.3125,225.278,7.57386,0.380682,CH Gayle,0,0,0,0,0,0,0,0,4,10,14,4,10,14,113,125,1,1,1,4.58621,0.206897,31.1293,89.4255,116,4,7.19898,2.80102
Australia,228,239.627,7.69737,0.372807,232.079,7.23246,0.337719,SE Marsh,0,0,0,0,0,0,0,0,16,13,29,16,13,29,0,273,2,0,1,3.66667,0.291667,35.5417,74.7918,48,4,7.75388,5.24612
West Indies,176,217.33,7.15909,0.3125,225.278,7.57386,0.380682,CH Gayle,0,0,0,0,0,0,0,0,4,8,12,4,8,12,274,189,1,1,1,4.58621,0.206897,31.1293,89.4255,116,4,6.57981,1.42019
West Indies,176,217.33,7.15909,0.3125,225.278,7.57386,0.380682,RR Sarwan,0,0,0,0,0,0,0,0,4,8,12,4,8,12,274,189,1,1,1,2.8254,0.222222,29.1429,69.1005,63,4,6.57981,1.42019
West Indies,176,217.33,7.15909,0.3125,225.278,7.57386,0.380682,ADS Fletcher,0,0,0,0,0,0,0,0,4,2,6,4,2,6,214,140,2,1,1,1.8125,0.125,13.5,62.6087,16,1,5.75801,-3.75801
Australia,228,239.627,7.69737,0.372807,232.079,7.23246,0.337719,SE Marsh,0,0,0,0,0,0,0,0,20,6,26,20,6,26,0,282,5,0,1,3.66667,0.291667,35.5417,74.7918,48,4,7.75388,-1.75388
West Indies,176,217.33,7.15909,0.3125,225.278,7.57386,0.380682,XM Marshall,0,0,0,0,0,0,0,0,20,7,27,20,7,27,283,281,2,1,1,1.5,0,10.5,58.3333,8,3,6.57981,0.420186
Bangladesh,160,218.438,7.70625,0.4,211.106,7.05,0.325,Junaid Siddique,0,0,0,0,0,0,0,0,12,8,20,12,8,20,0,178,1,1,1,2.16279,0.116279,20.0233,68.225,43,1,4.97499,3.02501
South Africa,190,234.274,7.4,0.373684,232.363,7.33158,0.342105,HH Gibbs,0,0,0,0,0,0,0,0,8,6,14,8,6,14,179,180,2,0,1,4.61538,0.307692,35.6923,83.4157,52,4,8.98012,-2.98012
Bangladesh,160,218.438,7.70625,0.4,211.106,7.05,0.325,Shahriar Nafees,0,0,0,0,0,0,0,0,12,3,15,12,3,15,0,173,2,1,1,3.40541,0.162162,24.4865,69.1076,37,4,6.14827,-3.14827
Bangladesh,160,218.438,7.70625,0.4,211.106,7.05,0.325,Tamim Iqbal,0,0,0,0,0,0,0,0,4,4,8,4,4,8,0,143,3,1,1,4.05344,0.274809,31.8015,76.8068,131,4,6.14827,-2.14827
Bangladesh,160,218.438,7.70625,0.4,211.106,7.05,0.325,Shahriar Nafees,0,0,0,0,0,0,0,0,4,4,8,4,4,8,0,143,3,1,1,3.40541,0.162162,24.4865,69.1076,37,4,6.14827,-2.14827
Zimbabwe,142,212.077,7.5,0.380282,227.704,6.97887,0.316901,C Zhuwao,0,0,0,0,0,0,0,0,38,2,40,38,2,40,0,303,3,0,1,3,0,16,72.7273,1,1,6.3628,-4.3628
Ireland,55,219.527,7.65455,0.290909,202.727,7.56364,0.4,GC Wilson,0,0,0,0,0,0,0,0,8,4,12,8,4,12,304,147,4,0,1,2.22727,0.227273,22,78.1906,22,4,6.99071,-2.99071
Zimbabwe,142,212.077,7.5,0.380282,227.704,6.97887,0.316901,H Masakadza,0,0,0,0,0,0,0,0,8,10,18,8,10,18,348,243,7,0,1,3.11215,0.186916,26.972,70.0485,107,4,6.56427,3.43573
Pakistan,211,222.621,7.38389,0.393365,235.517,7.54976,0.336493,Nasir Jamshed,0,0,0,0,0,0,0,0,4,2,6,4,2,6,0,272,2,1,1,3.63043,0.23913,30.2174,73.8184,46,4,7.1076,-5.1076
Zimbabwe,142,212.077,7.5,0.380282,227.704,6.97887,0.316901,SC Williams,0,0,0,0,0,0,0,0,0,6,6,0,6,6,0,244,6,0,1,2.56923,0.276923,28.5385,80.7927,65,4,5.77377,0.226234
Zimbabwe,142,212.077,7.5,0.380282,227.704,6.97887,0.316901,H Masakadza,0,0,0,0,0,0,0,0,4,12,16,4,12,16,0,181,7,0,1,3.11215,0.186916,26.972,70.0485,107,4,5.77377,6.22623
Bangladesh,160,218.438,7.70625,0.4,211.106,7.05,0.325,Mohammad Ashraful,0,0,0,0,0,0,0,0,8,7,15,8,7,15,358,226,0,0,1,2.17722,0.113924,19.4557,63.9085,79,1,6.63644,0.363558
India,259,242.378,7.15058,0.339768,244.568,7.12741,0.30888,RV Uthappa,0,0,0,0,0,0,0,0,12,12,24,12,12,24,284,284,2,0,1,3,0.117647,22.1471,89.0071,34,0,7.8668,4.1332
Sri Lanka,244,223.373,7.09016,0.344262,227.578,7.47541,0.385246,KC Sangakkara,0,0,0,0,0,0,0,0,12,9,21,12,9,21,0,302,4,0,1,4.33659,0.360976,41.9854,80.6276,205,4,7.29478,1.70522
Sri Lanka,244,223.373,7.09016,0.344262,227.578,7.47541,0.385246,DPMD Jayawardene,0,0,0,0,0,0,0,0,12,9,21,12,9,21,0,302,4,0,1,3.20833,0.244792,31.6979,79.1109,192,4,7.29478,1.70522
Bangladesh,160,218.438,7.70625,0.4,211.106,7.05,0.325,Mohammad Ashraful,0,0,0,0,0,0,0,0,4,6,10,4,6,10,333,174,0,0,1,2.17722,0.113924,19.4557,63.9085,79,1,7.38324,-1.38324
Pakistan,211,222.621,7.38389,0.393365,235.517,7.54976,0.336493,Salman Butt,0,0,0,0,0,0,0,0,24,11,35,24,11,35,309,309,0,0,1,5.4359,0.384615,42.3846,78.8645,39,4,7.64923,3.35077
Sri Lanka,244,223.373,7.09016,0.344262,227.578,7.47541,0.385246,KC Sangakkara,0,0,0,0,0,0,0,0,4,9,13,4,9,13,0,308,6,0,1,4.33659,0.360976,41.9854,80.6276,205,4,7.29478,1.70522
Bangladesh,160,218.438,7.70625,0.4,211.106,7.05,0.325,Nazimuddin,0,0,0,0,0,0,0,0,4,17,21,4,17,21,0,115,2,0,1,2,0,14.5,62.2318,10,1,8.20551,8.79449
Sri Lanka,244,223.373,7.09016,0.344262,227.578,7.47541,0.385246,KC Sangakkara,0,0,0,0,0,0,0,0,16,7,23,16,7,23,0,273,0,0,1,4.33659,0.360976,41.9854,80.6276,205,4,7.29478,-0.294781
India,259,242.378,7.15058,0.339768,244.568,7.12741,0.30888,G Gambhir,0,0,0,0,0,0,0,0,24,10,34,24,10,34,274,173,2,0,1,3.99145,0.333333,37.4701,84.1944,117,4,7.66219,2.33781
Bangladesh,160,218.438,7.70625,0.4,211.106,7.05,0.325,Tamim Iqbal,0,0,0,0,0,0,0,0,12,6,18,12,6,18,255,74,1,0,1,4.05344,0.274809,31.8015,76.8068,131,4,7.48716,-1.48716
Bangladesh,160,218.438,7.70625,0.4,211.106,7.05,0.325,Junaid Siddique,0,0,0,0,0,0,0,0,0,8,8,0,8,8,0,117,5,0,1,2.16279,0.116279,20.0233,68.225,43,1,8.20551,-0.205513
Australia,228,239.627,7.69737,0.372807,232.079,7.23246,0.337719,SR Watson,0,0,0,0,0,0,0,0,8,10,18,8,10,18,118,118,6,1,1,4.71318,0.286822,37.7907,90.0943,129,4,9.62595,0.374055
Bangladesh,160,218.438,7.70625,0.4,211.106,7.05,0.325,Junaid Siddique,0,0,0,0,0,0,0,0,4,8,12,4,8,12,199,125,1,0,1,2.16279,0.116279,20.0233,68.225,43,1,7.67566,0.324341
India,259,242.378,7.15058,0.339768,244.568,7.12741,0.30888,SK Raina,0,0,0,0,0,0,0,0,0,8,8,0,8,8,0,146,1,0,1,3.11111,0.216374,28.9064,91.8944,171,0,8.38985,-0.389853
Sri Lanka,244,223.373,7.09016,0.344262,227.578,7.47541,0.385246,KC Sangakkara,0,0,0,0,0,0,0,0,8,9,17,8,9,17,147,147,1,1,1,4.33659,0.360976,41.9854,80.6276,205,4,8.94355,0.0564499
Sri Lanka,244,223.373,7.09016,0.344262,227.578,7.47541,0.385246,ST Jayasuriya,0,0,0,0,0,0,0,0,4,4,8,4,4,8,0,142,0,1,1,4.91549,0.211268,33.9859,98.4898,71,0,7.45349,-3.45349
India,259,242.378,7.15058,0.339768,244.568,7.12741,0.30888,IK Pathan,0,0,0,0,0,0,0,0,8,6,14,8,6,14,143,143,3,0,1,1.875,0.025,16.85,78.2811,40,1,8,-2
India,259,242.378,7.15058,0.339768,244.568,7.12741,0.30888,V Kohli,0,0,0,0,0,0,0,0,8,6,14,8,6,14,143,143,3,0,1,4.66456,0.379747,44.9937,88.3325,158,4,8,-2
India,259,242.378,7.15058,0.339768,244.568,7.12741,0.30888,V Kohli,0,0,0,0,0,0,0,0,8,11,19,8,11,19,0,237,6,0,1,4.66456,0.379747,44.9937,88.3325,158,4,8.02085,2.97915
Sri Lanka,244,223.373,7.09016,0.344262,227.578,7.47541,0.385246,ML Udawatte,0,0,0,0,0,0,0,0,4,3,7,4,3,7,0,227,0,1,1,2.33333,0,17.1667,62.0482,6,1,7.45349,-4.45349
Pakistan,211,222.621,7.38389,0.393365,235.517,7.54976,0.336493,Salman Butt,0,0,0,0,0,0,0,0,24,13,37,24,13,37,226,160,4,1,1,5.4359,0.384615,42.3846,78.8645,39,4,7.5893,5.4107
Pakistan,211,222.621,7.38389,0.393365,235.517,7.54976,0.336493,Salman Butt,0,0,0,0,0,0,0,0,4,10,14,4,10,14,0,308,1,1,1,5.4359,0.384615,42.3846,78.8645,39,4,7.1076,2.8924
Bangladesh,160,218.438,7.70625,0.4,211.106,7.05,0.325,Shahriar Nafees,0,0,0,0,0,0,0,0,8,5,13,8,5,13,309,285,4,0,1,3.40541,0.162162,24.4865,69.1076,37,4,6.99071,-1.99071
Bangladesh,160,218.438,7.70625,0.4,211.106,7.05,0.325,Tamim Iqbal,0,0,0,0,0,0,0,0,4,7,11,4,7,11,330,179,1,0,1,4.05344,0.274809,31.8015,76.8068,131,4,6.34044,0.659557
England,221,237.176,7.17647,0.289593,230.633,7.45701,0.384615,RS Bopara,0,0,0,0,0,0,0,0,12,7,19,12,7,19,261,256,4,1,1,2.22115,0.144231,25.1538,75.9361,104,4,7.36315,-0.363149
England,221,237.176,7.17647,0.289593,230.633,7.45701,0.384615,RS Bopara,0,0,0,0,0,0,0,0,8,6,14,8,6,14,250,210,1,1,1,2.22115,0.144231,25.1538,75.9361,104,4,7.53475,-1.53475
Australia,228,239.627,7.69737,0.372807,232.079,7.23246,0.337719,SR Watson,0,0,0,0,0,0,0,0,4,10,14,4,10,14,229,230,2,0,1,4.71318,0.286822,37.7907,90.0943,129,4,8.6162,1.3838
England,221,237.176,7.17647,0.289593,230.633,7.45701,0.384615,JL Denly,0,0,0,0,0,0,0,0,20,7,27,20,7,27,0,220,2,1,1,3.55556,0.222222,29.3333,63.1579,9,4,7.9139,-0.9139
Australia,228,239.627,7.69737,0.372807,232.079,7.23246,0.337719,TD Paine,0,0,0,0,0,0,0,0,12,7,19,12,7,19,221,221,1,0,1,3.3913,0.217391,27.6522,65.7704,23,4,8.33739,-1.33739
Australia,228,239.627,7.69737,0.372807,232.079,7.23246,0.337719,TD Paine,0,0,0,0,0,0,0,0,8,5,13,8,5,13,0,296,6,0,1,3.3913,0.217391,27.6522,65.7704,23,4,7.75388,-2.75388
Australia,228,239.627,7.69737,0.372807,232.079,7.23246,0.337719,RT Ponting,0,0,0,0,0,0,0,0,8,5,13,8,5,13,0,296,6,0,1,4.17431,0.33945,38.1009,80.8606,109,4,7.75388,-2.75388
Australia,228,239.627,7.69737,0.372807,232.079,7.23246,0.337719,RT Ponting,0,0,0,0,0,0,0,0,16,4,20,16,4,20,0,176,1,0,1,4.17431,0.33945,38.1009,80.8606,109,4,7.75388,-3.75388
England,221,237.176,7.17647,0.289593,230.633,7.45701,0.384615,AJ Strauss,0,0,0,0,0,0,0,0,4,9,13,4,9,13,177,177,11,1,1,3.93243,0.27027,33.9054,79.8028,74,4,8.34379,0.656213
England,221,237.176,7.17647,0.289593,230.633,7.45701,0.384615,JL Denly,0,0,0,0,0,0,0,0,4,9,13,4,9,13,177,177,11,1,1,3.55556,0.222222,29.3333,63.1579,9,4,8.34379,0.656213
South Africa,190,234.274,7.4,0.373684,232.363,7.33158,0.342105,GC Smith,0,0,0,0,0,0,0,0,12,8,20,12,8,20,287,145,2,1,1,3.97,0.29,33.57,79.6819,100,4,7.20715,0.792847
South Africa,190,234.274,7.4,0.373684,232.363,7.33158,0.342105,HH Gibbs,0,0,0,0,0,0,0,0,12,8,20,12,8,20,287,145,2,1,1,4.61538,0.307692,35.6923,83.4157,52,4,7.20715,0.792847
South Africa,190,234.274,7.4,0.373684,232.363,7.33158,0.342105,GC Smith,0,0,0,0,0,0,0,0,4,11,15,4,11,15,0,317,2,1,1,3.97,0.29,33.57,79.6819,100,4,7.50981,3.49019
South Africa,190,234.274,7.4,0.373684,232.363,7.33158,0.342105,HH Gibbs,0,0,0,0,0,0,0,0,4,11,15,4,11,15,0,317,2,1,1,4.61538,0.307692,35.6923,83.4157,52,4,7.50981,3.49019
Australia,228,239.627,7.69737,0.372807,232.079,7.23246,0.337719,BJ Haddin,0,0,0,0,0,0,0,0,16,12,28,16,12,28,318,256,2,0,1,3.14737,0.147368,26.7789,81.382,95,4,10.3407,1.65934
South Africa,190,234.274,7.4,0.373684,232.363,7.33158,0.342105,GC Smith,0,0,0,0,0,0,0,0,14,12,26,14,12,26,304,256,1,1,1,3.97,0.29,33.57,79.6819,100,4,7.85737,4.14263
Australia,228,239.627,7.69737,0.372807,232.079,7.23246,0.337719,DA Warner,0,0,0,0,0,0,0,0,12,5,17,12,5,17,0,249,4,1,1,4.20312,0.265625,35.2031,87.7336,64,4,8.22214,-3.22214
Australia,228,239.627,7.69737,0.372807,232.079,7.23246,0.337719,SE Marsh,0,0,0,0,0,0,0,0,24,5,29,24,5,29,0,222,3,1,1,3.66667,0.291667,35.5417,74.7918,48,4,8.22214,-3.22214
South Africa,190,234.274,7.4,0.373684,232.363,7.33158,0.342105,HM Amla,0,0,0,0,0,0,0,0,12,11,23,12,11,23,0,288,5,0,1,5.20168,0.403361,48.7899,86.9292,119,4,7.75548,3.24452
Australia,228,239.627,7.69737,0.372807,232.079,7.23246,0.337719,DA Warner,0,0,0,0,0,0,0,0,8,6,14,8,6,14,0,181,0,1,1,4.20312,0.265625,35.2031,87.7336,64,4,8.22214,-2.22214
New Zealand,184,233.745,7.39674,0.36413,227.951,7.30435,0.353261,PG Fulton,0,0,0,0,0,0,0,0,8,2,10,8,2,10,182,182,3,0,1,2.75,0.1875,27.4062,67.4615,32,4,7.65185,-5.65185
Australia,228,239.627,7.69737,0.372807,232.079,7.23246,0.337719,MJ Clarke,0,0,0,0,0,0,0,0,0,9,9,0,9,9,0,225,0,1,1,3.10294,0.301471,35.9265,74.0303,136,4,8.22214,0.777863
Australia,228,239.627,7.69737,0.372807,232.079,7.23246,0.337719,BJ Haddin,0,0,0,0,0,0,0,0,0,9,9,0,9,9,0,225,0,1,1,3.14737,0.147368,26.7789,81.382,95,4,8.22214,0.777863
New Zealand,184,233.745,7.39674,0.36413,227.951,7.30435,0.353261,PG Fulton,0,0,0,0,0,0,0,0,8,4,12,8,4,12,302,269,0,0,1,2.75,0.1875,27.4062,67.4615,32,4,6.6514,-2.6514
New Zealand,184,233.745,7.39674,0.36413,227.951,7.30435,0.353261,MJ Guptill,0,0,0,0,0,0,0,0,0,11,11,0,11,11,0,244,0,0,1,4.8087,0.313043,38.1217,82.7482,115,4,7.05619,3.94381
West Indies,176,217.33,7.15909,0.3125,225.278,7.57386,0.380682,CH Gayle,0,0,0,0,0,0,0,0,4,5,9,4,5,9,271,244,1,1,1,4.58621,0.206897,31.1293,89.4255,116,4,6.57981,-1.57981
West Indies,176,217.33,7.15909,0.3125,225.278,7.57386,0.380682,RR Sarwan,0,0,0,0,0,0,0,0,4,5,9,4,5,9,271,244,1,1,1,2.8254,0.222222,29.1429,69.1005,63,4,6.57981,-1.57981
West Indies,176,217.33,7.15909,0.3125,225.278,7.57386,0.380682,CH Gayle,0,0,0,0,0,0,0,0,16,7,23,16,7,23,0,264,1,1,1,4.58621,0.206897,31.1293,89.4255,116,4,6.4592,0.540805
West Indies,176,217.33,7.15909,0.3125,225.278,7.57386,0.380682,LMP Simmons,0,0,0,0,0,0,0,0,16,7,23,16,7,23,0,264,1,1,1,3.3125,0.28125,30.5938,71.4338,64,4,6.4592,0.540805
England,221,237.176,7.17647,0.289593,230.633,7.45701,0.384615,AJ Strauss,0,0,0,0,0,0,0,0,4,6,10,4,6,10,0,117,5,0,1,3.93243,0.27027,33.9054,79.8028,74,4,7.75548,-1.75548
West Indies,176,217.33,7.15909,0.3125,225.278,7.57386,0.380682,LMP Simmons,0,0,0,0,0,0,0,0,20,9,29,20,9,29,173,146,2,1,1,3.3125,0.28125,30.5938,71.4338,64,4,8.99015,0.00985241
England,221,237.176,7.17647,0.289593,230.633,7.45701,0.384615,KP Pietersen,0,0,0,0,0,0,0,0,8,9,17,8,9,17,388,229,0,0,1,3.69892,0.236559,33.4946,82.2117,93,4,9.15773,-0.157729
England,221,237.176,7.17647,0.289593,230.633,7.45701,0.384615,OA Shah,0,0,0,0,0,0,0,0,12,7,19,12,7,19,293,238,0,0,1,3.13043,0.23913,32.6739,81.1994,46,4,8.62341,-1.62341
England,221,237.176,7.17647,0.289593,230.633,7.45701,0.384615,IR Bell,0,0,0,0,0,0,0,0,12,2,14,12,2,14,0,240,0,0,1,3.63433,0.246269,35.3806,75.6623,134,4,7.75548,-5.75548
India,259,242.378,7.15058,0.339768,244.568,7.12741,0.30888,G Gambhir,0,0,0,0,0,0,0,0,20,5,25,20,5,25,241,198,1,1,1,3.99145,0.333333,37.4701,84.1944,117,4,7.71753,-2.71753
England,221,237.176,7.17647,0.289593,230.633,7.45701,0.384615,OA Shah,0,0,0,0,0,0,0,0,12,6,18,12,6,18,167,178,1,0,1,3.13043,0.23913,32.6739,81.1994,46,4,8.70495,-2.70495
India,259,242.378,7.15058,0.339768,244.568,7.12741,0.30888,V Kohli,0,0,0,0,0,0,0,0,4,15,19,4,15,19,0,258,2,0,1,4.66456,0.379747,44.9937,88.3325,158,4,8.02085,6.97915
India,259,242.378,7.15058,0.339768,244.568,7.12741,0.30888,SR Tendulkar,0,0,0,0,0,0,0,0,12,13,25,12,13,25,0,392,4,0,1,5.89773,0.363636,45.6023,84.5376,88,4,8.02085,4.97915
New Zealand,184,233.745,7.39674,0.36413,227.951,7.30435,0.353261,BB McCullum,0,0,0,0,0,0,0,0,28,6,34,28,6,34,393,334,0,1,1,3.98611,0.201389,29.9028,98.4004,144,0,7.50952,-1.50952
West Indies,176,217.33,7.15909,0.3125,225.278,7.57386,0.380682,XM Marshall,0,0,0,0,0,0,0,0,12,5,17,12,5,17,0,128,2,0,1,1.5,0,10.5,58.3333,8,3,6.42326,-1.42326
West Indies,176,217.33,7.15909,0.3125,225.278,7.57386,0.380682,CH Gayle,0,0,0,0,0,0,0,0,4,2,6,4,2,6,233,208,8,0,1,4.58621,0.206897,31.1293,89.4255,116,4,5.32509,-3.32509
Sri Lanka,244,223.373,7.09016,0.344262,227.578,7.47541,0.385246,WU Tharanga,0,0,0,0,0,0,0,0,6,11,17,6,11,17,128,130,2,0,1,3.93985,0.263158,32.9699,71.6035,133,4,8.82964,2.17036
Sri Lanka,244,223.373,7.09016,0.344262,227.578,7.47541,0.385246,ML Udawatte,0,0,0,0,0,0,0,0,4,6,10,4,6,10,68,68,3,0,1,2.33333,0,17.1667,62.0482,6,1,6.64231,-0.642305
Sri Lanka,244,223.373,7.09016,0.344262,227.578,7.47541,0.385246,ML Udawatte,0,0,0,0,0,0,0,0,4,9,13,4,9,13,0,171,5,0,1,2.33333,0,17.1667,62.0482,6,1,7.29478,1.70522
Sri Lanka,244,223.373,7.09016,0.344262,227.578,7.47541,0.385246,DPMD Jayawardene,0,0,0,0,0,0,0,0,4,2,6,4,2,6,0,152,2,0,1,3.20833,0.244792,31.6979,79.1109,192,4,7.29478,-5.29478
Zimbabwe,142,212.077,7.5,0.380282,227.704,6.97887,0.316901,V Sibanda,0,0,0,0,0,0,0,0,0,14,14,0,14,14,153,133,11,1,1,2.9697,0.181818,23.5152,63.5545,66,1,8.21367,5.78633
India,259,242.378,7.15058,0.339768,244.568,7.12741,0.30888,RG Sharma,0,0,0,0,0,0,0,0,4,7,11,4,7,11,0,188,2,0,1,3.82836,0.268657,35.9179,83.083,134,4,8.02085,-1.02085
India,259,242.378,7.15058,0.339768,244.568,7.12741,0.30888,G Gambhir,0,0,0,0,0,0,0,0,4,7,11,4,7,11,0,188,2,0,1,3.99145,0.333333,37.4701,84.1944,117,4,8.02085,-1.02085
West Indies,176,217.33,7.15909,0.3125,225.278,7.57386,0.380682,CH Gayle,0,0,0,0,0,0,0,0,28,9,37,28,9,37,0,186,0,1,1,4.58621,0.206897,31.1293,89.4255,116,4,6.4592,2.5408
Bangladesh,160,218.438,7.70625,0.4,211.106,7.05,0.325,Junaid Siddique,0,0,0,0,0,0,0,0,8,2,10,8,2,10,206,167,1,1,1,2.16279,0.116279,20.0233,68.225,43,1,7.43233,-5.43233
Bangladesh,160,218.438,7.70625,0.4,211.106,7.05,0.325,Tamim Iqbal,0,0,0,0,0,0,0,0,12,6,18,12,6,18,148,151,1,1,1,4.05344,0.274809,31.8015,76.8068,131,4,7.35155,-1.35155
Bangladesh,160,218.438,7.70625,0.4,211.106,7.05,0.325,Mushfiqur Rahim,0,0,0,0,0,0,0,0,12,6,18,12,6,18,148,151,1,1,1,2.61111,0.18254,27.7778,75.2526,126,4,7.35155,-1.35155
Bangladesh,160,218.438,7.70625,0.4,211.106,7.05,0.325,Mehrab Hossain jnr,0,0,0,0,0,0,0,0,4,4,8,4,4,8,120,121,10,1,1,1.7,0.1,18.3,42.4594,10,3,4.74087,-0.74087
West Indies,176,217.33,7.15909,0.3125,225.278,7.57386,0.380682,RS Morton,0,0,0,0,0,0,0,0,20,8,28,20,8,28,329,270,1,0,1,2.2963,0.222222,28.8889,67.0103,27,4,6.67613,1.32387
West Indies,176,217.33,7.15909,0.3125,225.278,7.57386,0.380682,RR Sarwan,0,0,0,0,0,0,0,0,20,8,28,20,8,28,329,270,1,0,1,2.8254,0.222222,29.1429,69.1005,63,4,6.67613,1.32387
Ireland,55,219.527,7.65455,0.290909,202.727,7.56364,0.4,NJ O'Brien,0,0,0,0,0,0,0,0,16,13,29,16,13,29,204,112,4,1,1,2.55882,0.176471,25.5882,69.378,34,4,7.15528,5.84472
Ireland,55,219.527,7.65455,0.290909,202.727,7.56364,0.4,PR Stirling,0,0,0,0,0,0,0,0,16,13,29,16,13,29,204,112,4,1,1,3.47826,0.173913,24.2174,88.1329,23,0,7.66942,5.33058
Ireland,55,219.527,7.65455,0.290909,202.727,7.56364,0.4,AC Botha,0,0,0,0,0,0,0,0,16,13,29,16,13,29,204,112,4,1,1,1.25,0.0833333,14.3333,53.75,12,3,7.15528,5.84472
Sri Lanka,244,223.373,7.09016,0.344262,227.578,7.47541,0.385246,TM Dilshan,0,0,0,0,0,0,0,0,16,12,28,16,12,28,0,219,2,0,1,4.60199,0.273632,38.3632,86.0219,201,4,7.29478,4.70522
Sri Lanka,244,223.373,7.09016,0.344262,227.578,7.47541,0.385246,ST Jayasuriya,0,0,0,0,0,0,0,0,16,12,28,16,12,28,0,219,2,0,1,4.91549,0.211268,33.9859,98.4898,71,0,7.46273,4.53727
Sri Lanka,244,223.373,7.09016,0.344262,227.578,7.47541,0.385246,TM Dilshan,0,0,0,0,0,0,0,0,32,3,35,32,3,35,0,290,4,0,1,4.60199,0.273632,38.3632,86.0219,201,4,7.29478,-4.29478
Pakistan,211,222.621,7.38389,0.393365,235.517,7.54976,0.336493,Khurram Manzoor,0,0,0,0,0,0,0,0,12,6,18,12,6,18,291,161,1,0,1,3.33333,0.5,33.6667,62.5387,6,4,7.51863,-1.51863
Pakistan,211,222.621,7.38389,0.393365,235.517,7.54976,0.336493,Salman Butt,0,0,0,0,0,0,0,0,12,6,18,12,6,18,291,161,1,0,1,5.4359,0.384615,42.3846,78.8645,39,4,7.51863,-1.51863
Pakistan,211,222.621,7.38389,0.393365,235.517,7.54976,0.336493,Shoaib Malik,0,0,0,0,0,0,0,0,12,6,18,12,6,18,291,161,1,0,1,2.77551,0.193878,28.7041,81.4418,98,4,7.51863,-1.51863
Pakistan,211,222.621,7.38389,0.393365,235.517,7.54976,0.336493,Kamran Akmal,0,0,0,0,0,0,0,0,4,6,10,4,6,10,310,75,1,1,1,3.01124,0.11236,23.0787,81.4433,89,4,6.52213,-0.522129
India,259,242.378,7.15058,0.339768,244.568,7.12741,0.30888,SR Tendulkar,0,0,0,0,0,0,0,0,4,14,18,4,14,18,247,247,1,0,1,5.89773,0.363636,45.6023,84.5376,88,4,9.99733,4.00267
Sri Lanka,244,223.373,7.09016,0.344262,227.578,7.47541,0.385246,ST Jayasuriya,0,0,0,0,0,0,0,0,12,13,25,12,13,25,364,216,3,1,1,4.91549,0.211268,33.9859,98.4898,71,0,12.5913,0.408657
Sri Lanka,244,223.373,7.09016,0.344262,227.578,7.47541,0.385246,KC Sangakkara,0,0,0,0,0,0,0,0,12,13,25,12,13,25,364,216,3,1,1,4.33659,0.360976,41.9854,80.6276,205,4,12.2242,0.775771
India,259,242.378,7.15058,0.339768,244.568,7.12741,0.30888,G Gambhir,0,0,0,0,0,0,0,0,12,8,20,12,8,20,321,252,2,0,1,3.99145,0.333333,37.4701,84.1944,117,4,9.74026,-1.74026
India,259,242.378,7.15058,0.339768,244.568,7.12741,0.30888,SK Raina,0,0,0,0,0,0,0,0,12,8,20,12,8,20,321,252,2,0,1,3.11111,0.216374,28.9064,91.8944,171,0,9.94487,-1.94487
England,221,237.176,7.17647,0.289593,230.633,7.45701,0.384615,IJL Trott,0,0,0,0,0,0,0,0,12,7,19,12,7,19,251,252,0,0,1,3.3871,0.403226,43.7903,75.2494,62,4,8.23847,-1.23847
England,221,237.176,7.17647,0.289593,230.633,7.45701,0.384615,AJ Strauss,0,0,0,0,0,0,0,0,30,10,40,30,10,40,355,242,1,0,1,3.93243,0.27027,33.9054,79.8028,74,4,8.991,1.009
South Africa,190,234.274,7.4,0.373684,232.363,7.33158,0.342105,HM Amla,0,0,0,0,0,0,0,0,12,6,18,12,6,18,0,119,2,1,1,5.20168,0.403361,48.7899,86.9292,119,4,7.50981,-1.50981
Pakistan,211,222.621,7.38389,0.393365,235.517,7.54976,0.336493,Kamran Akmal,0,0,0,0,0,0,0,0,8,3,11,8,3,11,169,171,0,0,1,3.01124,0.11236,23.0787,81.4433,89,4,7.41527,-4.41527
Pakistan,211,222.621,7.38389,0.393365,235.517,7.54976,0.336493,Salman Butt,0,0,0,0,0,0,0,0,8,4,12,8,4,12,0,207,1,0,1,5.4359,0.384615,42.3846,78.8645,39,4,7.17136,-3.17136
Australia,228,239.627,7.69737,0.372807,232.079,7.23246,0.337719,BJ Haddin,0,0,0,0,0,0,0,0,8,10,18,8,10,18,198,200,0,0,1,3.14737,0.147368,26.7789,81.382,95,4,8.33739,1.66261
Australia,228,239.627,7.69737,0.372807,232.079,7.23246,0.337719,MJ Clarke,0,0,0,0,0,0,0,0,8,10,18,8,10,18,198,200,0,0,1,3.10294,0.301471,35.9265,74.0303,136,4,8.33739,1.66261
Pakistan,211,222.621,7.38389,0.393365,235.517,7.54976,0.336493,Ahmed Shehzad,0,0,0,0,0,0,0,0,0,4,4,0,4,4,251,254,4,0,1,3.67143,0.242857,33.2714,70.8118,70,4,7.76923,-3.76923
West Indies,176,217.33,7.15909,0.3125,225.278,7.57386,0.380682,DS Smith,0,0,0,0,0,0,0,0,4,7,11,4,7,11,247,194,1,1,1,2.61765,0.147059,23.5588,71.2,34,4,6.80406,0.195942
Bangladesh,160,218.438,7.70625,0.4,211.106,7.05,0.325,Tamim Iqbal,0,0,0,0,0,0,0,0,8,12,20,8,12,20,275,276,0,0,1,4.05344,0.274809,31.8015,76.8068,131,4,7.30397,4.69603
West Indies,176,217.33,7.15909,0.3125,225.278,7.57386,0.380682,DS Smith,0,0,0,0,0,0,0,0,24,3,27,24,3,27,0,248,3,1,1,2.61765,0.147059,23.5588,71.2,34,4,6.4592,-3.4592
Bangladesh,160,218.438,7.70625,0.4,211.106,7.05,0.325,Junaid Siddique,0,0,0,0,0,0,0,0,28,6,34,28,6,34,249,249,0,0,1,2.16279,0.116279,20.0233,68.225,43,1,7.55638,-1.55638
Sri Lanka,244,223.373,7.09016,0.344262,227.578,7.47541,0.385246,WU Tharanga,0,0,0,0,0,0,0,0,4,8,12,4,8,12,0,232,3,1,1,3.93985,0.263158,32.9699,71.6035,133,4,7.45349,0.546508
Sri Lanka,244,223.373,7.09016,0.344262,227.578,7.47541,0.385246,ST Jayasuriya,0,0,0,0,0,0,0,0,4,8,12,4,8,12,0,232,3,1,1,4.91549,0.211268,33.9859,98.4898,71,0,7.45349,0.546508
Pakistan,211,222.621,7.38389,0.393365,235.517,7.54976,0.336493,Kamran Akmal,0,0,0,0,0,0,0,0,20,5,25,20,5,25,233,196,0,0,1,3.01124,0.11236,23.0787,81.4433,89,4,6.81386,-1.81386
Pakistan,211,222.621,7.38389,0.393365,235.517,7.54976,0.336493,Imran Nazir,0,0,0,0,0,0,0,0,8,9,17,8,9,17,0,321,3,0,1,4.66667,0.133333,29,96.0265,15,0,7.52279,1.47721
Sri Lanka,244,223.373,7.09016,0.344262,227.578,7.47541,0.385246,DPMD Jayawardene,0,0,0,0,0,0,0,0,22,8,30,22,8,30,322,175,0,1,1,3.20833,0.244792,31.6979,79.1109,192,4,10.4922,-2.49218
Sri Lanka,244,223.373,7.09016,0.344262,227.578,7.47541,0.385246,DPMD Jayawardene,0,0,0,0,0,0,0,0,16,7,23,16,7,23,280,147,3,1,1,3.20833,0.244792,31.6979,79.1109,192,4,8.0636,-1.0636
New Zealand,184,233.745,7.39674,0.36413,227.951,7.30435,0.353261,GD Elliott,0,0,0,0,0,0,0,0,0,7,7,0,7,7,217,119,0,0,1,2.67188,0.203125,29.4375,79.7629,64,4,7.47924,-0.479242
India,259,242.378,7.15058,0.339768,244.568,7.12741,0.30888,KD Karthik,0,0,0,0,0,0,0,0,16,9,25,16,9,25,308,168,5,0,1,2.46429,0.107143,21.6786,71.8769,56,1,8.76484,0.235161
New Zealand,184,233.745,7.39674,0.36413,227.951,7.30435,0.353261,LRPL Taylor,0,0,0,0,0,0,0,0,8,5,13,8,5,13,0,155,1,0,1,3.68382,0.301471,36.7206,79.3959,136,4,7.05619,-2.05619
India,259,242.378,7.15058,0.339768,244.568,7.12741,0.30888,SR Tendulkar,0,0,0,0,0,0,0,0,0,15,15,0,15,15,156,156,1,0,1,5.89773,0.363636,45.6023,84.5376,88,4,8.46067,6.53933
Pakistan,211,222.621,7.38389,0.393365,235.517,7.54976,0.336493,Salman Butt,0,0,0,0,0,0,0,0,16,8,24,16,8,24,0,274,3,0,1,5.4359,0.384615,42.3846,78.8645,39,4,7.17136,0.828635
Australia,228,239.627,7.69737,0.372807,232.079,7.23246,0.337719,SR Watson,0,0,0,0,0,0,0,0,4,12,16,4,12,16,275,275,6,1,1,4.71318,0.286822,37.7907,90.0943,129,4,9.4603,2.5397
Australia,228,239.627,7.69737,0.372807,232.079,7.23246,0.337719,SE Marsh,0,0,0,0,0,0,0,0,4,12,16,4,12,16,275,275,6,1,1,3.66667,0.291667,35.5417,74.7918,48,4,9.4603,2.5397
Australia,228,239.627,7.69737,0.372807,232.079,7.23246,0.337719,SE Marsh,0,0,0,0,0,0,0,0,8,12,20,8,12,20,213,213,1,1,1,3.66667,0.291667,35.5417,74.7918,48,4,8.83063,3.16937
Australia,228,239.627,7.69737,0.372807,232.079,7.23246,0.337719,BJ Haddin,0,0,0,0,0,0,0,0,8,12,20,8,12,20,213,213,1,1,1,3.14737,0.147368,26.7789,81.382,95,4,8.83063,3.16937
Zimbabwe,142,212.077,7.5,0.380282,227.704,6.97887,0.316901,H Masakadza,0,0,0,0,0,0,0,0,16,13,29,16,13,29,321,271,0,1,1,3.11215,0.186916,26.972,70.0485,107,4,6.16278,6.83722
Zimbabwe,142,212.077,7.5,0.380282,227.704,6.97887,0.316901,CK Coventry,0,0,0,0,0,0,0,0,16,13,29,16,13,29,321,271,0,1,1,3.33333,0.166667,29.3889,90.273,18,4,6.16278,6.83722
Zimbabwe,142,212.077,7.5,0.380282,227.704,6.97887,0.316901,MA Vermeulen,0,0,0,0,0,0,0,0,16,8,24,16,8,24,0,323,3,1,1,1.85714,0.142857,20.2857,68.2692,7,1,6.27492,1.72508
Bangladesh,160,218.438,7.70625,0.4,211.106,7.05,0.325,Tamim Iqbal,0,0,0,0,0,0,0,0,12,9,21,12,9,21,324,254,1,0,1,4.05344,0.274809,31.8015,76.8068,131,4,7.61688,1.38312
Zimbabwe,142,212.077,7.5,0.380282,227.704,6.97887,0.316901,V Sibanda,0,0,0,0,0,0,0,0,8,8,16,8,8,16,0,209,5,1,1,2.9697,0.181818,23.5152,63.5545,66,1,6.27492,1.72508
Zimbabwe,142,212.077,7.5,0.380282,227.704,6.97887,0.316901,CK Coventry,0,0,0,0,0,0,0,0,8,8,16,8,8,16,0,209,5,1,1,3.33333,0.166667,29.3889,90.273,18,4,6.39467,1.60533
Bangladesh,160,218.438,7.70625,0.4,211.106,7.05,0.325,Mushfiqur Rahim,0,0,0,0,0,0,0,0,4,5,9,4,5,9,210,212,6,0,1,2.61111,0.18254,27.7778,75.2526,126,4,7.05882,-2.05882
South Africa,190,234.274,7.4,0.373684,232.363,7.33158,0.342105,GC Smith,0,0,0,0,0,0,0,0,8,10,18,8,10,18,320,206,0,1,1,3.97,0.29,33.57,79.6819,100,4,7.01203,2.98797
South Africa,190,234.274,7.4,0.373684,232.363,7.33158,0.342105,JH Kallis,0,0,0,0,0,0,0,0,8,10,18,8,10,18,320,206,0,1,1,3.58621,0.356322,37.2644,76.4442,87,4,7.01203,2.98797
West Indies,176,217.33,7.15909,0.3125,225.278,7.57386,0.380682,TM Dowlin,0,0,0,0,0,0,0,0,4,9,13,4,9,13,0,133,1,0,1,2.1,0.2,22.7,62.7072,10,1,6.30204,2.69796
Pakistan,211,222.621,7.38389,0.393365,235.517,7.54976,0.336493,Shoaib Malik,0,0,0,0,0,0,0,0,14,6,20,14,6,20,134,134,1,0,1,2.77551,0.193878,28.7041,81.4418,98,4,6.9546,-0.9546
Sri Lanka,244,223.373,7.09016,0.344262,227.578,7.47541,0.385246,TM Dilshan,0,0,0,0,0,0,0,0,4,8,12,4,8,12,0,212,5,0,1,4.60199,0.273632,38.3632,86.0219,201,4,7.29478,0.705219
Sri Lanka,244,223.373,7.09016,0.344262,227.578,7.47541,0.385246,KC Sangakkara,0,0,0,0,0,0,0,0,4,8,12,4,8,12,0,212,5,0,1,4.33659,0.360976,41.9854,80.6276,205,4,7.29478,0.705219
Australia,228,239.627,7.69737,0.372807,232.079,7.23246,0.337719,SR Watson,0,0,0,0,0,0,0,0,0,13,13,0,13,13,0,275,5,0,1,4.71318,0.286822,37.7907,90.0943,129,4,7.75388,5.24612
India,259,242.378,7.15058,0.339768,244.568,7.12741,0.30888,SR Tendulkar,0,0,0,0,0,0,0,0,16,9,25,16,9,25,303,248,3,0,1,5.89773,0.363636,45.6023,84.5376,88,4,8.76484,0.235161
New Zealand,184,233.745,7.39674,0.36413,227.951,7.30435,0.353261,JD Ryder,0,0,0,0,0,0,0,0,12,10,22,12,10,22,0,315,4,0,1,4.88571,0.257143,34.4,97.2536,35,0,7.22414,2.77586
Sri Lanka,244,223.373,7.09016,0.344262,227.578,7.47541,0.385246,ST Jayasuriya,0,0,0,0,0,0,0,0,38,7,45,38,7,45,316,277,1,0,1,4.91549,0.211268,33.9859,98.4898,71,0,7.10719,-0.107194
England,221,237.176,7.17647,0.289593,230.633,7.45701,0.384615,AJ Strauss,0,0,0,0,0,0,0,0,20,5,25,20,5,25,0,323,2,0,1,3.93243,0.27027,33.9054,79.8028,74,4,7.75548,-2.75548
South Africa,190,234.274,7.4,0.373684,232.363,7.33158,0.342105,HH Gibbs,0,0,0,0,0,0,0,0,18,9,27,18,9,27,324,301,2,1,1,4.61538,0.307692,35.6923,83.4157,52,4,8.95112,0.0488758
England,221,237.176,7.17647,0.289593,230.633,7.45701,0.384615,PD Collingwood,0,0,0,0,0,0,0,0,4,7,11,4,7,11,0,146,2,0,1,2.62366,0.193548,30.5161,76.8065,93,4,7.75548,-0.755482
West Indies,176,217.33,7.15909,0.3125,225.278,7.57386,0.380682,ADS Fletcher,0,0,0,0,0,0,0,0,8,5,13,8,5,13,0,129,0,0,1,1.8125,0.125,13.5,62.6087,16,1,6.30204,-1.30204
Australia,228,239.627,7.69737,0.372807,232.079,7.23246,0.337719,SR Watson,0,0,0,0,0,0,0,0,16,3,19,16,3,19,0,292,3,0,1,4.71318,0.286822,37.7907,90.0943,129,4,7.75388,-4.75388
India,259,242.378,7.15058,0.339768,244.568,7.12741,0.30888,G Gambhir,0,0,0,0,0,0,0,0,20,3,23,20,3,23,293,288,6,1,1,3.99145,0.333333,37.4701,84.1944,117,4,7.88094,-4.88094
India,259,242.378,7.15058,0.339768,244.568,7.12741,0.30888,SR Tendulkar,0,0,0,0,0,0,0,0,24,4,28,24,4,28,0,354,4,1,1,5.89773,0.363636,45.6023,84.5376,88,4,7.08899,-3.08899
India,259,242.378,7.15058,0.339768,244.568,7.12741,0.30888,V Sehwag,0,0,0,0,0,0,0,0,32,6,38,32,6,38,251,226,2,1,1,5.88636,0.238636,38.8295,108.649,88,0,6.66118,-0.661176
India,259,242.378,7.15058,0.339768,244.568,7.12741,0.30888,SR Tendulkar,0,0,0,0,0,0,0,0,18,4,22,18,4,22,0,170,1,1,1,5.89773,0.363636,45.6023,84.5376,88,4,7.08899,-3.08899
Australia,228,239.627,7.69737,0.372807,232.079,7.23246,0.337719,RT Ponting,0,0,0,0,0,0,0,0,24,3,27,24,3,27,171,172,1,0,1,4.17431,0.33945,38.1009,80.8606,109,4,7.09718,-4.09718
Bangladesh,160,218.438,7.70625,0.4,211.106,7.05,0.325,Junaid Siddique,0,0,0,0,0,0,0,0,4,4,8,4,4,8,0,186,0,1,1,2.16279,0.116279,20.0233,68.225,43,1,4.97499,-0.974994
Bangladesh,160,218.438,7.70625,0.4,211.106,7.05,0.325,Mohammad Ashraful,0,0,0,0,0,0,0,0,4,4,8,4,4,8,0,186,0,1,1,2.17722,0.113924,19.4557,63.9085,79,1,4.97499,-0.974994
Zimbabwe,142,212.077,7.5,0.380282,227.704,6.97887,0.316901,MA Vermeulen,0,0,0,0,0,0,0,0,8,3,11,8,3,11,0,221,0,0,1,1.85714,0.142857,20.2857,68.2692,7,1,6.3628,-3.3628
New Zealand,184,233.745,7.39674,0.36413,227.951,7.30435,0.353261,PJ Ingram,0,0,0,0,0,0,0,0,0,5,5,0,5,5,0,336,1,1,1,4.28571,0.142857,27.5714,80.7531,7,4,7.05259,-2.05259
Bangladesh,160,218.438,7.70625,0.4,211.106,7.05,0.325,Tamim Iqbal,0,0,0,0,0,0,0,0,4,7,11,4,7,11,0,183,1,0,1,4.05344,0.274809,31.8015,76.8068,131,4,8.00813,-1.00813
New Zealand,184,233.745,7.39674,0.36413,227.951,7.30435,0.353261,BB McCullum,0,0,0,0,0,0,0,0,22,13,35,22,13,35,184,185,1,1,1,3.98611,0.201389,29.9028,98.4004,144,0,7.83024,5.16976
Bangladesh,160,218.438,7.70625,0.4,211.106,7.05,0.325,Tamim Iqbal,0,0,0,0,0,0,0,0,20,7,27,20,7,27,0,241,6,0,1,4.05344,0.274809,31.8015,76.8068,131,4,8.00813,-1.00813
New Zealand,184,233.745,7.39674,0.36413,227.951,7.30435,0.353261,BB McCullum,0,0,0,0,0,0,0,0,24,9,33,24,9,33,242,244,4,1,1,3.98611,0.201389,29.9028,98.4004,144,0,7.78067,1.21933
New Zealand,184,233.745,7.39674,0.36413,227.951,7.30435,0.353261,PJ Ingram,0,0,0,0,0,0,0,0,24,9,33,24,9,33,242,244,4,1,1,4.28571,0.142857,27.5714,80.7531,7,4,7.54359,1.45641
Australia,228,239.627,7.69737,0.372807,232.079,7.23246,0.337719,BJ Haddin,0,0,0,0,0,0,0,0,4,9,13,4,9,13,0,273,1,0,1,3.14737,0.147368,26.7789,81.382,95,4,7.75388,1.24612
Australia,228,239.627,7.69737,0.372807,232.079,7.23246,0.337719,BJ Haddin,0,0,0,0,0,0,0,0,16,6,22,16,6,22,239,202,2,0,1,3.14737,0.147368,26.7789,81.382,95,4,8.99032,-2.99032
New Zealand,184,233.745,7.39674,0.36413,227.951,7.30435,0.353261,LRPL Taylor,0,0,0,0,0,0,0,0,6,5,11,6,5,11,0,241,14,1,1,3.68382,0.301471,36.7206,79.3959,136,4,7.05259,-2.05259
Australia,228,239.627,7.69737,0.372807,232.079,7.23246,0.337719,SR Watson,0,0,0,0,0,0,0,0,6,10,16,6,10,16,0,231,4,0,1,4.71318,0.286822,37.7907,90.0943,129,4,7.75388,2.24612
England,221,237.176,7.17647,0.289593,230.633,7.45701,0.384615,AJ Strauss,0,0,0,0,0,0,0,0,16,5,21,16,5,21,268,268,2,1,1,3.93243,0.27027,33.9054,79.8028,74,4,7.71535,-2.71535
England,221,237.176,7.17647,0.289593,230.633,7.45701,0.384615,KP Pietersen,0,0,0,0,0,0,0,0,16,5,21,16,5,21,268,268,2,1,1,3.69892,0.236559,33.4946,82.2117,93,4,7.71535,-2.71535
England,221,237.176,7.17647,0.289593,230.633,7.45701,0.384615,AJ Strauss,0,0,0,0,0,0,0,0,12,6,18,12,6,18,291,212,3,1,1,3.93243,0.27027,33.9054,79.8028,74,4,7.69462,-1.69462
England,221,237.176,7.17647,0.289593,230.633,7.45701,0.384615,C Kieswetter,0,0,0,0,0,0,0,0,12,6,18,12,6,18,291,212,3,1,1,3.43243,0.135135,26.4324,88.0288,37,4,7.69462,-1.69462
Bangladesh,160,218.438,7.70625,0.4,211.106,7.05,0.325,Tamim Iqbal,0,0,0,0,0,0,0,0,20,14,34,20,14,34,0,250,3,0,1,4.05344,0.274809,31.8015,76.8068,131,4,8.00813,5.99187
England,221,237.176,7.17647,0.289593,230.633,7.45701,0.384615,C Kieswetter,0,0,0,0,0,0,0,0,16,7,23,16,7,23,251,251,3,1,1,3.43243,0.135135,26.4324,88.0288,37,4,8.07226,-1.07226
England,221,237.176,7.17647,0.289593,230.633,7.45701,0.384615,AJ Strauss,0,0,0,0,0,0,0,0,10,9,19,10,9,19,237,231,0,1,1,3.93243,0.27027,33.9054,79.8028,74,4,6.81813,2.18187
England,221,237.176,7.17647,0.289593,230.633,7.45701,0.384615,IJL Trott,0,0,0,0,0,0,0,0,18,9,27,18,9,27,0,347,0,1,1,3.3871,0.403226,43.7903,75.2494,62,4,7.9139,1.0861
Bangladesh,160,218.438,7.70625,0.4,211.106,7.05,0.325,Junaid Siddique,0,0,0,0,0,0,0,0,20,4,24,20,4,24,348,203,0,0,1,2.16279,0.116279,20.0233,68.225,43,1,5.55635,-1.55635
Bangladesh,160,218.438,7.70625,0.4,211.106,7.05,0.325,Imrul Kayes,0,0,0,0,0,0,0,0,4,7,11,4,7,11,0,260,3,1,1,3,0.207547,26.2642,63.6488,53,4,6.14827,0.851728
England,221,237.176,7.17647,0.289593,230.633,7.45701,0.384615,AN Cook,0,0,0,0,0,0,0,0,16,8,24,16,8,24,261,261,0,0,1,4.17045,0.272727,35.75,75.5524,88,4,7.13539,0.864614
England,221,237.176,7.17647,0.289593,230.633,7.45701,0.384615,C Kieswetter,0,0,0,0,0,0,0,0,16,8,24,16,8,24,261,261,0,0,1,3.43243,0.135135,26.4324,88.0288,37,4,7.13539,0.864614
England,221,237.176,7.17647,0.289593,230.633,7.45701,0.384615,KP Pietersen,0,0,0,0,0,0,0,0,16,8,24,16,8,24,261,261,0,0,1,3.69892,0.236559,33.4946,82.2117,93,4,7.13539,0.864614
Pakistan,211,222.621,7.38389,0.393365,235.517,7.54976,0.336493,Kamran Akmal,0,0,0,0,0,0,0,0,24,4,28,24,4,28,0,294,3,0,1,3.01124,0.11236,23.0787,81.4433,89,4,7.17136,-3.17136
Pakistan,211,222.621,7.38389,0.393365,235.517,7.54976,0.336493,Kamran Akmal,0,0,0,0,0,0,0,0,4,7,11,4,7,11,0,241,2,0,1,3.01124,0.11236,23.0787,81.4433,89,4,7.17136,-0.171365
Pakistan,211,222.621,7.38389,0.393365,235.517,7.54976,0.336493,Mohammad Yousuf,0,0,0,0,0,0,0,0,4,7,11,4,7,11,0,241,2,0,1,3.27586,0.275862,36.7931,73.9176,58,4,7.17136,-0.171365
England,221,237.176,7.17647,0.289593,230.633,7.45701,0.384615,AJ Strauss,0,0,0,0,0,0,0,0,20,8,28,20,8,28,242,218,0,1,1,3.93243,0.27027,33.9054,79.8028,74,4,8.12162,-0.121618
England,221,237.176,7.17647,0.289593,230.633,7.45701,0.384615,SM Davies,0,0,0,0,0,0,0,0,20,8,28,20,8,28,242,218,0,1,1,4.5,0.125,30.125,100.837,8,0,8.3587,-0.358704
Pakistan,211,222.621,7.38389,0.393365,235.517,7.54976,0.336493,Mohammad Hafeez,0,0,0,0,0,0,0,0,12,5,17,12,5,17,0,265,1,0,1,4.04511,0.255639,34.3534,78.0625,133,4,7.17136,-2.17136
England,221,237.176,7.17647,0.289593,230.633,7.45701,0.384615,AJ Strauss,0,0,0,0,0,0,0,0,28,6,34,28,6,34,266,227,2,1,1,3.93243,0.27027,33.9054,79.8028,74,4,7.71535,-1.71535
Pakistan,211,222.621,7.38389,0.393365,235.517,7.54976,0.336493,Younis Khan,0,0,0,0,0,0,0,0,4,9,13,4,9,13,0,287,2,0,1,2.64655,0.215517,28.5,73.2713,116,4,7.17136,1.82864
New Zealand,184,233.745,7.39674,0.36413,227.951,7.30435,0.353261,AJ Redmond,0,0,0,0,0,0,0,0,8,4,12,8,4,12,288,149,4,0,1,3.16667,0.166667,25.3333,57.1429,6,3,7.55801,-3.55801
New Zealand,184,233.745,7.39674,0.36413,227.951,7.30435,0.353261,BB McCullum,0,0,0,0,0,0,0,0,12,9,21,12,9,21,0,303,4,0,1,3.98611,0.201389,29.9028,98.4004,144,0,7.22414,1.77586
Pakistan,211,222.621,7.38389,0.393365,235.517,7.54976,0.336493,Khalid Latif,0,0,0,0,0,0,0,0,8,7,15,8,7,15,304,239,1,0,1,2.6,0.2,29.4,63.0901,5,4,7.64923,-0.649234
India,259,242.378,7.15058,0.339768,244.568,7.12741,0.30888,V Sehwag,0,0,0,0,0,0,0,0,16,3,19,16,3,19,0,414,0,1,1,5.88636,0.238636,38.8295,108.649,88,0,6.73412,-3.73412
Sri Lanka,244,223.373,7.09016,0.344262,227.578,7.47541,0.385246,TM Dilshan,0,0,0,0,0,0,0,0,20,9,29,20,9,29,302,302,2,0,1,4.60199,0.273632,38.3632,86.0219,201,4,4.47036,4.52964
India,259,242.378,7.15058,0.339768,244.568,7.12741,0.30888,SR Tendulkar,0,0,0,0,0,0,0,0,20,7,27,20,7,27,240,243,0,1,1,5.89773,0.363636,45.6023,84.5376,88,4,7.71753,-0.71753
India,259,242.378,7.15058,0.339768,244.568,7.12741,0.30888,SR Tendulkar,0,0,0,0,0,0,0,0,20,3,23,20,3,23,316,317,14,1,1,5.89773,0.363636,45.6023,84.5376,88,4,4.9484,-1.9484
India,259,242.378,7.15058,0.339768,244.568,7.12741,0.30888,V Sehwag,0,0,0,0,0,0,0,0,24,12,36,24,12,36,0,370,2,0,1,5.88636,0.238636,38.8295,108.649,88,0,8.38985,3.61015
Bangladesh,160,218.438,7.70625,0.4,211.106,7.05,0.325,Imrul Kayes,0,0,0,0,0,0,0,0,28,8,36,28,8,36,371,283,15,1,1,3,0.207547,26.2642,63.6488,53,4,6.05948,1.94052
Zimbabwe,142,212.077,7.5,0.380282,227.704,6.97887,0.316901,BRM Taylor,0,0,0,0,0,0,0,0,10,10,20,10,10,20,263,171,2,0,1,3.3,0.26,33.56,76.3421,100,4,7.42177,2.57823
South Africa,190,234.274,7.4,0.373684,232.363,7.33158,0.342105,GC Smith,0,0,0,0,0,0,0,0,8,11,19,8,11,19,223,223,1,0,1,3.97,0.29,33.57,79.6819,100,4,8.80751,2.19249
England,221,237.176,7.17647,0.289593,230.633,7.45701,0.384615,KP Pietersen,0,0,0,0,0,0,0,0,16,11,27,16,11,27,339,338,1,0,1,3.69892,0.236559,33.4946,82.2117,93,4,9.0616,1.9384
Ireland,55,219.527,7.65455,0.290909,202.727,7.56364,0.4,PR Stirling,0,0,0,0,0,0,0,0,18,4,22,18,4,22,328,329,4,0,1,3.47826,0.173913,24.2174,88.1329,23,0,6.27798,-2.27798
Bangladesh,160,218.438,7.70625,0.4,211.106,7.05,0.325,Tamim Iqbal,0,0,0,0,0,0,0,0,12,12,24,12,12,24,0,58,1,1,1,4.05344,0.274809,31.8015,76.8068,131,4,6.14827,5.85173
Zimbabwe,142,212.077,7.5,0.380282,227.704,6.97887,0.316901,T Taibu,0,0,0,0,0,0,0,0,8,7,15,8,7,15,0,162,2,0,1,2.36364,0.254545,29.4,71.0145,55,4,5.77377,1.22623
Ireland,55,219.527,7.65455,0.290909,202.727,7.56364,0.4,PR Stirling,0,0,0,0,0,0,0,0,8,1,9,8,1,9,0,207,2,0,1,3.47826,0.173913,24.2174,88.1329,23,0,5.02212,-4.02212
England,221,237.176,7.17647,0.289593,230.633,7.45701,0.384615,AJ Strauss,0,0,0,0,0,0,0,0,4,8,12,4,8,12,0,171,3,0,1,3.93243,0.27027,33.9054,79.8028,74,4,7.75548,0.244518
England,221,237.176,7.17647,0.289593,230.633,7.45701,0.384615,IJL Trott,0,0,0,0,0,0,0,0,4,8,12,4,8,12,0,171,3,0,1,3.3871,0.403226,43.7903,75.2494,62,4,7.75548,0.244518
England,221,237.176,7.17647,0.289593,230.633,7.45701,0.384615,IR Bell,0,0,0,0,0,0,0,0,4,8,12,4,8,12,0,171,3,0,1,3.63433,0.246269,35.3806,75.6623,134,4,7.75548,0.244518
Zimbabwe,142,212.077,7.5,0.380282,227.704,6.97887,0.316901,RW Chakabva,0,0,0,0,0,0,0,0,12,15,27,12,15,27,328,188,9,0,1,0.846154,0,13.2692,51.3393,26,3,6.50845,8.49155
West Indies,176,217.33,7.15909,0.3125,225.278,7.57386,0.380682,S Chanderpaul,0,0,0,0,0,0,0,0,8,3,11,8,3,11,0,275,0,0,1,3.57143,0.396825,40.8254,68.0783,63,4,5.87734,-2.87734
England,221,237.176,7.17647,0.289593,230.633,7.45701,0.384615,AJ Strauss,0,0,0,0,0,0,0,0,12,6,18,12,6,18,0,243,0,0,1,3.93243,0.27027,33.9054,79.8028,74,4,7.75548,-1.75548
England,221,237.176,7.17647,0.289593,230.633,7.45701,0.384615,MJ Prior,0,0,0,0,0,0,0,0,12,6,18,12,6,18,0,243,0,0,1,2.27083,0.0625,21.6875,76.4879,48,4,7.75548,-1.75548
Australia,228,239.627,7.69737,0.372807,232.079,7.23246,0.337719,SR Watson,0,0,0,0,0,0,0,0,4,7,11,4,7,11,0,176,1,0,1,4.71318,0.286822,37.7907,90.0943,129,4,7.75388,-0.753881
Bangladesh,160,218.438,7.70625,0.4,211.106,7.05,0.325,Junaid Siddique,0,0,0,0,0,0,0,0,8,1,9,8,1,9,285,78,5,1,1,2.16279,0.116279,20.0233,68.225,43,1,7.25975,-6.25975
India,259,242.378,7.15058,0.339768,244.568,7.12741,0.30888,G Gambhir,0,0,0,0,0,0,0,0,12,11,23,12,11,23,0,268,5,1,1,3.99145,0.333333,37.4701,84.1944,117,4,7.08899,3.91101
Pakistan,211,222.621,7.38389,0.393365,235.517,7.54976,0.336493,Mohammad Hafeez,0,0,0,0,0,0,0,0,24,14,38,24,14,38,113,113,5,0,1,4.04511,0.255639,34.3534,78.0625,133,4,7.43854,6.56146
Australia,228,239.627,7.69737,0.372807,232.079,7.23246,0.337719,BJ Haddin,0,0,0,0,0,0,0,0,12,6,18,12,6,18,0,260,1,0,1,3.14737,0.147368,26.7789,81.382,95,4,7.75388,-1.75388
New Zealand,184,233.745,7.39674,0.36413,227.951,7.30435,0.353261,MJ Guptill,0,0,0,0,0,0,0,0,16,4,20,16,4,20,0,217,0,0,1,4.8087,0.313043,38.1217,82.7482,115,4,7.05619,-3.05619
New Zealand,184,233.745,7.39674,0.36413,227.951,7.30435,0.353261,BB McCullum,0,0,0,0,0,0,0,0,16,4,20,16,4,20,0,217,0,0,1,3.98611,0.201389,29.9028,98.4004,144,0,7.22414,-3.22414
India,259,242.378,7.15058,0.339768,244.568,7.12741,0.30888,SR Tendulkar,0,0,0,0,0,0,0,0,12,14,26,12,14,26,275,277,1,1,1,5.89773,0.363636,45.6023,84.5376,88,4,7.48586,6.51414
Sri Lanka,244,223.373,7.09016,0.344262,227.578,7.47541,0.385246,WU Tharanga,0,0,0,0,0,0,0,0,24,5,29,24,5,29,261,261,10,0,1,3.93985,0.263158,32.9699,71.6035,133,4,7.28315,-2.28315
Bangladesh,160,218.438,7.70625,0.4,211.106,7.05,0.325,Imrul Kayes,0,0,0,0,0,0,0,0,18,9,27,18,9,27,0,296,1,1,1,3,0.207547,26.2642,63.6488,53,4,6.14827,2.85173
Sri Lanka,244,223.373,7.09016,0.344262,227.578,7.47541,0.385246,WU Tharanga,0,0,0,0,0,0,0,0,28,8,36,28,8,36,250,252,0,0,1,3.93985,0.263158,32.9699,71.6035,133,4,7.3484,0.651599
Sri Lanka,244,223.373,7.09016,0.344262,227.578,7.47541,0.385246,TM Dilshan,0,0,0,0,0,0,0,0,36,2,38,36,2,38,0,213,0,0,1,4.60199,0.273632,38.3632,86.0219,201,4,7.29478,-5.29478
India,259,242.378,7.15058,0.339768,244.568,7.12741,0.30888,KD Karthik,0,0,0,0,0,0,0,0,12,19,31,12,19,31,248,249,5,0,1,2.46429,0.107143,21.6786,71.8769,56,1,9.86203,9.13797
Sri Lanka,244,223.373,7.09016,0.344262,227.578,7.47541,0.385246,TM Dilshan,0,0,0,0,0,0,0,0,20,8,28,20,8,28,246,249,1,0,1,4.60199,0.273632,38.3632,86.0219,201,4,7.5282,0.471796
Zimbabwe,142,212.077,7.5,0.380282,227.704,6.97887,0.316901,V Sibanda,0,0,0,0,0,0,0,0,10,3,13,10,3,13,0,206,6,0,1,2.9697,0.181818,23.5152,63.5545,66,1,6.3628,-3.3628
West Indies,176,217.33,7.15909,0.3125,225.278,7.57386,0.380682,AB Barath,0,0,0,0,0,0,0,0,18,9,27,18,9,27,207,208,0,1,1,2.76923,0.0769231,21.6154,56.4257,13,3,5.81031,3.18969
West Indies,176,217.33,7.15909,0.3125,225.278,7.57386,0.380682,CH Gayle,0,0,0,0,0,0,0,0,0,11,11,0,11,11,0,245,0,1,1,4.58621,0.206897,31.1293,89.4255,116,4,6.4592,4.5408
Zimbabwe,142,212.077,7.5,0.380282,227.704,6.97887,0.316901,V Sibanda,0,0,0,0,0,0,0,0,12,6,18,12,6,18,246,104,1,0,1,2.9697,0.181818,23.5152,63.5545,66,1,6.7889,-0.788902
Zimbabwe,142,212.077,7.5,0.380282,227.704,6.97887,0.316901,BRM Taylor,0,0,0,0,0,0,0,0,12,6,18,12,6,18,246,104,1,0,1,3.3,0.26,33.56,76.3421,100,4,6.51185,-0.511854
West Indies,176,217.33,7.15909,0.3125,225.278,7.57386,0.380682,CH Gayle,0,0,0,0,0,0,0,0,12,7,19,12,7,19,301,283,0,1,1,4.58621,0.206897,31.1293,89.4255,116,4,7.11657,-0.11657
West Indies,176,217.33,7.15909,0.3125,225.278,7.57386,0.380682,DM Richards,0,0,0,0,0,0,0,0,8,11,19,8,11,19,225,157,4,1,1,3.42857,0.285714,25.5714,68.8462,7,4,4.77152,6.22848
West Indies,176,217.33,7.15909,0.3125,225.278,7.57386,0.380682,DM Richards,0,0,0,0,0,0,0,0,18,9,27,18,9,27,0,303,1,1,1,3.42857,0.285714,25.5714,68.8462,7,4,6.4592,2.5408
West Indies,176,217.33,7.15909,0.3125,225.278,7.57386,0.380682,S Chanderpaul,0,0,0,0,0,0,0,0,14,8,22,14,8,22,0,252,1,1,1,3.57143,0.396825,40.8254,68.0783,63,4,6.4592,1.5408
India,259,242.378,7.15058,0.339768,244.568,7.12741,0.30888,SR Tendulkar,0,0,0,0,0,0,0,0,18,5,23,18,5,23,0,298,3,1,1,5.89773,0.363636,45.6023,84.5376,88,4,7.08899,-2.08899
India,259,242.378,7.15058,0.339768,244.568,7.12741,0.30888,V Sehwag,0,0,0,0,0,0,0,0,20,11,31,20,11,31,0,401,0,1,1,5.88636,0.238636,38.8295,108.649,88,0,6.73412,4.26588
South Africa,190,234.274,7.4,0.373684,232.363,7.33158,0.342105,HH Gibbs,0,0,0,0,0,0,0,0,34,8,42,34,8,42,402,248,1,0,1,4.61538,0.307692,35.6923,83.4157,52,4,7.83173,0.168268
South Africa,190,234.274,7.4,0.373684,232.363,7.33158,0.342105,LE Bosman,0,0,0,0,0,0,0,0,12,9,21,12,9,21,0,365,1,0,1,4.18182,0.181818,27.1818,97.7124,11,0,8.09504,0.90496
Australia,228,239.627,7.69737,0.372807,232.079,7.23246,0.337719,RT Ponting,0,0,0,0,0,0,0,0,12,13,25,12,13,25,214,210,3,1,1,4.17431,0.33945,38.1009,80.8606,109,4,8.83063,4.16937
Sri Lanka,244,223.373,7.09016,0.344262,227.578,7.47541,0.385246,LPC Silva,0,0,0,0,0,0,0,0,8,5,13,8,5,13,0,115,6,0,1,2.55556,0.244444,26.0222,69.4543,45,4,7.29478,-2.29478
Australia,228,239.627,7.69737,0.372807,232.079,7.23246,0.337719,BJ Haddin,0,0,0,0,0,0,0,0,8,20,28,8,20,28,116,119,6,1,1,3.14737,0.147368,26.7789,81.382,95,4,9.62595,10.3741
England,221,237.176,7.17647,0.289593,230.633,7.45701,0.384615,SM Davies,0,0,0,0,0,0,0,0,12,14,26,12,14,26,0,294,3,0,1,4.5,0.125,30.125,100.837,8,0,8.09504,5.90496
Australia,228,239.627,7.69737,0.372807,232.079,7.23246,0.337719,BJ Haddin,0,0,0,0,0,0,0,0,20,12,32,20,12,32,295,297,0,1,1,3.14737,0.147368,26.7789,81.382,95,4,8.47193,3.52807
Australia,228,239.627,7.69737,0.372807,232.079,7.23246,0.337719,MJ Clarke,0,0,0,0,0,0,0,0,4,6,10,4,6,10,0,230,1,1,1,3.10294,0.301471,35.9265,74.0303,136,4,8.22214,-2.22214
England,221,237.176,7.17647,0.289593,230.633,7.45701,0.384615,IJL Trott,0,0,0,0,0,0,0,0,4,13,17,4,13,17,0,214,1,0,1,3.3871,0.403226,43.7903,75.2494,62,4,7.75548,5.24452
Australia,228,239.627,7.69737,0.372807,232.079,7.23246,0.337719,MJ Clarke,0,0,0,0,0,0,0,0,20,6,26,20,6,26,215,215,3,1,1,3.10294,0.301471,35.9265,74.0303,136,4,8.83063,-2.83063
England,221,237.176,7.17647,0.289593,230.633,7.45701,0.384615,MJ Prior,0,0,0,0,0,0,0,0,16,11,27,16,11,27,0,299,5,0,1,2.27083,0.0625,21.6875,76.4879,48,4,7.75548,3.24452
Australia,228,239.627,7.69737,0.372807,232.079,7.23246,0.337719,BJ Haddin,0,0,0,0,0,0,0,0,12,9,21,12,9,21,0,249,4,1,1,3.14737,0.147368,26.7789,81.382,95,4,8.22214,0.777863
England,221,237.176,7.17647,0.289593,230.633,7.45701,0.384615,AJ Strauss,0,0,0,0,0,0,0,0,8,13,21,8,13,21,0,333,1,0,1,3.93243,0.27027,33.9054,79.8028,74,4,7.75548,5.24452
England,221,237.176,7.17647,0.289593,230.633,7.45701,0.384615,MJ Prior,0,0,0,0,0,0,0,0,8,13,21,8,13,21,0,333,1,0,1,2.27083,0.0625,21.6875,76.4879,48,4,7.75548,5.24452
Australia,228,239.627,7.69737,0.372807,232.079,7.23246,0.337719,CJ Ferguson,0,0,0,0,0,0,0,0,4,10,14,4,10,14,0,279,4,1,1,2.47826,0.173913,26.3478,80.4781,23,4,8.22214,1.77786
England,221,237.176,7.17647,0.289593,230.633,7.45701,0.384615,KP Pietersen,0,0,0,0,0,0,0,0,8,11,19,8,11,19,280,222,10,0,1,3.69892,0.236559,33.4946,82.2117,93,4,7.91583,3.08417
India,259,242.378,7.15058,0.339768,244.568,7.12741,0.30888,KD Karthik,0,0,0,0,0,0,0,0,12,8,20,12,8,20,0,285,22,0,1,2.46429,0.107143,21.6786,71.8769,56,1,8.38985,-0.389853
Zimbabwe,142,212.077,7.5,0.380282,227.704,6.97887,0.316901,H Masakadza,0,0,0,0,0,0,0,0,12,12,24,12,12,24,286,289,0,1,1,3.11215,0.186916,26.972,70.0485,107,4,6.57981,5.42019
Sri Lanka,244,223.373,7.09016,0.344262,227.578,7.47541,0.385246,TT Samaraweera,0,0,0,0,0,0,0,0,0,10,10,0,10,10,0,242,0,0,1,2.19231,0.0769231,23.4231,73.8182,26,4,7.29478,2.70522
India,259,242.378,7.15058,0.339768,244.568,7.12741,0.30888,M Vijay,0,0,0,0,0,0,0,0,8,10,18,8,10,18,243,243,2,0,1,2.25,0.0625,21.1875,65.6977,16,1,8.99032,1.00968
Zimbabwe,142,212.077,7.5,0.380282,227.704,6.97887,0.316901,BRM Taylor,0,0,0,0,0,0,0,0,4,12,16,4,12,16,0,118,2,1,1,3.3,0.26,33.56,76.3421,100,4,6.39467,5.60533
Sri Lanka,244,223.373,7.09016,0.344262,227.578,7.47541,0.385246,WU Tharanga,0,0,0,0,0,0,0,0,24,8,32,24,8,32,119,119,5,0,1,3.93985,0.263158,32.9699,71.6035,133,4,7.44658,0.553419
India,259,242.378,7.15058,0.339768,244.568,7.12741,0.30888,KD Karthik,0,0,0,0,0,0,0,0,4,5,9,4,5,9,0,194,4,0,1,2.46429,0.107143,21.6786,71.8769,56,1,8.38985,-3.38985
India,259,242.378,7.15058,0.339768,244.568,7.12741,0.30888,M Vijay,0,0,0,0,0,0,0,0,4,5,9,4,5,9,0,194,4,0,1,2.25,0.0625,21.1875,65.6977,16,1,8.38985,-3.38985
India,259,242.378,7.15058,0.339768,244.568,7.12741,0.30888,G Gambhir,0,0,0,0,0,0,0,0,16,9,25,16,9,25,168,168,10,0,1,3.99145,0.333333,37.4701,84.1944,117,4,8.46067,0.539327
Sri Lanka,244,223.373,7.09016,0.344262,227.578,7.47541,0.385246,TM Dilshan,0,0,0,0,0,0,0,0,34,14,48,34,14,48,0,312,1,1,1,4.60199,0.273632,38.3632,86.0219,201,4,7.45349,6.54651
Bangladesh,160,218.438,7.70625,0.4,211.106,7.05,0.325,Tamim Iqbal,0,0,0,0,0,0,0,0,12,4,16,12,4,16,386,246,1,0,1,4.05344,0.274809,31.8015,76.8068,131,4,5.35654,-1.35654
India,259,242.378,7.15058,0.339768,244.568,7.12741,0.30888,G Gambhir,0,0,0,0,0,0,0,0,8,8,16,8,8,16,0,209,2,0,1,3.99145,0.333333,37.4701,84.1944,117,4,8.02085,-0.020853
New Zealand,184,233.745,7.39674,0.36413,227.951,7.30435,0.353261,PJ Ingram,0,0,0,0,0,0,0,0,16,10,26,16,10,26,0,288,1,0,1,4.28571,0.142857,27.5714,80.7531,7,4,7.05619,2.94381
Sri Lanka,244,223.373,7.09016,0.344262,227.578,7.47541,0.385246,TM Dilshan,0,0,0,0,0,0,0,0,8,10,18,8,10,18,0,170,2,1,1,4.60199,0.273632,38.3632,86.0219,201,4,7.45349,2.54651
Sri Lanka,244,223.373,7.09016,0.344262,227.578,7.47541,0.385246,KC Sangakkara,0,0,0,0,0,0,0,0,12,7,19,12,7,19,193,195,1,1,1,4.33659,0.360976,41.9854,80.6276,205,4,8.09874,-1.09874
India,259,242.378,7.15058,0.339768,244.568,7.12741,0.30888,V Kohli,0,0,0,0,0,0,0,0,16,9,25,16,9,25,0,223,2,0,1,4.66456,0.379747,44.9937,88.3325,158,4,8.02085,0.979147
India,259,242.378,7.15058,0.339768,244.568,7.12741,0.30888,V Sehwag,0,0,0,0,0,0,0,0,8,12,20,8,12,20,0,103,0,0,1,5.88636,0.238636,38.8295,108.649,88,0,8.38985,3.61015
Sri Lanka,244,223.373,7.09016,0.344262,227.578,7.47541,0.385246,TM Dilshan,0,0,0,0,0,0,0,0,28,6,34,28,6,34,104,104,2,1,1,4.60199,0.273632,38.3632,86.0219,201,4,7.6405,-1.6405
India,259,242.378,7.15058,0.339768,244.568,7.12741,0.30888,V Kohli,0,0,0,0,0,0,0,0,24,7,31,24,7,31,300,225,3,0,1,4.66456,0.379747,44.9937,88.3325,158,4,8.76484,-1.76484
South Africa,190,234.274,7.4,0.373684,232.363,7.33158,0.342105,CA Ingram,0,0,0,0,0,0,0,0,20,5,25,20,5,25,0,286,0,0,1,3,0.178571,27.1786,81.3904,28,4,7.75548,-2.75548
Pakistan,211,222.621,7.38389,0.393365,235.517,7.54976,0.336493,Mohammad Hafeez,0,0,0,0,0,0,0,0,0,9,9,0,9,9,229,226,2,0,1,4.04511,0.255639,34.3534,78.0625,133,4,6.69438,2.30562
South Africa,190,234.274,7.4,0.373684,232.363,7.33158,0.342105,GC Smith,0,0,0,0,0,0,0,0,12,11,23,12,11,23,0,274,1,0,1,3.97,0.29,33.57,79.6819,100,4,7.75548,3.24452
Pakistan,211,222.621,7.38389,0.393365,235.517,7.54976,0.336493,Mohammad Hafeez,0,0,0,0,0,0,0,0,4,26,30,4,26,30,275,275,2,0,1,4.04511,0.255639,34.3534,78.0625,133,4,8.37127,17.6287
Pakistan,211,222.621,7.38389,0.393365,235.517,7.54976,0.336493,Mohammad Hafeez,0,0,0,0,0,0,0,0,20,6,26,20,6,26,318,260,1,0,1,4.04511,0.255639,34.3534,78.0625,133,4,7.56181,-1.56181
South Africa,190,234.274,7.4,0.373684,232.363,7.33158,0.342105,HM Amla,0,0,0,0,0,0,0,0,32,8,40,32,8,40,0,351,3,1,1,5.20168,0.403361,48.7899,86.9292,119,4,7.50981,0.490188
South Africa,190,234.274,7.4,0.373684,232.363,7.33158,0.342105,GC Smith,0,0,0,0,0,0,0,0,32,8,40,32,8,40,0,351,3,1,1,3.97,0.29,33.57,79.6819,100,4,7.50981,0.490188
South Africa,190,234.274,7.4,0.373684,232.363,7.33158,0.342105,GC Smith,0,0,0,0,0,0,0,0,12,12,24,12,12,24,269,273,2,1,1,3.97,0.29,33.57,79.6819,100,4,7.90106,4.09894
Zimbabwe,142,212.077,7.5,0.380282,227.704,6.97887,0.316901,CJ Chibhabha,0,0,0,0,0,0,0,0,14,9,23,14,9,23,400,127,0,0,1,2.56716,0.149254,23.5373,64.7373,67,1,8.43407,0.565928
India,259,242.378,7.15058,0.339768,244.568,7.12741,0.30888,M Vijay,0,0,0,0,0,0,0,0,8,4,12,8,4,12,0,190,0,0,1,2.25,0.0625,21.1875,65.6977,16,1,8.38985,-4.38985
South Africa,190,234.274,7.4,0.373684,232.363,7.33158,0.342105,GC Smith,0,0,0,0,0,0,0,0,12,11,23,12,11,23,0,220,0,1,1,3.97,0.29,33.57,79.6819,100,4,7.50981,3.49019
South Africa,190,234.274,7.4,0.373684,232.363,7.33158,0.342105,HM Amla,0,0,0,0,0,0,0,0,12,11,23,12,11,23,0,220,0,1,1,5.20168,0.403361,48.7899,86.9292,119,4,7.50981,3.49019
India,259,242.378,7.15058,0.339768,244.568,7.12741,0.30888,RG Sharma,0,0,0,0,0,0,0,0,4,8,12,4,8,12,221,223,2,0,1,3.82836,0.268657,35.9179,83.083,134,4,8.33739,-0.337387
India,259,242.378,7.15058,0.339768,244.568,7.12741,0.30888,V Kohli,0,0,0,0,0,0,0,0,4,8,12,4,8,12,221,223,2,0,1,4.66456,0.379747,44.9937,88.3325,158,4,8.33739,-0.337387
South Africa,190,234.274,7.4,0.373684,232.363,7.33158,0.342105,HM Amla,0,0,0,0,0,0,0,0,4,5,9,4,5,9,0,265,1,1,1,5.20168,0.403361,48.7899,86.9292,119,4,7.50981,-2.50981
India,259,242.378,7.15058,0.339768,244.568,7.12741,0.30888,V Kohli,0,0,0,0,0,0,0,0,16,3,19,16,3,19,266,142,0,0,1,4.66456,0.379747,44.9937,88.3325,158,4,7.23394,-4.23394
South Africa,190,234.274,7.4,0.373684,232.363,7.33158,0.342105,HM Amla,0,0,0,0,0,0,0,0,20,7,27,20,7,27,0,250,5,1,1,5.20168,0.403361,48.7899,86.9292,119,4,7.50981,-0.509812
Australia,228,239.627,7.69737,0.372807,232.079,7.23246,0.337719,SE Marsh,0,0,0,0,0,0,0,0,4,3,7,4,3,7,0,289,5,0,1,3.66667,0.291667,35.5417,74.7918,48,4,7.75388,-4.75388
West Indies,176,217.33,7.15909,0.3125,225.278,7.57386,0.380682,CH Gayle,0,0,0,0,0,0,0,0,12,5,17,12,5,17,278,251,0,0,1,4.58621,0.206897,31.1293,89.4255,116,4,6.96728,-1.96728
India,259,242.378,7.15058,0.339768,244.568,7.12741,0.30888,G Gambhir,0,0,0,0,0,0,0,0,8,10,18,8,10,18,259,259,0,1,1,3.99145,0.333333,37.4701,84.1944,117,4,7.05762,2.94238
India,259,242.378,7.15058,0.339768,244.568,7.12741,0.30888,PA Patel,0,0,0,0,0,0,0,0,12,5,17,12,5,17,316,321,1,1,1,2.65217,0.130435,22.1304,79.4072,23,4,4.9484,0.0516009
New Zealand,184,233.745,7.39674,0.36413,227.951,7.30435,0.353261,MJ Guptill,0,0,0,0,0,0,0,0,18,18,36,18,18,36,125,125,3,1,1,4.8087,0.313043,38.1217,82.7482,115,4,7.96071,10.0393
New Zealand,184,233.745,7.39674,0.36413,227.951,7.30435,0.353261,JD Ryder,0,0,0,0,0,0,0,0,18,18,36,18,18,36,125,125,3,1,1,4.88571,0.257143,34.4,97.2536,35,0,7.83024,10.1698
Pakistan,211,222.621,7.38389,0.393365,235.517,7.54976,0.336493,Ahmed Shehzad,0,0,0,0,0,0,0,0,4,9,13,4,9,13,0,293,0,0,1,3.67143,0.242857,33.2714,70.8118,70,4,7.17136,1.82864
Pakistan,211,222.621,7.38389,0.393365,235.517,7.54976,0.336493,Kamran Akmal,0,0,0,0,0,0,0,0,4,9,13,4,9,13,0,293,0,0,1,3.01124,0.11236,23.0787,81.4433,89,4,7.17136,1.82864
Pakistan,211,222.621,7.38389,0.393365,235.517,7.54976,0.336493,Younis Khan,0,0,0,0,0,0,0,0,4,9,13,4,9,13,0,293,0,0,1,2.64655,0.215517,28.5,73.2713,116,4,7.17136,1.82864
New Zealand,184,233.745,7.39674,0.36413,227.951,7.30435,0.353261,MJ Guptill,0,0,0,0,0,0,0,0,20,6,26,20,6,26,294,250,0,1,1,4.8087,0.313043,38.1217,82.7482,115,4,7.55801,-1.55801
New Zealand,184,233.745,7.39674,0.36413,227.951,7.30435,0.353261,JM How,0,0,0,0,0,0,0,0,16,4,20,16,4,20,0,262,5,1,1,3.34615,0.192308,29.9231,64.9416,26,4,7.05259,-3.05259
Pakistan,211,222.621,7.38389,0.393365,235.517,7.54976,0.336493,Mohammad Hafeez,0,0,0,0,0,0,0,0,8,3,11,8,3,11,0,268,0,0,1,4.04511,0.255639,34.3534,78.0625,133,4,7.17136,-4.17136
New Zealand,184,233.745,7.39674,0.36413,227.951,7.30435,0.353261,MJ Guptill,0,0,0,0,0,0,0,0,8,6,14,8,6,14,269,227,5,1,1,4.8087,0.313043,38.1217,82.7482,115,4,7.55801,-1.55801
Pakistan,211,222.621,7.38389,0.393365,235.517,7.54976,0.336493,Ahmed Shehzad,0,0,0,0,0,0,0,0,18,9,27,18,9,27,312,254,1,0,1,3.67143,0.242857,33.2714,70.8118,70,4,7.20689,1.79311
England,221,237.176,7.17647,0.289593,230.633,7.45701,0.384615,C Kieswetter,0,0,0,0,0,0,0,0,16,10,26,16,10,26,0,229,3,1,1,3.43243,0.135135,26.4324,88.0288,37,4,7.9139,2.0861
Sri Lanka,244,223.373,7.09016,0.344262,227.578,7.47541,0.385246,DPMD Jayawardene,0,0,0,0,0,0,0,0,20,9,29,20,9,29,247,249,1,0,1,3.20833,0.244792,31.6979,79.1109,192,4,8.11752,0.882484
Sri Lanka,244,223.373,7.09016,0.344262,227.578,7.47541,0.385246,KC Sangakkara,0,0,0,0,0,0,0,0,8,14,22,8,14,22,269,252,0,0,1,4.33659,0.360976,41.9854,80.6276,205,4,8.0636,5.9364
India,259,242.378,7.15058,0.339768,244.568,7.12741,0.30888,AM Rahane,0,0,0,0,0,0,0,0,0,5,5,0,5,5,0,234,4,0,1,3.55738,0.262295,32.2295,78.0159,61,4,8.02085,-3.02085
India,259,242.378,7.15058,0.339768,244.568,7.12741,0.30888,AM Rahane,0,0,0,0,0,0,0,0,0,12,12,0,12,12,0,304,7,0,1,3.55738,0.262295,32.2295,78.0159,61,4,8.02085,3.97915
England,221,237.176,7.17647,0.289593,230.633,7.45701,0.384615,C Kieswetter,0,0,0,0,0,0,0,0,20,9,29,20,9,29,305,241,0,1,1,3.43243,0.135135,26.4324,88.0288,37,4,7.69462,1.30538
Bangladesh,160,218.438,7.70625,0.4,211.106,7.05,0.325,Shahriar Nafees,0,0,0,0,0,0,0,0,16,3,19,16,3,19,0,228,0,1,1,3.40541,0.162162,24.4865,69.1076,37,4,6.14827,-3.14827
New Zealand,184,233.745,7.39674,0.36413,227.951,7.30435,0.353261,JD Ryder,0,0,0,0,0,0,0,0,24,15,39,24,15,39,229,200,0,0,1,4.88571,0.257143,34.4,97.2536,35,0,7.99514,7.00486
Bangladesh,160,218.438,7.70625,0.4,211.106,7.05,0.325,Shahriar Nafees,0,0,0,0,0,0,0,0,20,14,34,20,14,34,174,177,1,1,1,3.40541,0.162162,24.4865,69.1076,37,4,8.99556,5.00444
Bangladesh,160,218.438,7.70625,0.4,211.106,7.05,0.325,Imrul Kayes,0,0,0,0,0,0,0,0,16,9,25,16,9,25,0,241,2,1,1,3,0.207547,26.2642,63.6488,53,4,6.14827,2.85173
Bangladesh,160,218.438,7.70625,0.4,211.106,7.05,0.325,Junaid Siddique,0,0,0,0,0,0,0,0,16,9,25,16,9,25,0,241,2,1,1,2.16279,0.116279,20.0233,68.225,43,1,4.97499,4.02501
New Zealand,184,233.745,7.39674,0.36413,227.951,7.30435,0.353261,KS Williamson,0,0,0,0,0,0,0,0,0,11,11,0,11,11,175,171,4,0,1,4.31707,0.390244,43.0488,82.8833,82,4,7.65185,3.34815
Zimbabwe,142,212.077,7.5,0.380282,227.704,6.97887,0.316901,CJ Chibhabha,0,0,0,0,0,0,0,0,16,6,22,16,6,22,0,209,6,0,1,2.56716,0.149254,23.5373,64.7373,67,1,6.3628,-0.362797
Bangladesh,160,218.438,7.70625,0.4,211.106,7.05,0.325,Tamim Iqbal,0,0,0,0,0,0,0,0,8,3,11,8,3,11,0,246,4,1,1,4.05344,0.274809,31.8015,76.8068,131,4,6.14827,-3.14827
Pakistan,211,222.621,7.38389,0.393365,235.517,7.54976,0.336493,Mohammad Hafeez,0,0,0,0,0,0,0,0,28,7,35,28,7,35,222,222,0,0,1,4.04511,0.255639,34.3534,78.0625,133,4,7.29199,-0.291987
West Indies,176,217.33,7.15909,0.3125,225.278,7.57386,0.380682,LMP Simmons,0,0,0,0,0,0,0,0,10,9,19,10,9,19,0,220,4,1,1,3.3125,0.28125,30.5938,71.4338,64,4,6.4592,2.5408
Pakistan,211,222.621,7.38389,0.393365,235.517,7.54976,0.336493,Ahmed Shehzad,0,0,0,0,0,0,0,0,8,6,14,8,6,14,172,177,5,0,1,3.67143,0.242857,33.2714,70.8118,70,4,7.46459,-1.46459
Pakistan,211,222.621,7.38389,0.393365,235.517,7.54976,0.336493,Asad Shafiq,0,0,0,0,0,0,0,0,8,8,16,8,8,16,0,248,0,0,1,2.07843,0.176471,24.7843,67.1269,51,4,7.17136,0.828635
Pakistan,211,222.621,7.38389,0.393365,235.517,7.54976,0.336493,Mohammad Hafeez,0,0,0,0,0,0,0,0,8,9,17,8,9,17,0,139,1,0,1,4.04511,0.255639,34.3534,78.0625,133,4,7.17136,1.82864
West Indies,176,217.33,7.15909,0.3125,225.278,7.57386,0.380682,LMP Simmons,0,0,0,0,0,0,0,0,8,5,13,8,5,13,0,214,8,1,1,3.3125,0.28125,30.5938,71.4338,64,4,6.4592,-1.4592
India,259,242.378,7.15058,0.339768,244.568,7.12741,0.30888,PA Patel,0,0,0,0,0,0,0,0,4,11,15,4,11,15,0,251,2,0,1,2.65217,0.130435,22.1304,79.4072,23,4,8.02085,2.97915
West Indies,176,217.33,7.15909,0.3125,225.278,7.57386,0.380682,RR Sarwan,0,0,0,0,0,0,0,0,0,9,9,0,9,9,252,255,3,1,1,2.8254,0.222222,29.1429,69.1005,63,4,6.763,2.237
Australia,228,239.627,7.69737,0.372807,232.079,7.23246,0.337719,BJ Haddin,0,0,0,0,0,0,0,0,12,12,24,12,12,24,0,270,0,0,1,3.14737,0.147368,26.7789,81.382,95,4,7.75388,4.24612
Australia,228,239.627,7.69737,0.372807,232.079,7.23246,0.337719,RT Ponting,0,0,0,0,0,0,0,0,12,12,24,12,12,24,0,270,0,0,1,4.17431,0.33945,38.1009,80.8606,109,4,7.75388,4.24612
Bangladesh,160,218.438,7.70625,0.4,211.106,7.05,0.325,Raqibul Hasan,0,0,0,0,0,0,0,0,8,6,14,8,6,14,271,210,1,1,1,1.85106,0.12766,23.2766,59.2312,47,1,7.25975,-1.25975
Australia,228,239.627,7.69737,0.372807,232.079,7.23246,0.337719,BJ Haddin,0,0,0,0,0,0,0,0,26,7,33,26,7,33,230,232,1,0,1,3.14737,0.147368,26.7789,81.382,95,4,8.6162,-1.6162
Bangladesh,160,218.438,7.70625,0.4,211.106,7.05,0.325,Tamim Iqbal,0,0,0,0,0,0,0,0,38,4,42,38,4,42,362,295,1,1,1,4.05344,0.274809,31.8015,76.8068,131,4,5.62472,-1.62472
Australia,228,239.627,7.69737,0.372807,232.079,7.23246,0.337719,RT Ponting,0,0,0,0,0,0,0,0,32,4,36,32,4,36,0,183,1,0,1,4.17431,0.33945,38.1009,80.8606,109,4,7.75388,-3.75388
South Africa,190,234.274,7.4,0.373684,232.363,7.33158,0.342105,JH Kallis,0,0,0,0,0,0,0,0,14,6,20,14,6,20,184,129,1,1,1,3.58621,0.356322,37.2644,76.4442,87,4,7.9397,-1.9397
South Africa,190,234.274,7.4,0.373684,232.363,7.33158,0.342105,HM Amla,0,0,0,0,0,0,0,0,22,7,29,22,7,29,0,303,2,1,1,5.20168,0.403361,48.7899,86.9292,119,4,7.50981,-0.509812
South Africa,190,234.274,7.4,0.373684,232.363,7.33158,0.342105,JH Kallis,0,0,0,0,0,0,0,0,22,7,29,22,7,29,0,303,2,1,1,3.58621,0.356322,37.2644,76.4442,87,4,7.50981,-0.509812
Australia,228,239.627,7.69737,0.372807,232.079,7.23246,0.337719,DA Warner,0,0,0,0,0,0,0,0,16,9,25,16,9,25,223,227,2,0,1,4.20312,0.265625,35.2031,87.7336,64,4,8.33739,0.662613
South Africa,190,234.274,7.4,0.373684,232.363,7.33158,0.342105,GC Smith,0,0,0,0,0,0,0,0,0,16,16,0,16,16,0,301,2,1,1,3.97,0.29,33.57,79.6819,100,4,7.50981,8.49019
South Africa,190,234.274,7.4,0.373684,232.363,7.33158,0.342105,HM Amla,0,0,0,0,0,0,0,0,10,10,20,10,10,20,237,237,1,1,1,5.20168,0.403361,48.7899,86.9292,119,4,7.15134,2.84866
South Africa,190,234.274,7.4,0.373684,232.363,7.33158,0.342105,CA Ingram,0,0,0,0,0,0,0,0,4,9,13,4,9,13,267,179,1,1,1,3,0.178571,27.1786,81.3904,28,4,7.47282,1.52718
Sri Lanka,244,223.373,7.09016,0.344262,227.578,7.47541,0.385246,TM Dilshan,0,0,0,0,0,0,0,0,22,8,30,22,8,30,300,304,1,0,1,4.60199,0.273632,38.3632,86.0219,201,4,8.0636,-0.0635996
Australia,228,239.627,7.69737,0.372807,232.079,7.23246,0.337719,SR Watson,0,0,0,0,0,0,0,0,20,11,31,20,11,31,192,192,0,0,1,4.71318,0.286822,37.7907,90.0943,129,4,8.33739,2.66261
Sri Lanka,244,223.373,7.09016,0.344262,227.578,7.47541,0.385246,TM Dilshan,0,0,0,0,0,0,0,0,20,7,27,20,7,27,0,208,1,1,1,4.60199,0.273632,38.3632,86.0219,201,4,7.45349,-0.453492
Australia,228,239.627,7.69737,0.372807,232.079,7.23246,0.337719,SR Watson,0,0,0,0,0,0,0,0,12,6,18,12,6,18,209,211,3,0,1,4.71318,0.286822,37.7907,90.0943,129,4,8.33739,-2.33739
Australia,228,239.627,7.69737,0.372807,232.079,7.23246,0.337719,SR Watson,0,0,0,0,0,0,0,0,8,3,11,8,3,11,287,208,4,0,1,4.71318,0.286822,37.7907,90.0943,129,4,7.38348,-4.38348
Australia,228,239.627,7.69737,0.372807,232.079,7.23246,0.337719,BJ Haddin,0,0,0,0,0,0,0,0,8,3,11,8,3,11,287,208,4,0,1,3.14737,0.147368,26.7789,81.382,95,4,7.38348,-4.38348
Sri Lanka,244,223.373,7.09016,0.344262,227.578,7.47541,0.385246,WU Tharanga,0,0,0,0,0,0,0,0,12,7,19,12,7,19,0,132,0,1,1,3.93985,0.263158,32.9699,71.6035,133,4,7.45349,-0.453492
Australia,228,239.627,7.69737,0.372807,232.079,7.23246,0.337719,SR Watson,0,0,0,0,0,0,0,0,16,3,19,16,3,19,133,133,0,0,1,4.71318,0.286822,37.7907,90.0943,129,4,8,-5
Australia,228,239.627,7.69737,0.372807,232.079,7.23246,0.337719,SE Marsh,0,0,0,0,0,0,0,0,12,5,17,12,5,17,0,211,6,0,1,3.66667,0.291667,35.5417,74.7918,48,4,7.75388,-2.75388
Australia,228,239.627,7.69737,0.372807,232.079,7.23246,0.337719,DA Warner,0,0,0,0,0,0,0,0,4,10,14,4,10,14,0,216,1,1,1,4.20312,0.265625,35.2031,87.7336,64,4,8.22214,1.77786
India,259,242.378,7.15058,0.339768,244.568,7.12741,0.30888,V Kohli,0,0,0,0,0,0,0,0,0,13,13,0,13,13,217,151,5,0,1,4.66456,0.379747,44.9937,88.3325,158,4,8.33739,4.66261
Sri Lanka,244,223.373,7.09016,0.344262,227.578,7.47541,0.385246,WU Tharanga,0,0,0,0,0,0,0,0,12,8,20,12,8,20,0,233,0,0,1,3.93985,0.263158,32.9699,71.6035,133,4,7.29478,0.705219
India,259,242.378,7.15058,0.339768,244.568,7.12741,0.30888,V Sehwag,0,0,0,0,0,0,0,0,20,7,27,20,7,27,234,234,1,0,1,5.88636,0.238636,38.8295,108.649,88,0,8.58456,-1.58456
Australia,228,239.627,7.69737,0.372807,232.079,7.23246,0.337719,DA Warner,0,0,0,0,0,0,0,0,16,9,25,16,9,25,0,231,2,1,1,4.20312,0.265625,35.2031,87.7336,64,4,8.22214,0.777863
Australia,228,239.627,7.69737,0.372807,232.079,7.23246,0.337719,MS Wade,0,0,0,0,0,0,0,0,16,9,25,16,9,25,0,231,2,1,1,1.86275,0.117647,20.3333,78.2642,51,1,8.42701,0.57299
Sri Lanka,244,223.373,7.09016,0.344262,227.578,7.47541,0.385246,KC Sangakkara,0,0,0,0,0,0,0,0,12,4,16,12,4,16,232,226,0,0,1,4.33659,0.360976,41.9854,80.6276,205,4,8.55154,-4.55154
Sri Lanka,244,223.373,7.09016,0.344262,227.578,7.47541,0.385246,TM Dilshan,0,0,0,0,0,0,0,0,8,7,15,8,7,15,0,236,2,0,1,4.60199,0.273632,38.3632,86.0219,201,4,7.29478,-0.294781
India,259,242.378,7.15058,0.339768,244.568,7.12741,0.30888,G Gambhir,0,0,0,0,0,0,0,0,4,9,13,4,9,13,289,178,2,0,1,3.99145,0.333333,37.4701,84.1944,117,4,8.05726,0.942738
Sri Lanka,244,223.373,7.09016,0.344262,227.578,7.47541,0.385246,DPMD Jayawardene,0,0,0,0,0,0,0,0,8,13,21,8,13,21,0,289,1,0,1,3.20833,0.244792,31.6979,79.1109,192,4,7.29478,5.70522
Australia,228,239.627,7.69737,0.372807,232.079,7.23246,0.337719,PJ Forrest,0,0,0,0,0,0,0,0,4,5,9,4,5,9,0,252,1,1,1,2.71429,0.285714,26.2143,63.6049,14,4,8.22214,-3.22214
Sri Lanka,244,223.373,7.09016,0.344262,227.578,7.47541,0.385246,DPMD Jayawardene,0,0,0,0,0,0,0,0,12,4,16,12,4,16,0,238,1,0,1,3.20833,0.244792,31.6979,79.1109,192,4,7.29478,-3.29478
Australia,228,239.627,7.69737,0.372807,232.079,7.23246,0.337719,PJ Forrest,0,0,0,0,0,0,0,0,12,12,24,12,12,24,239,229,2,1,1,2.71429,0.285714,26.2143,63.6049,14,4,8.78106,3.21894
Sri Lanka,244,223.373,7.09016,0.344262,227.578,7.47541,0.385246,DPMD Jayawardene,0,0,0,0,0,0,0,0,24,11,35,24,11,35,322,306,4,0,1,3.20833,0.244792,31.6979,79.1109,192,4,10.4922,0.50782
Australia,228,239.627,7.69737,0.372807,232.079,7.23246,0.337719,MS Wade,0,0,0,0,0,0,0,0,8,11,19,8,11,19,0,271,4,1,1,1.86275,0.117647,20.3333,78.2642,51,1,8.42701,2.57299
Australia,228,239.627,7.69737,0.372807,232.079,7.23246,0.337719,DA Warner,0,0,0,0,0,0,0,0,8,11,19,8,11,19,0,271,4,1,1,4.20312,0.265625,35.2031,87.7336,64,4,8.22214,2.77786
Sri Lanka,244,223.373,7.09016,0.344262,227.578,7.47541,0.385246,TM Dilshan,0,0,0,0,0,0,0,0,20,9,29,20,9,29,272,274,13,0,1,4.60199,0.273632,38.3632,86.0219,201,4,8.0636,0.9364
New Zealand,184,233.745,7.39674,0.36413,227.951,7.30435,0.353261,BB McCullum,0,0,0,0,0,0,0,0,16,9,25,16,9,25,0,248,2,1,1,3.98611,0.201389,29.9028,98.4004,144,0,6.81018,2.18982
Zimbabwe,142,212.077,7.5,0.380282,227.704,6.97887,0.316901,H Masakadza,0,0,0,0,0,0,0,0,0,11,11,0,11,11,373,231,1,0,1,3.11215,0.186916,26.972,70.0485,107,4,10.9554,0.0446081
Zimbabwe,142,212.077,7.5,0.380282,227.704,6.97887,0.316901,S Matsikenyeri,0,0,0,0,0,0,0,0,0,11,11,0,11,11,373,231,1,0,1,2,0.106383,19.9787,75.7869,47,1,8.15279,2.84721
South Africa,190,234.274,7.4,0.373684,232.363,7.33158,0.342105,HM Amla,0,0,0,0,0,0,0,0,8,11,19,8,11,19,254,254,0,0,1,5.20168,0.403361,48.7899,86.9292,119,4,8.55869,2.44131
South Africa,190,234.274,7.4,0.373684,232.363,7.33158,0.342105,GC Smith,0,0,0,0,0,0,0,0,8,11,19,8,11,19,254,254,0,0,1,3.97,0.29,33.57,79.6819,100,4,8.55869,2.44131
New Zealand,184,233.745,7.39674,0.36413,227.951,7.30435,0.353261,MJ Guptill,0,0,0,0,0,0,0,0,4,9,13,4,9,13,0,206,1,1,1,4.8087,0.313043,38.1217,82.7482,115,4,7.05259,1.94741
India,259,242.378,7.15058,0.339768,244.568,7.12741,0.30888,PA Patel,0,0,0,0,0,0,0,0,4,10,14,4,10,14,0,300,5,1,1,2.65217,0.130435,22.1304,79.4072,23,4,7.08899,2.91101
England,221,237.176,7.17647,0.289593,230.633,7.45701,0.384615,KP Pietersen,0,0,0,0,0,0,0,0,20,9,29,20,9,29,301,174,0,0,1,3.69892,0.236559,33.4946,82.2117,93,4,8.62341,0.37659
India,259,242.378,7.15058,0.339768,244.568,7.12741,0.30888,PA Patel,0,0,0,0,0,0,0,0,8,5,13,8,5,13,238,238,1,1,1,2.65217,0.130435,22.1304,79.4072,23,4,7.27728,-2.27728
Zimbabwe,142,212.077,7.5,0.380282,227.704,6.97887,0.316901,H Masakadza,0,0,0,0,0,0,0,0,4,4,8,4,4,8,189,191,0,1,1,3.11215,0.186916,26.972,70.0485,107,4,6.67537,-2.67537
Bangladesh,160,218.438,7.70625,0.4,211.106,7.05,0.325,Tamim Iqbal,0,0,0,0,0,0,0,0,4,11,15,4,11,15,0,253,1,0,1,4.05344,0.274809,31.8015,76.8068,131,4,8.00813,2.99187
Zimbabwe,142,212.077,7.5,0.380282,227.704,6.97887,0.316901,CJ Chibhabha,0,0,0,0,0,0,0,0,4,6,10,4,6,10,0,225,4,1,1,2.56716,0.149254,23.5373,64.7373,67,1,6.27492,-0.274917
Zimbabwe,142,212.077,7.5,0.380282,227.704,6.97887,0.316901,CJ Chibhabha,0,0,0,0,0,0,0,0,4,3,7,4,3,7,0,231,0,1,1,2.56716,0.149254,23.5373,64.7373,67,1,6.27492,-3.27492
New Zealand,184,233.745,7.39674,0.36413,227.951,7.30435,0.353261,MJ Guptill,0,0,0,0,0,0,0,0,20,19,39,20,19,39,232,232,4,0,1,4.8087,0.313043,38.1217,82.7482,115,4,9.13177,9.86823
Zimbabwe,142,212.077,7.5,0.380282,227.704,6.97887,0.316901,BRM Taylor,0,0,0,0,0,0,0,0,14,6,20,14,6,20,329,329,0,1,1,3.3,0.26,33.56,76.3421,100,4,5.09384,0.906158
Pakistan,211,222.621,7.38389,0.393365,235.517,7.54976,0.336493,Imran Farhat,0,0,0,0,0,0,0,0,12,9,21,12,9,21,132,132,9,0,1,3.03333,0.266667,27.0333,62.9658,30,4,6.9546,2.0454
Pakistan,211,222.621,7.38389,0.393365,235.517,7.54976,0.336493,Younis Khan,0,0,0,0,0,0,0,0,12,8,20,12,8,20,236,210,3,0,1,2.64655,0.215517,28.5,73.2713,116,4,7.51508,0.484925
Pakistan,211,222.621,7.38389,0.393365,235.517,7.54976,0.336493,Imran Farhat,0,0,0,0,0,0,0,0,12,4,16,12,4,16,0,200,2,0,1,3.03333,0.266667,27.0333,62.9658,30,4,7.17136,-3.17136
Sri Lanka,244,223.373,7.09016,0.344262,227.578,7.47541,0.385246,KC Sangakkara,0,0,0,0,0,0,0,0,4,12,16,4,12,16,0,218,4,0,1,4.33659,0.360976,41.9854,80.6276,205,4,7.29478,4.70522
England,221,237.176,7.17647,0.289593,230.633,7.45701,0.384615,KP Pietersen,0,0,0,0,0,0,0,0,8,11,19,8,11,19,0,260,5,0,1,3.69892,0.236559,33.4946,82.2117,93,4,7.75548,3.24452
Pakistan,211,222.621,7.38389,0.393365,235.517,7.54976,0.336493,Asad Shafiq,0,0,0,0,0,0,0,0,12,6,18,12,6,18,261,130,2,0,1,2.07843,0.176471,24.7843,67.1269,51,4,7.87558,-1.87558
England,221,237.176,7.17647,0.289593,230.633,7.45701,0.384615,AN Cook,0,0,0,0,0,0,0,0,8,4,12,8,4,12,0,250,7,0,1,4.17045,0.272727,35.75,75.5524,88,4,7.75548,-3.75548
England,221,237.176,7.17647,0.289593,230.633,7.45701,0.384615,KP Pietersen,0,0,0,0,0,0,0,0,8,4,12,8,4,12,0,250,7,0,1,3.69892,0.236559,33.4946,82.2117,93,4,7.75548,-3.75548
West Indies,176,217.33,7.15909,0.3125,225.278,7.57386,0.380682,LMP Simmons,0,0,0,0,0,0,0,0,0,10,10,0,10,10,0,298,1,0,1,3.3125,0.28125,30.5938,71.4338,64,4,5.87734,4.12266
Bangladesh,160,218.438,7.70625,0.4,211.106,7.05,0.325,Mushfiqur Rahim,0,0,0,0,0,0,0,0,16,2,18,16,2,18,0,220,0,1,1,2.61111,0.18254,27.7778,75.2526,126,4,6.14827,-4.14827
West Indies,176,217.33,7.15909,0.3125,225.278,7.57386,0.380682,DP Hyatt,0,0,0,0,0,0,0,0,0,7,7,0,7,7,0,61,1,0,1,1.55556,0,12.4444,59.2593,9,3,6.42326,0.576735
England,221,237.176,7.17647,0.289593,230.633,7.45701,0.384615,AN Cook,0,0,0,0,0,0,0,0,4,8,12,4,8,12,0,288,4,1,1,4.17045,0.272727,35.75,75.5524,88,4,7.9139,0.0861001
England,221,237.176,7.17647,0.289593,230.633,7.45701,0.384615,IR Bell,0,0,0,0,0,0,0,0,4,8,12,4,8,12,0,288,4,1,1,3.63433,0.246269,35.3806,75.6623,134,4,7.9139,0.0861001
England,221,237.176,7.17647,0.289593,230.633,7.45701,0.384615,AN Cook,0,0,0,0,0,0,0,0,16,5,21,16,5,21,239,239,2,1,1,4.17045,0.272727,35.75,75.5524,88,4,8.12162,-3.12162
England,221,237.176,7.17647,0.289593,230.633,7.45701,0.384615,AN Cook,0,0,0,0,0,0,0,0,0,7,7,0,7,7,0,272,4,1,1,4.17045,0.272727,35.75,75.5524,88,4,7.9139,-0.9139
Australia,228,239.627,7.69737,0.372807,232.079,7.23246,0.337719,SR Watson,0,0,0,0,0,0,0,0,0,14,14,0,14,14,273,257,1,0,1,4.71318,0.286822,37.7907,90.0943,129,4,8.57309,5.42691
England,221,237.176,7.17647,0.289593,230.633,7.45701,0.384615,IJL Trott,0,0,0,0,0,0,0,0,8,11,19,8,11,19,146,138,1,1,1,3.3871,0.403226,43.7903,75.2494,62,4,8.53874,2.46126
England,221,237.176,7.17647,0.289593,230.633,7.45701,0.384615,IJL Trott,0,0,0,0,0,0,0,0,12,3,15,12,3,15,212,212,2,1,1,3.3871,0.403226,43.7903,75.2494,62,4,8.17118,-5.17118
South Africa,190,234.274,7.4,0.373684,232.363,7.33158,0.342105,HM Amla,0,0,0,0,0,0,0,0,8,8,16,8,8,16,0,220,1,0,1,5.20168,0.403361,48.7899,86.9292,119,4,7.75548,0.244518
England,221,237.176,7.17647,0.289593,230.633,7.45701,0.384615,IR Bell,0,0,0,0,0,0,0,0,20,3,23,20,3,23,0,182,1,1,1,3.63433,0.246269,35.3806,75.6623,134,4,7.9139,-4.9139
India,259,242.378,7.15058,0.339768,244.568,7.12741,0.30888,G Gambhir,0,0,0,0,0,0,0,0,8,7,15,8,7,15,0,304,2,0,1,3.99145,0.333333,37.4701,84.1944,117,4,8.02085,-1.02085
Pakistan,211,222.621,7.38389,0.393365,235.517,7.54976,0.336493,Mohammad Hafeez,0,0,0,0,0,0,0,0,4,7,11,4,7,11,189,189,0,0,1,4.04511,0.255639,34.3534,78.0625,133,4,7.29199,-0.291987
Pakistan,211,222.621,7.38389,0.393365,235.517,7.54976,0.336493,Nasir Jamshed,0,0,0,0,0,0,0,0,20,6,26,20,6,26,0,329,1,0,1,3.63043,0.23913,30.2174,73.8184,46,4,7.17136,-1.17136
Sri Lanka,244,223.373,7.09016,0.344262,227.578,7.47541,0.385246,KC Sangakkara,0,0,0,0,0,0,0,0,12,8,20,12,8,20,0,232,0,0,1,4.33659,0.360976,41.9854,80.6276,205,4,7.29478,0.705219
Bangladesh,160,218.438,7.70625,0.4,211.106,7.05,0.325,Tamim Iqbal,0,0,0,0,0,0,0,0,12,7,19,12,7,19,233,212,6,1,1,4.05344,0.274809,31.8015,76.8068,131,4,6.99846,0.00153542
Pakistan,211,222.621,7.38389,0.393365,235.517,7.54976,0.336493,Nasir Jamshed,0,0,0,0,0,0,0,0,12,5,17,12,5,17,0,236,2,0,1,3.63043,0.23913,30.2174,73.8184,46,4,7.17136,-2.17136
Pakistan,211,222.621,7.38389,0.393365,235.517,7.54976,0.336493,Younis Khan,0,0,0,0,0,0,0,0,12,5,17,12,5,17,0,236,2,0,1,2.64655,0.215517,28.5,73.2713,116,4,7.17136,-2.17136
Bangladesh,160,218.438,7.70625,0.4,211.106,7.05,0.325,Tamim Iqbal,0,0,0,0,0,0,0,0,8,6,14,8,6,14,237,234,0,1,1,4.05344,0.274809,31.8015,76.8068,131,4,6.82088,-0.820882
West Indies,176,217.33,7.15909,0.3125,225.278,7.57386,0.380682,LMP Simmons,0,0,0,0,0,0,0,0,12,6,18,12,6,18,0,211,1,0,1,3.3125,0.28125,30.5938,71.4338,64,4,5.87734,0.122655
India,259,242.378,7.15058,0.339768,244.568,7.12741,0.30888,G Gambhir,0,0,0,0,0,0,0,0,24,10,34,24,10,34,212,213,8,1,1,3.99145,0.333333,37.4701,84.1944,117,4,7.76709,2.23291
West Indies,176,217.33,7.15909,0.3125,225.278,7.57386,0.380682,LMP Simmons,0,0,0,0,0,0,0,0,4,3,7,4,3,7,0,260,0,0,1,3.3125,0.28125,30.5938,71.4338,64,4,5.87734,-2.87734
West Indies,176,217.33,7.15909,0.3125,225.278,7.57386,0.380682,MN Samuels,0,0,0,0,0,0,0,0,4,3,7,4,3,7,0,260,0,0,1,3.74757,0.23301,31.6214,74.5821,103,4,5.87734,-2.87734
India,259,242.378,7.15058,0.339768,244.568,7.12741,0.30888,AM Rahane,0,0,0,0,0,0,0,0,4,14,18,4,14,18,0,267,1,1,1,3.55738,0.262295,32.2295,78.0159,61,4,7.08899,6.91101
India,259,242.378,7.15058,0.339768,244.568,7.12741,0.30888,MK Tiwary,0,0,0,0,0,0,0,0,4,14,18,4,14,18,0,267,1,1,1,2.7,0.2,28.2,72.3077,10,4,7.08899,6.91101
Pakistan,211,222.621,7.38389,0.393365,235.517,7.54976,0.336493,Mohammad Hafeez,0,0,0,0,0,0,0,0,16,2,18,16,2,18,92,93,2,0,1,4.04511,0.255639,34.3534,78.0625,133,4,4.822,-2.822
Pakistan,211,222.621,7.38389,0.393365,235.517,7.54976,0.336493,Mohammad Hafeez,0,0,0,0,0,0,0,0,12,1,13,12,1,13,0,262,5,0,1,4.04511,0.255639,34.3534,78.0625,133,4,7.17136,-6.17136
Pakistan,211,222.621,7.38389,0.393365,235.517,7.54976,0.336493,Imran Farhat,0,0,0,0,0,0,0,0,12,1,13,12,1,13,0,262,5,0,1,3.03333,0.266667,27.0333,62.9658,30,4,7.17136,-6.17136
Pakistan,211,222.621,7.38389,0.393365,235.517,7.54976,0.336493,Mohammad Hafeez,0,0,0,0,0,0,0,0,8,5,13,8,5,13,0,177,5,0,1,4.04511,0.255639,34.3534,78.0625,133,4,7.17136,-2.17136
Bangladesh,160,218.438,7.70625,0.4,211.106,7.05,0.325,Mahmudullah,0,0,0,0,0,0,0,0,4,9,13,4,9,13,178,119,3,1,1,2.26531,0.153061,24.4286,70.9544,98,4,8.99556,0.00444126
Australia,228,239.627,7.69737,0.372807,232.079,7.23246,0.337719,DA Warner,0,0,0,0,0,0,0,0,16,7,23,16,7,23,0,204,2,0,1,4.20312,0.265625,35.2031,87.7336,64,4,7.75388,-0.753881
West Indies,176,217.33,7.15909,0.3125,225.278,7.57386,0.380682,J Charles,0,0,0,0,0,0,0,0,16,4,20,16,4,20,205,140,1,1,1,3.82353,0.147059,28.2353,81.2183,34,4,5.81031,-1.81031
West Indies,176,217.33,7.15909,0.3125,225.278,7.57386,0.380682,MN Samuels,0,0,0,0,0,0,0,0,16,4,20,16,4,20,205,140,1,1,1,3.74757,0.23301,31.6214,74.5821,103,4,5.81031,-1.81031
West Indies,176,217.33,7.15909,0.3125,225.278,7.57386,0.380682,KOA Powell,0,0,0,0,0,0,0,0,8,8,16,8,8,16,155,163,0,1,1,3.59259,0.222222,26.4815,80.6088,27,4,8.05109,-0.0510921
Australia,228,239.627,7.69737,0.372807,232.079,7.23246,0.337719,SR Watson,0,0,0,0,0,0,0,0,20,13,33,20,13,33,0,220,0,0,1,4.71318,0.286822,37.7907,90.0943,129,4,7.75388,5.24612
Australia,228,239.627,7.69737,0.372807,232.079,7.23246,0.337719,DA Warner,0,0,0,0,0,0,0,0,20,13,33,20,13,33,0,220,0,0,1,4.20312,0.265625,35.2031,87.7336,64,4,7.75388,5.24612
Australia,228,239.627,7.69737,0.372807,232.079,7.23246,0.337719,SR Watson,0,0,0,0,0,0,0,0,18,11,29,18,11,29,0,281,1,0,1,4.71318,0.286822,37.7907,90.0943,129,4,7.75388,3.24612
West Indies,176,217.33,7.15909,0.3125,225.278,7.57386,0.380682,J Charles,0,0,0,0,0,0,0,0,4,1,5,4,1,5,282,251,2,1,1,3.82353,0.147059,28.2353,81.2183,34,4,6.57981,-5.57981
West Indies,176,217.33,7.15909,0.3125,225.278,7.57386,0.380682,AB Barath,0,0,0,0,0,0,0,0,4,1,5,4,1,5,282,251,2,1,1,2.76923,0.0769231,21.6154,56.4257,13,3,6.57981,-5.57981
New Zealand,184,233.745,7.39674,0.36413,227.951,7.30435,0.353261,MJ Guptill,0,0,0,0,0,0,0,0,4,8,12,4,8,12,0,190,3,0,1,4.8087,0.313043,38.1217,82.7482,115,4,7.05619,0.943808
West Indies,176,217.33,7.15909,0.3125,225.278,7.57386,0.380682,LMP Simmons,0,0,0,0,0,0,0,0,4,4,8,4,4,8,191,136,6,1,1,3.3125,0.28125,30.5938,71.4338,64,4,6.67537,-2.67537
West Indies,176,217.33,7.15909,0.3125,225.278,7.57386,0.380682,DR Smith,0,0,0,0,0,0,0,0,4,4,8,4,4,8,191,136,6,1,1,2.5,0.12,17.96,84.5574,50,1,6.95241,-2.95241
New Zealand,184,233.745,7.39674,0.36413,227.951,7.30435,0.353261,RJ Nicol,0,0,0,0,0,0,0,0,12,7,19,12,7,19,316,260,1,0,1,3.3,0.2,29.25,73.4003,20,4,7.95596,-0.955956
Pakistan,211,222.621,7.38389,0.393365,235.517,7.54976,0.336493,Mohammad Hafeez,0,0,0,0,0,0,0,0,20,6,26,20,6,26,281,204,0,0,1,4.04511,0.255639,34.3534,78.0625,133,4,8.37127,-2.37127
Pakistan,211,222.621,7.38389,0.393365,235.517,7.54976,0.336493,Mohammad Hafeez,0,0,0,0,0,0,0,0,8,5,13,8,5,13,244,199,4,0,1,4.04511,0.255639,34.3534,78.0625,133,4,6.52199,-1.52199
Pakistan,211,222.621,7.38389,0.393365,235.517,7.54976,0.336493,Azhar Ali,0,0,0,0,0,0,0,0,8,5,13,8,5,13,244,199,4,0,1,3.83333,0.3,38.5333,73.6775,30,4,6.52199,-1.52199
Sri Lanka,244,223.373,7.09016,0.344262,227.578,7.47541,0.385246,TM Dilshan,0,0,0,0,0,0,0,0,4,8,12,4,8,12,248,248,6,1,1,4.60199,0.273632,38.3632,86.0219,201,4,7.46231,0.537692
Sri Lanka,244,223.373,7.09016,0.344262,227.578,7.47541,0.385246,WU Tharanga,0,0,0,0,0,0,0,0,4,10,14,4,10,14,0,286,5,1,1,3.93985,0.263158,32.9699,71.6035,133,4,7.45349,2.54651
Sri Lanka,244,223.373,7.09016,0.344262,227.578,7.47541,0.385246,TM Dilshan,0,0,0,0,0,0,0,0,12,6,18,12,6,18,0,251,4,1,1,4.60199,0.273632,38.3632,86.0219,201,4,7.45349,-1.45349
Sri Lanka,244,223.373,7.09016,0.344262,227.578,7.47541,0.385246,HDRL Thirimanne,0,0,0,0,0,0,0,0,8,15,23,8,15,23,295,274,12,1,1,2.77778,0.246914,31.5802,71.4725,81,4,8.0636,6.9364
England,221,237.176,7.17647,0.289593,230.633,7.45701,0.384615,AN Cook,0,0,0,0,0,0,0,0,12,9,21,12,9,21,0,325,0,0,1,4.17045,0.272727,35.75,75.5524,88,4,7.75548,1.24452
India,259,242.378,7.15058,0.339768,244.568,7.12741,0.30888,Yuvraj Singh,0,0,0,0,0,0,0,0,4,9,13,4,9,13,0,285,6,1,1,4.05833,0.258333,32.525,83.8093,120,4,7.08899,1.91101
England,221,237.176,7.17647,0.289593,230.633,7.45701,0.384615,KP Pietersen,0,0,0,0,0,0,0,0,12,7,19,12,7,19,286,158,4,0,1,3.69892,0.236559,33.4946,82.2117,93,4,7.91583,-0.915833
India,259,242.378,7.15058,0.339768,244.568,7.12741,0.30888,G Gambhir,0,0,0,0,0,0,0,0,16,3,19,16,3,19,258,258,1,1,1,3.99145,0.333333,37.4701,84.1944,117,4,7.05762,-4.05762
India,259,242.378,7.15058,0.339768,244.568,7.12741,0.30888,RG Sharma,0,0,0,0,0,0,0,0,12,1,13,12,1,13,0,226,1,1,1,3.82836,0.268657,35.9179,83.083,134,4,7.08899,-6.08899
New Zealand,184,233.745,7.39674,0.36413,227.951,7.30435,0.353261,LRPL Taylor,0,0,0,0,0,0,0,0,16,5,21,16,5,21,228,231,5,0,1,3.68382,0.301471,36.7206,79.3959,136,4,6.84075,-1.84075
New Zealand,184,233.745,7.39674,0.36413,227.951,7.30435,0.353261,MJ Guptill,0,0,0,0,0,0,0,0,16,5,21,16,5,21,228,231,5,0,1,4.8087,0.313043,38.1217,82.7482,115,4,6.84075,-1.84075
Ireland,55,219.527,7.65455,0.290909,202.727,7.56364,0.4,WTS Porterfield,0,0,0,0,0,0,0,0,24,3,27,24,3,27,0,269,6,1,1,2.6,0.142857,24.6857,56.2866,35,3,6.79898,-3.79898
Ireland,55,219.527,7.65455,0.290909,202.727,7.56364,0.4,PR Stirling,0,0,0,0,0,0,0,0,24,3,27,24,3,27,0,269,6,1,1,3.47826,0.173913,24.2174,88.1329,23,0,5.89885,-2.89885
Ireland,55,219.527,7.65455,0.290909,202.727,7.56364,0.4,EC Joyce,0,0,0,0,0,0,0,0,24,3,27,24,3,27,0,269,6,1,1,3.08571,0.2,28.3429,68.6505,35,4,4.92415,-1.92415
England,221,237.176,7.17647,0.289593,230.633,7.45701,0.384615,JWA Taylor,0,0,0,0,0,0,0,0,12,5,17,12,5,17,270,274,0,0,1,3.375,0.333333,35.9167,79.8888,24,4,7.91583,-2.91583
England,221,237.176,7.17647,0.289593,230.633,7.45701,0.384615,JE Root,0,0,0,0,0,0,0,0,4,3,7,4,3,7,316,227,3,1,1,3.68852,0.327869,41.6721,83.3443,61,4,5.20932,-2.20932
Australia,228,239.627,7.69737,0.372807,232.079,7.23246,0.337719,SE Marsh,0,0,0,0,0,0,0,0,8,3,11,8,3,11,0,227,4,0,1,3.66667,0.291667,35.5417,74.7918,48,4,7.75388,-4.75388
England,221,237.176,7.17647,0.289593,230.633,7.45701,0.384615,EJG Morgan,0,0,0,0,0,0,0,0,8,6,14,8,6,14,228,231,2,1,1,3.19549,0.233083,30.0526,86.9291,133,4,7.53269,-1.53269
England,221,237.176,7.17647,0.289593,230.633,7.45701,0.384615,KP Pietersen,0,0,0,0,0,0,0,0,12,10,22,12,10,22,299,249,0,1,1,3.69892,0.236559,33.4946,82.2117,93,4,7.69462,2.30538
South Africa,190,234.274,7.4,0.373684,232.363,7.33158,0.342105,CA Ingram,0,0,0,0,0,0,0,0,4,9,13,4,9,13,0,175,3,0,1,3,0.178571,27.1786,81.3904,28,4,7.75548,1.24452
South Africa,190,234.274,7.4,0.373684,232.363,7.33158,0.342105,HM Amla,0,0,0,0,0,0,0,0,4,9,13,4,9,13,0,175,3,0,1,5.20168,0.403361,48.7899,86.9292,119,4,7.75548,1.24452
South Africa,190,234.274,7.4,0.373684,232.363,7.33158,0.342105,CA Ingram,0,0,0,0,0,0,0,0,4,15,19,4,15,19,0,208,6,1,1,3,0.178571,27.1786,81.3904,28,4,7.50981,7.49019
New Zealand,184,233.745,7.39674,0.36413,227.951,7.30435,0.353261,BJ Watling,0,0,0,0,0,0,0,0,8,1,9,8,1,9,209,209,1,0,1,3,0.263158,27.7895,66.9202,19,4,7.47924,-6.47924
New Zealand,184,233.745,7.39674,0.36413,227.951,7.30435,0.353261,KS Williamson,0,0,0,0,0,0,0,0,8,1,9,8,1,9,209,209,1,0,1,4.31707,0.390244,43.0488,82.8833,82,4,7.47924,-6.47924
New Zealand,184,233.745,7.39674,0.36413,227.951,7.30435,0.353261,MJ Guptill,0,0,0,0,0,0,0,0,8,5,13,8,5,13,0,260,2,0,1,4.8087,0.313043,38.1217,82.7482,115,4,7.05619,-2.05619
South Africa,190,234.274,7.4,0.373684,232.363,7.33158,0.342105,GC Smith,0,0,0,0,0,0,0,0,8,6,14,8,6,14,0,315,1,1,1,3.97,0.29,33.57,79.6819,100,4,7.50981,-1.50981
South Africa,190,234.274,7.4,0.373684,232.363,7.33158,0.342105,HM Amla,0,0,0,0,0,0,0,0,12,11,23,12,11,23,0,191,3,1,1,5.20168,0.403361,48.7899,86.9292,119,4,7.50981,3.49019
South Africa,190,234.274,7.4,0.373684,232.363,7.33158,0.342105,GC Smith,0,0,0,0,0,0,0,0,12,11,23,12,11,23,0,191,3,1,1,3.97,0.29,33.57,79.6819,100,4,7.50981,3.49019
South Africa,190,234.274,7.4,0.373684,232.363,7.33158,0.342105,CA Ingram,0,0,0,0,0,0,0,0,4,5,9,4,5,9,0,343,2,1,1,3,0.178571,27.1786,81.3904,28,4,7.50981,-2.50981
South Africa,190,234.274,7.4,0.373684,232.363,7.33158,0.342105,CA Ingram,0,0,0,0,0,0,0,0,12,6,18,12,6,18,0,234,1,1,1,3,0.178571,27.1786,81.3904,28,4,7.50981,-1.50981
England,221,237.176,7.17647,0.289593,230.633,7.45701,0.384615,IR Bell,0,0,0,0,0,0,0,0,12,4,16,12,4,16,270,270,1,0,1,3.63433,0.246269,35.3806,75.6623,134,4,7.91583,-3.91583
Pakistan,211,222.621,7.38389,0.393365,235.517,7.54976,0.336493,Mohammad Hafeez,0,0,0,0,0,0,0,0,4,11,15,4,11,15,0,198,5,0,1,4.04511,0.255639,34.3534,78.0625,133,4,7.17136,3.82864
Australia,228,239.627,7.69737,0.372807,232.079,7.23246,0.337719,MS Wade,0,0,0,0,0,0,0,0,12,8,20,12,8,20,0,248,7,0,1,1.86275,0.117647,20.3333,78.2642,51,1,7.92549,0.0745072
Australia,228,239.627,7.69737,0.372807,232.079,7.23246,0.337719,DA Warner,0,0,0,0,0,0,0,0,12,8,20,12,8,20,0,248,7,0,1,4.20312,0.265625,35.2031,87.7336,64,4,7.75388,0.246119
Pakistan,211,222.621,7.38389,0.393365,235.517,7.54976,0.336493,Mohammad Hafeez,0,0,0,0,0,0,0,0,16,8,24,16,8,24,0,244,2,0,1,4.04511,0.255639,34.3534,78.0625,133,4,7.17136,0.828635
Sri Lanka,244,223.373,7.09016,0.344262,227.578,7.47541,0.385246,DPMD Jayawardene,0,0,0,0,0,0,0,0,4,7,11,4,7,11,75,75,2,0,1,3.20833,0.244792,31.6979,79.1109,192,4,6.95748,0.0425248
West Indies,176,217.33,7.15909,0.3125,225.278,7.57386,0.380682,KOA Powell,0,0,0,0,0,0,0,0,8,3,11,8,3,11,0,70,3,0,1,3.59259,0.222222,26.4815,80.6088,27,4,5.87734,-2.87734
Australia,228,239.627,7.69737,0.372807,232.079,7.23246,0.337719,AJ Finch,0,0,0,0,0,0,0,0,12,6,18,12,6,18,0,266,2,1,1,4.52941,0.313725,37.2549,83.4431,51,4,8.22214,-2.22214
Australia,228,239.627,7.69737,0.372807,232.079,7.23246,0.337719,SR Watson,0,0,0,0,0,0,0,0,12,7,19,12,7,19,0,329,1,1,1,4.71318,0.286822,37.7907,90.0943,129,4,8.22214,-1.22214
West Indies,176,217.33,7.15909,0.3125,225.278,7.57386,0.380682,KOA Powell,0,0,0,0,0,0,0,0,16,3,19,16,3,19,330,290,0,0,1,3.59259,0.222222,26.4815,80.6088,27,4,5.63985,-2.63985
West Indies,176,217.33,7.15909,0.3125,225.278,7.57386,0.380682,DC Thomas,0,0,0,0,0,0,0,0,16,3,19,16,3,19,330,290,0,0,1,1.11111,0,12.4444,61.3699,18,1,6.10096,-3.10096
Australia,228,239.627,7.69737,0.372807,232.079,7.23246,0.337719,SR Watson,0,0,0,0,0,0,0,0,8,8,16,8,8,16,221,221,10,1,1,4.71318,0.286822,37.7907,90.0943,129,4,8.83063,-0.830626
India,259,242.378,7.15058,0.339768,244.568,7.12741,0.30888,S Dhawan,0,0,0,0,0,0,0,0,4,8,12,4,8,12,0,331,3,0,1,5.65217,0.362319,43.2174,88.9088,69,4,8.02085,-0.020853
South Africa,190,234.274,7.4,0.373684,232.363,7.33158,0.342105,CA Ingram,0,0,0,0,0,0,0,0,28,14,42,28,14,42,332,305,0,0,1,3,0.178571,27.1786,81.3904,28,4,10.4906,3.50935
South Africa,190,234.274,7.4,0.373684,232.363,7.33158,0.342105,RJ Peterson,0,0,0,0,0,0,0,0,28,14,42,28,14,42,332,305,0,0,1,1.62069,0.0344828,15.7931,83.5766,29,1,10.5996,3.40044
Pakistan,211,222.621,7.38389,0.393365,235.517,7.54976,0.336493,Mohammad Hafeez,0,0,0,0,0,0,0,0,8,4,12,8,4,12,0,170,2,0,1,4.04511,0.255639,34.3534,78.0625,133,4,7.17136,-3.17136
West Indies,176,217.33,7.15909,0.3125,225.278,7.57386,0.380682,DM Bravo,0,0,0,0,0,0,0,0,12,5,17,12,5,17,171,172,0,0,1,3,0.226667,28.52,67.4551,75,4,6.65773,-1.65773
Australia,228,239.627,7.69737,0.372807,232.079,7.23246,0.337719,DA Warner,0,0,0,0,0,0,0,0,4,12,16,4,12,16,270,221,1,0,1,4.20312,0.265625,35.2031,87.7336,64,4,8.07739,3.92261
India,259,242.378,7.15058,0.339768,244.568,7.12741,0.30888,S Dhawan,0,0,0,0,0,0,0,0,16,15,31,16,15,31,234,236,1,0,1,5.65217,0.362319,43.2174,88.9088,69,4,8.81083,6.18917
West Indies,176,217.33,7.15909,0.3125,225.278,7.57386,0.380682,CH Gayle,0,0,0,0,0,0,0,0,12,11,23,12,11,23,231,190,0,0,1,4.58621,0.206897,31.1293,89.4255,116,4,6.08203,4.91797
Pakistan,211,222.621,7.38389,0.393365,235.517,7.54976,0.336493,Nasir Jamshed,0,0,0,0,0,0,0,0,0,6,6,0,6,6,0,165,1,0,1,3.63043,0.23913,30.2174,73.8184,46,4,7.17136,-1.17136
New Zealand,184,233.745,7.39674,0.36413,227.951,7.30435,0.353261,L Ronchi,0,0,0,0,0,0,0,0,4,10,14,4,10,14,170,159,3,0,1,2.92157,0.0784314,22.1961,115.392,51,0,7.71633,2.28367
Sri Lanka,244,223.373,7.09016,0.344262,227.578,7.47541,0.385246,WU Tharanga,0,0,0,0,0,0,0,0,20,6,26,20,6,26,189,200,4,1,1,3.93985,0.263158,32.9699,71.6035,133,4,8.09874,-2.09874
Bangladesh,160,218.438,7.70625,0.4,211.106,7.05,0.325,Tamim Iqbal,0,0,0,0,0,0,0,0,14,4,18,14,4,18,200,201,3,1,1,4.05344,0.274809,31.8015,76.8068,131,4,7.49508,-3.49508
West Indies,176,217.33,7.15909,0.3125,225.278,7.57386,0.380682,CH Gayle,0,0,0,0,0,0,0,0,10,4,14,10,4,14,293,132,2,0,1,4.58621,0.206897,31.1293,89.4255,116,4,6.65402,-2.65402
West Indies,176,217.33,7.15909,0.3125,225.278,7.57386,0.380682,KOA Powell,0,0,0,0,0,0,0,0,14,4,18,14,4,18,228,228,0,0,1,3.59259,0.222222,26.4815,80.6088,27,4,4.63123,-0.631231
West Indies,176,217.33,7.15909,0.3125,225.278,7.57386,0.380682,MN Samuels,0,0,0,0,0,0,0,0,14,4,18,14,4,18,228,228,0,0,1,3.74757,0.23301,31.6214,74.5821,103,4,4.63123,-0.631231
Bangladesh,160,218.438,7.70625,0.4,211.106,7.05,0.325,Anamul Haque,0,0,0,0,0,0,0,0,0,7,7,0,7,7,212,136,5,1,1,4.12,0.24,36.8,69.6442,25,4,7.15528,-0.155283
Bangladesh,160,218.438,7.70625,0.4,211.106,7.05,0.325,Mushfiqur Rahim,0,0,0,0,0,0,0,0,0,7,7,0,7,7,212,136,5,1,1,2.61111,0.18254,27.7778,75.2526,126,4,7.15528,-0.155283
Bangladesh,160,218.438,7.70625,0.4,211.106,7.05,0.325,Mominul Haque,0,0,0,0,0,0,0,0,0,7,7,0,7,7,212,136,5,1,1,2.57143,0.0952381,23.3333,73.4633,21,4,7.15528,-0.155283
Bangladesh,160,218.438,7.70625,0.4,211.106,7.05,0.325,Tamim Iqbal,0,0,0,0,0,0,0,0,20,2,22,20,2,22,218,221,0,1,1,4.05344,0.274809,31.8015,76.8068,131,4,7.15528,-5.15528
Bangladesh,160,218.438,7.70625,0.4,211.106,7.05,0.325,Anamul Haque,0,0,0,0,0,0,0,0,20,2,22,20,2,22,218,221,0,1,1,4.12,0.24,36.8,69.6442,25,4,7.15528,-5.15528
Bangladesh,160,218.438,7.70625,0.4,211.106,7.05,0.325,Jahurul Islam,0,0,0,0,0,0,0,0,20,2,22,20,2,22,218,221,0,1,1,2.18182,0.0909091,20.5455,69.5385,11,1,7.43233,-5.43233
Pakistan,211,222.621,7.38389,0.393365,235.517,7.54976,0.336493,Mohammad Hafeez,0,0,0,0,0,0,0,0,0,4,4,0,4,4,228,228,4,0,1,4.04511,0.255639,34.3534,78.0625,133,4,6.6535,-2.6535
India,259,242.378,7.15058,0.339768,244.568,7.12741,0.30888,G Gambhir,0,0,0,0,0,0,0,0,12,9,21,12,9,21,251,165,6,1,1,3.99145,0.333333,37.4701,84.1944,117,4,7.49704,1.50296
Pakistan,211,222.621,7.38389,0.393365,235.517,7.54976,0.336493,Kamran Akmal,0,0,0,0,0,0,0,0,4,4,8,4,4,8,168,157,1,0,1,3.01124,0.11236,23.0787,81.4433,89,4,7.41527,-3.41527
West Indies,176,217.33,7.15909,0.3125,225.278,7.57386,0.380682,J Charles,0,0,0,0,0,0,0,0,8,12,20,8,12,20,0,337,1,1,1,3.82353,0.147059,28.2353,81.2183,34,4,6.4592,5.5408
Zimbabwe,142,212.077,7.5,0.380282,227.704,6.97887,0.316901,V Sibanda,0,0,0,0,0,0,0,0,14,4,18,14,4,18,338,181,4,0,1,2.9697,0.181818,23.5152,63.5545,66,1,5.10576,-1.10576
West Indies,176,217.33,7.15909,0.3125,225.278,7.57386,0.380682,J Charles,0,0,0,0,0,0,0,0,8,4,12,8,4,12,209,209,4,1,1,3.82353,0.147059,28.2353,81.2183,34,4,5.81031,-1.81031
Sri Lanka,244,223.373,7.09016,0.344262,227.578,7.47541,0.385246,WU Tharanga,0,0,0,0,0,0,0,0,8,4,12,8,4,12,120,96,6,0,1,3.93985,0.263158,32.9699,71.6035,133,4,7.44658,-3.44658
Sri Lanka,244,223.373,7.09016,0.344262,227.578,7.47541,0.385246,DPMD Jayawardene,0,0,0,0,0,0,0,0,8,4,12,8,4,12,120,96,6,0,1,3.20833,0.244792,31.6979,79.1109,192,4,7.44658,-3.44658
India,259,242.378,7.15058,0.339768,244.568,7.12741,0.30888,RG Sharma,0,0,0,0,0,0,0,0,4,10,14,4,10,14,202,203,2,0,1,3.82836,0.268657,35.9179,83.083,134,4,8.33739,1.66261
Pakistan,211,222.621,7.38389,0.393365,235.517,7.54976,0.336493,Imran Farhat,0,0,0,0,0,0,0,0,0,6,6,0,6,6,0,266,2,0,1,3.03333,0.266667,27.0333,62.9658,30,4,7.17136,-1.17136
Pakistan,211,222.621,7.38389,0.393365,235.517,7.54976,0.336493,Nasir Jamshed,0,0,0,0,0,0,0,0,0,5,5,0,5,5,230,230,3,0,1,3.63043,0.23913,30.2174,73.8184,46,4,6.69438,-1.69438
Sri Lanka,244,223.373,7.09016,0.344262,227.578,7.47541,0.385246,TM Dilshan,0,0,0,0,0,0,0,0,26,10,36,26,10,36,0,302,0,1,1,4.60199,0.273632,38.3632,86.0219,201,4,7.45349,2.54651
Bangladesh,160,218.438,7.70625,0.4,211.106,7.05,0.325,Anamul Haque,0,0,0,0,0,0,0,0,20,7,27,20,7,27,303,184,11,0,1,4.12,0.24,36.8,69.6442,25,4,6.99071,0.00929165
Zimbabwe,142,212.077,7.5,0.380282,227.704,6.97887,0.316901,H Masakadza,0,0,0,0,0,0,0,0,12,6,18,12,6,18,270,148,5,1,1,3.11215,0.186916,26.972,70.0485,107,4,6.57981,-0.579814
Bangladesh,160,218.438,7.70625,0.4,211.106,7.05,0.325,Mominul Haque,0,0,0,0,0,0,0,0,4,9,13,4,9,13,0,252,1,0,1,2.57143,0.0952381,23.3333,73.4633,21,4,8.00813,0.991873
Bangladesh,160,218.438,7.70625,0.4,211.106,7.05,0.325,Mohammad Ashraful,0,0,0,0,0,0,0,0,10,9,19,10,9,19,0,247,1,0,1,2.17722,0.113924,19.4557,63.9085,79,1,8.20551,0.794487
Bangladesh,160,218.438,7.70625,0.4,211.106,7.05,0.325,Jahurul Islam,0,0,0,0,0,0,0,0,10,9,19,10,9,19,0,247,1,0,1,2.18182,0.0909091,20.5455,69.5385,11,1,8.20551,0.794487
Sri Lanka,244,223.373,7.09016,0.344262,227.578,7.47541,0.385246,TM Dilshan,0,0,0,0,0,0,0,0,12,7,19,12,7,19,0,320,8,1,1,4.60199,0.273632,38.3632,86.0219,201,4,7.45349,-0.453492
Sri Lanka,244,223.373,7.09016,0.344262,227.578,7.47541,0.385246,WU Tharanga,0,0,0,0,0,0,0,0,4,7,11,4,7,11,0,223,3,1,1,3.93985,0.263158,32.9699,71.6035,133,4,7.45349,-0.453492
South Africa,190,234.274,7.4,0.373684,232.363,7.33158,0.342105,RJ Peterson,0,0,0,0,0,0,0,0,12,16,28,12,16,28,224,104,2,0,1,1.62069,0.0344828,15.7931,83.5766,29,1,8.21284,7.78716
South Africa,190,234.274,7.4,0.373684,232.363,7.33158,0.342105,JP Duminy,0,0,0,0,0,0,0,0,12,16,28,12,16,28,224,104,2,0,1,2.3252,0.186992,29.9675,80.2351,123,4,8.21284,7.78716
Sri Lanka,244,223.373,7.09016,0.344262,227.578,7.47541,0.385246,KC Sangakkara,0,0,0,0,0,0,0,0,8,3,11,8,3,11,224,167,4,1,1,4.33659,0.360976,41.9854,80.6276,205,4,7.50407,-4.50407
South Africa,190,234.274,7.4,0.373684,232.363,7.33158,0.342105,JP Duminy,0,0,0,0,0,0,0,0,24,6,30,24,6,30,0,238,0,0,1,2.3252,0.186992,29.9675,80.2351,123,4,7.75548,-1.75548
Sri Lanka,244,223.373,7.09016,0.344262,227.578,7.47541,0.385246,TM Dilshan,0,0,0,0,0,0,0,0,8,3,11,8,3,11,0,307,3,1,1,4.60199,0.273632,38.3632,86.0219,201,4,7.45349,-4.45349
South Africa,190,234.274,7.4,0.373684,232.363,7.33158,0.342105,Q de Kock,0,0,0,0,0,0,0,0,24,8,32,24,8,32,308,179,0,0,1,5.12963,0.240741,39.1111,91.2311,54,4,9.2114,-1.2114
Australia,228,239.627,7.69737,0.372807,232.079,7.23246,0.337719,AJ Finch,0,0,0,0,0,0,0,0,16,8,24,16,8,24,270,270,4,1,1,4.52941,0.313725,37.2549,83.4431,51,4,8.9646,-0.964596
Australia,228,239.627,7.69737,0.372807,232.079,7.23246,0.337719,AJ Finch,0,0,0,0,0,0,0,0,16,14,30,16,14,30,301,301,1,1,1,4.52941,0.313725,37.2549,83.4431,51,4,8.47193,5.52807
Australia,228,239.627,7.69737,0.372807,232.079,7.23246,0.337719,AJ Finch,0,0,0,0,0,0,0,0,12,15,27,12,15,27,244,244,3,1,1,4.52941,0.313725,37.2549,83.4431,51,4,8.78106,6.21894
Australia,228,239.627,7.69737,0.372807,232.079,7.23246,0.337719,SE Marsh,0,0,0,0,0,0,0,0,4,7,11,4,7,11,0,217,3,1,1,3.66667,0.291667,35.5417,74.7918,48,4,8.22214,-1.22214
West Indies,176,217.33,7.15909,0.3125,225.278,7.57386,0.380682,KOA Powell,0,0,0,0,0,0,0,0,10,9,19,10,9,19,0,269,0,1,1,3.59259,0.222222,26.4815,80.6088,27,4,6.4592,2.5408
England,221,237.176,7.17647,0.289593,230.633,7.45701,0.384615,MJ Lumb,0,0,0,0,0,0,0,0,12,11,23,12,11,23,270,254,2,0,1,5,0.333333,55,80.0971,3,4,7.91583,3.08417
England,221,237.176,7.17647,0.289593,230.633,7.45701,0.384615,MM Ali,0,0,0,0,0,0,0,0,12,11,23,12,11,23,270,254,2,0,1,2.67647,0.117647,21.3824,94.5384,34,0,8.12045,2.87955
England,221,237.176,7.17647,0.289593,230.633,7.45701,0.384615,MJ Lumb,0,0,0,0,0,0,0,0,8,11,19,8,11,19,160,163,4,0,1,5,0.333333,55,80.0971,3,4,8.70495,2.29505
England,221,237.176,7.17647,0.289593,230.633,7.45701,0.384615,MM Ali,0,0,0,0,0,0,0,0,8,11,19,8,11,19,160,163,4,0,1,2.67647,0.117647,21.3824,94.5384,34,0,8.57447,2.42553
West Indies,176,217.33,7.15909,0.3125,225.278,7.57386,0.380682,KOA Powell,0,0,0,0,0,0,0,0,24,8,32,24,8,32,304,278,0,1,1,3.59259,0.222222,26.4815,80.6088,27,4,7.11657,0.88343
West Indies,176,217.33,7.15909,0.3125,225.278,7.57386,0.380682,LMP Simmons,0,0,0,0,0,0,0,0,24,8,32,24,8,32,304,278,0,1,1,3.3125,0.28125,30.5938,71.4338,64,4,7.11657,0.88343
West Indies,176,217.33,7.15909,0.3125,225.278,7.57386,0.380682,DM Bravo,0,0,0,0,0,0,0,0,24,8,32,24,8,32,304,278,0,1,1,3,0.226667,28.52,67.4551,75,4,7.11657,0.88343
India,259,242.378,7.15058,0.339768,244.568,7.12741,0.30888,V Kohli,0,0,0,0,0,0,0,0,16,6,22,16,6,22,0,294,7,0,1,4.66456,0.379747,44.9937,88.3325,158,4,8.02085,-2.02085
Zimbabwe,142,212.077,7.5,0.380282,227.704,6.97887,0.316901,Sikandar Raza,0,0,0,0,0,0,0,0,12,5,17,12,5,17,0,183,5,1,1,3,0.131579,26.1842,81.1582,38,4,6.39467,-1.39467
Zimbabwe,142,212.077,7.5,0.380282,227.704,6.97887,0.316901,V Sibanda,0,0,0,0,0,0,0,0,4,5,9,4,5,9,0,144,3,1,1,2.9697,0.181818,23.5152,63.5545,66,1,6.27492,-1.27492
India,259,242.378,7.15058,0.339768,244.568,7.12741,0.30888,RG Sharma,0,0,0,0,0,0,0,0,8,4,12,8,4,12,145,145,0,0,1,3.82836,0.268657,35.9179,83.083,134,4,8,-4
Zimbabwe,142,212.077,7.5,0.380282,227.704,6.97887,0.316901,V Sibanda,0,0,0,0,0,0,0,0,12,6,18,12,6,18,0,163,1,1,1,2.9697,0.181818,23.5152,63.5545,66,1,6.27492,-0.274917
Zimbabwe,142,212.077,7.5,0.380282,227.704,6.97887,0.316901,H Masakadza,0,0,0,0,0,0,0,0,12,6,18,12,6,18,0,163,1,1,1,3.11215,0.186916,26.972,70.0485,107,4,6.39467,-0.394666
Pakistan,211,222.621,7.38389,0.393365,235.517,7.54976,0.336493,Mohammad Hafeez,0,0,0,0,0,0,0,0,8,2,10,8,2,10,0,224,7,0,1,4.04511,0.255639,34.3534,78.0625,133,4,7.17136,-5.17136
West Indies,176,217.33,7.15909,0.3125,225.278,7.57386,0.380682,CH Gayle,0,0,0,0,0,0,0,0,4,2,6,4,2,6,225,98,1,1,1,4.58621,0.206897,31.1293,89.4255,116,4,4.77152,-2.77152
West Indies,176,217.33,7.15909,0.3125,225.278,7.57386,0.380682,DM Bravo,0,0,0,0,0,0,0,0,8,10,18,8,10,18,0,232,1,1,1,3,0.226667,28.52,67.4551,75,4,6.4592,3.5408
Pakistan,211,222.621,7.38389,0.393365,235.517,7.54976,0.336493,Ahmed Shehzad,0,0,0,0,0,0,0,0,0,0,0,0,0,0,233,195,5,0,1,3.67143,0.242857,33.2714,70.8118,70,4,6.81386,-6.81386
Pakistan,211,222.621,7.38389,0.393365,235.517,7.54976,0.336493,Nasir Jamshed,0,0,0,0,0,0,0,0,8,6,14,8,6,14,0,229,1,0,1,3.63043,0.23913,30.2174,73.8184,46,4,7.17136,-1.17136
West Indies,176,217.33,7.15909,0.3125,225.278,7.57386,0.380682,DM Bravo,0,0,0,0,0,0,0,0,8,9,17,8,9,17,230,229,2,1,1,3,0.226667,28.52,67.4551,75,4,6.1785,2.8215
West Indies,176,217.33,7.15909,0.3125,225.278,7.57386,0.380682,J Charles,0,0,0,0,0,0,0,0,12,4,16,12,4,16,0,261,0,1,1,3.82353,0.147059,28.2353,81.2183,34,4,6.4592,-2.4592
Pakistan,211,222.621,7.38389,0.393365,235.517,7.54976,0.336493,Ahmed Shehzad,0,0,0,0,0,0,0,0,8,14,22,8,14,22,262,189,1,0,1,3.67143,0.242857,33.2714,70.8118,70,4,7.87558,6.12442
Australia,228,239.627,7.69737,0.372807,232.079,7.23246,0.337719,PJ Hughes,0,0,0,0,0,0,0,0,4,7,11,4,7,11,0,304,2,0,1,4.52381,0.285714,38.7619,74.7475,21,4,7.75388,-0.753881
India,259,242.378,7.15058,0.339768,244.568,7.12741,0.30888,RG Sharma,0,0,0,0,0,0,0,0,4,9,13,4,9,13,305,232,2,1,1,3.82836,0.268657,35.9179,83.083,134,4,7.88094,1.11906
Australia,228,239.627,7.69737,0.372807,232.079,7.23246,0.337719,AJ Finch,0,0,0,0,0,0,0,0,16,5,21,16,5,21,0,359,2,0,1,4.52941,0.313725,37.2549,83.4431,51,4,7.75388,-2.75388
India,259,242.378,7.15058,0.339768,244.568,7.12741,0.30888,S Dhawan,0,0,0,0,0,0,0,0,16,8,24,16,8,24,360,362,6,1,1,5.65217,0.362319,43.2174,88.9088,69,4,8.43447,-0.434467
India,259,242.378,7.15058,0.339768,244.568,7.12741,0.30888,V Kohli,0,0,0,0,0,0,0,0,20,2,22,20,2,22,0,303,7,1,1,4.66456,0.379747,44.9937,88.3325,158,4,7.08899,-5.08899
Australia,228,239.627,7.69737,0.372807,232.079,7.23246,0.337719,PJ Hughes,0,0,0,0,0,0,0,0,8,4,12,8,4,12,0,350,0,0,1,4.52381,0.285714,38.7619,74.7475,21,4,7.75388,-3.75388
India,259,242.378,7.15058,0.339768,244.568,7.12741,0.30888,RG Sharma,0,0,0,0,0,0,0,0,12,9,21,12,9,21,351,351,5,1,1,3.82836,0.268657,35.9179,83.083,134,4,12.3832,-3.38319
India,259,242.378,7.15058,0.339768,244.568,7.12741,0.30888,S Dhawan,0,0,0,0,0,0,0,0,12,9,21,12,9,21,351,351,5,1,1,5.65217,0.362319,43.2174,88.9088,69,4,12.3832,-3.38319
India,259,242.378,7.15058,0.339768,244.568,7.12741,0.30888,S Dhawan,0,0,0,0,0,0,0,0,20,8,28,20,8,28,0,383,5,1,1,5.65217,0.362319,43.2174,88.9088,69,4,7.08899,0.911011
Australia,228,239.627,7.69737,0.372807,232.079,7.23246,0.337719,AJ Finch,0,0,0,0,0,0,0,0,8,8,16,8,8,16,384,326,0,0,1,4.52941,0.313725,37.2549,83.4431,51,4,7.54282,0.457182
Australia,228,239.627,7.69737,0.372807,232.079,7.23246,0.337719,PJ Hughes,0,0,0,0,0,0,0,0,8,8,16,8,8,16,384,326,0,0,1,4.52381,0.285714,38.7619,74.7475,21,4,7.54282,0.457182
Pakistan,211,222.621,7.38389,0.393365,235.517,7.54976,0.336493,Nasir Jamshed,0,0,0,0,0,0,0,0,0,3,3,0,3,3,184,182,1,0,1,3.63043,0.23913,30.2174,73.8184,46,4,7.46459,-4.46459
South Africa,190,234.274,7.4,0.373684,232.363,7.33158,0.342105,GC Smith,0,0,0,0,0,0,0,0,16,9,25,16,9,25,210,143,2,0,1,3.97,0.29,33.57,79.6819,100,4,8.80751,0.192489
Pakistan,211,222.621,7.38389,0.393365,235.517,7.54976,0.336493,Mohammad Hafeez,0,0,0,0,0,0,0,0,32,3,35,32,3,35,260,191,2,0,1,4.04511,0.255639,34.3534,78.0625,133,4,7.87558,-4.87558
Pakistan,211,222.621,7.38389,0.393365,235.517,7.54976,0.336493,Mohammad Hafeez,0,0,0,0,0,0,0,0,0,7,7,0,7,7,267,238,1,0,1,4.04511,0.255639,34.3534,78.0625,133,4,7.87558,-0.875576
South Africa,190,234.274,7.4,0.373684,232.363,7.33158,0.342105,Q de Kock,0,0,0,0,0,0,0,0,16,9,25,16,9,25,0,268,3,0,1,5.12963,0.240741,39.1111,91.2311,54,4,7.75548,1.24452
England,221,237.176,7.17647,0.289593,230.633,7.45701,0.384615,IR Bell,0,0,0,0,0,0,0,0,20,6,26,20,6,26,343,231,3,0,1,3.63433,0.246269,35.3806,75.6623,134,4,7.62421,-1.62421
England,221,237.176,7.17647,0.289593,230.633,7.45701,0.384615,GS Ballance,0,0,0,0,0,0,0,0,20,6,26,20,6,26,343,231,3,0,1,1.69231,0.153846,22,66.3573,13,1,7.62421,-1.62421
India,259,242.378,7.15058,0.339768,244.568,7.12741,0.30888,S Dhawan,0,0,0,0,0,0,0,0,12,8,20,12,8,20,0,300,1,0,1,5.65217,0.362319,43.2174,88.9088,69,4,8.02085,-0.020853
West Indies,176,217.33,7.15909,0.3125,225.278,7.57386,0.380682,DR Smith,0,0,0,0,0,0,0,0,8,8,16,8,8,16,0,310,1,0,1,2.5,0.12,17.96,84.5574,50,1,6.30204,1.69796
Pakistan,211,222.621,7.38389,0.393365,235.517,7.54976,0.336493,Sohaib Maqsood,0,0,0,0,0,0,0,0,0,2,2,0,2,2,311,160,1,0,1,2.86957,0.217391,29.4348,79.7409,23,4,6.53014,-4.53014
Pakistan,211,222.621,7.38389,0.393365,235.517,7.54976,0.336493,Misbah-ul-Haq,0,0,0,0,0,0,0,0,0,2,2,0,2,2,311,160,1,0,1,2.95238,0.285714,34.9921,71.8195,126,4,6.53014,-4.53014
South Africa,190,234.274,7.4,0.373684,232.363,7.33158,0.342105,F du Plessis,0,0,0,0,0,0,0,0,4,10,14,4,10,14,308,177,3,0,1,3.45122,0.292683,34.9268,83.135,82,4,9.2114,0.788602
Zimbabwe,142,212.077,7.5,0.380282,227.704,6.97887,0.316901,RW Chakabva,0,0,0,0,0,0,0,0,12,12,24,12,12,24,373,289,2,0,1,0.846154,0,13.2692,51.3393,26,3,9.61041,2.38959
West Indies,176,217.33,7.15909,0.3125,225.278,7.57386,0.380682,DR Smith,0,0,0,0,0,0,0,0,6,7,13,6,7,13,409,151,7,0,1,2.5,0.12,17.96,84.5574,50,1,7.33121,-0.331205
West Indies,176,217.33,7.15909,0.3125,225.278,7.57386,0.380682,JL Carter,0,0,0,0,0,0,0,0,6,7,13,6,7,13,409,151,7,0,1,1.63636,0,14.7273,55.8621,11,3,7.31068,-0.310682
Australia,228,239.627,7.69737,0.372807,232.079,7.23246,0.337719,AJ Finch,0,0,0,0,0,0,0,0,28,13,41,28,13,41,0,151,7,0,1,4.52941,0.313725,37.2549,83.4431,51,4,7.75388,5.24612
Australia,228,239.627,7.69737,0.372807,232.079,7.23246,0.337719,SR Watson,0,0,0,0,0,0,0,0,28,13,41,28,13,41,0,151,7,0,1,4.71318,0.286822,37.7907,90.0943,129,4,7.75388,5.24612
New Zealand,184,233.745,7.39674,0.36413,227.951,7.30435,0.353261,BB McCullum,0,0,0,0,0,0,0,0,42,5,47,42,5,47,152,152,3,1,1,3.98611,0.201389,29.9028,98.4004,144,0,7.83024,-2.83024
England,221,237.176,7.17647,0.289593,230.633,7.45701,0.384615,IR Bell,0,0,0,0,0,0,0,0,32,4,36,32,4,36,0,309,6,0,1,3.63433,0.246269,35.3806,75.6623,134,4,7.75548,-3.75548
Zimbabwe,142,212.077,7.5,0.380282,227.704,6.97887,0.316901,Sikandar Raza,0,0,0,0,0,0,0,0,8,6,14,8,6,14,236,215,1,0,1,3,0.131579,26.1842,81.1582,38,4,6.12731,-0.127306
Ireland,55,219.527,7.65455,0.290909,202.727,7.56364,0.4,A Balbirnie,0,0,0,0,0,0,0,0,20,5,25,20,5,25,412,210,0,0,1,3,0.222222,28.7778,81.1912,9,4,5.19019,-0.190188
Ireland,55,219.527,7.65455,0.290909,202.727,7.56364,0.4,PR Stirling,0,0,0,0,0,0,0,0,8,12,20,8,12,20,0,331,1,0,1,3.47826,0.173913,24.2174,88.1329,23,0,5.02212,6.97788
Ireland,55,219.527,7.65455,0.290909,202.727,7.56364,0.4,EC Joyce,0,0,0,0,0,0,0,0,8,12,20,8,12,20,0,331,1,0,1,3.08571,0.2,28.3429,68.6505,35,4,4.1599,7.8401
Australia,228,239.627,7.69737,0.372807,232.079,7.23246,0.337719,SPD Smith,0,0,0,0,0,0,0,0,12,11,23,12,11,23,0,376,1,1,1,3.19298,0.22807,34.5614,87.0526,57,4,8.22214,2.77786
Bangladesh,160,218.438,7.70625,0.4,211.106,7.05,0.325,Tamim Iqbal,0,0,0,0,0,0,0,0,4,8,12,4,8,12,0,275,0,0,1,4.05344,0.274809,31.8015,76.8068,131,4,8.00813,-0.00812721
Bangladesh,160,218.438,7.70625,0.4,211.106,7.05,0.325,Imrul Kayes,0,0,0,0,0,0,0,0,0,4,4,0,4,4,0,288,0,0,1,3,0.207547,26.2642,63.6488,53,4,8.00813,-4.00813
New Zealand,184,233.745,7.39674,0.36413,227.951,7.30435,0.353261,BB McCullum,0,0,0,0,0,0,0,0,24,9,33,24,9,33,289,290,0,1,1,3.98611,0.201389,29.9028,98.4004,144,0,7.14779,1.85221
Ireland,55,219.527,7.65455,0.290909,202.727,7.56364,0.4,WTS Porterfield,0,0,0,0,0,0,0,0,8,7,15,8,7,15,0,237,1,0,1,2.6,0.142857,24.6857,56.2866,35,3,5.51713,1.48287
Pakistan,211,222.621,7.38389,0.393365,235.517,7.54976,0.336493,Sarfraz Ahmed,0,0,0,0,0,0,0,0,4,10,14,4,10,14,238,241,3,0,1,2.04878,0.097561,25.4878,83.9357,41,4,7.51508,2.48492
Sri Lanka,244,223.373,7.09016,0.344262,227.578,7.47541,0.385246,MDKJ Perera,0,0,0,0,0,0,0,0,0,4,4,0,4,4,0,133,2,0,1,3.30435,0.195652,25.7391,90.5199,46,0,7.46273,-3.46273
Bangladesh,160,218.438,7.70625,0.4,211.106,7.05,0.325,Imrul Kayes,0,0,0,0,0,0,0,0,12,8,20,12,8,20,303,193,3,0,1,3,0.207547,26.2642,63.6488,53,4,6.99071,1.00929
Pakistan,211,222.621,7.38389,0.393365,235.517,7.54976,0.336493,Ahmed Shehzad,0,0,0,0,0,0,0,0,8,11,19,8,11,19,0,213,5,0,1,3.67143,0.242857,33.2714,70.8118,70,4,7.17136,3.82864
Australia,228,239.627,7.69737,0.372807,232.079,7.23246,0.337719,DA Warner,0,0,0,0,0,0,0,0,18,11,29,18,11,29,0,328,2,1,1,4.20312,0.265625,35.2031,87.7336,64,4,8.22214,2.77786
New Zealand,184,233.745,7.39674,0.36413,227.951,7.30435,0.353261,MJ Guptill,0,0,0,0,0,0,0,0,10,4,14,10,4,14,0,183,4,0,1,4.8087,0.313043,38.1217,82.7482,115,4,7.05619,-3.05619
Australia,228,239.627,7.69737,0.372807,232.079,7.23246,0.337719,AJ Finch,0,0,0,0,0,0,0,0,16,13,29,16,13,29,184,186,4,1,1,4.52941,0.313725,37.2549,83.4431,51,4,9.00323,3.99677
Pakistan,211,222.621,7.38389,0.393365,235.517,7.54976,0.336493,Sharjeel Khan,0,0,0,0,0,0,0,0,22,8,30,22,8,30,0,322,2,0,1,2.6,0.1,16.9,81.25,10,1,7.44224,0.557762
Pakistan,211,222.621,7.38389,0.393365,235.517,7.54976,0.336493,Ahmed Shehzad,0,0,0,0,0,0,0,0,22,8,30,22,8,30,0,322,2,0,1,3.67143,0.242857,33.2714,70.8118,70,4,7.17136,0.828635
Sri Lanka,244,223.373,7.09016,0.344262,227.578,7.47541,0.385246,MDKJ Perera,0,0,0,0,0,0,0,0,8,10,18,8,10,18,285,287,0,0,1,3.30435,0.195652,25.7391,90.5199,46,0,8.26821,1.73179
Pakistan,211,222.621,7.38389,0.393365,235.517,7.54976,0.336493,Ahmed Shehzad,0,0,0,0,0,0,0,0,4,11,15,4,11,15,0,326,0,0,1,3.67143,0.242857,33.2714,70.8118,70,4,7.17136,3.82864
Sri Lanka,244,223.373,7.09016,0.344262,227.578,7.47541,0.385246,FDM Karunaratne,0,0,0,0,0,0,0,0,16,10,26,16,10,26,327,213,0,0,1,0.8,0,10.7,64.8485,10,1,10.1851,-0.185132
Pakistan,211,222.621,7.38389,0.393365,235.517,7.54976,0.336493,Ahmed Shehzad,0,0,0,0,0,0,0,0,20,10,30,20,10,30,226,226,1,0,1,3.67143,0.242857,33.2714,70.8118,70,4,7.37892,2.62108
Pakistan,211,222.621,7.38389,0.393365,235.517,7.54976,0.336493,Ahmed Shehzad,0,0,0,0,0,0,0,0,0,8,8,0,8,8,0,244,5,0,1,3.67143,0.242857,33.2714,70.8118,70,4,7.17136,0.828635
Pakistan,211,222.621,7.38389,0.393365,235.517,7.54976,0.336493,Nasir Jamshed,0,0,0,0,0,0,0,0,8,5,13,8,5,13,0,260,2,0,1,3.63043,0.23913,30.2174,73.8184,46,4,7.17136,-2.17136
Zimbabwe,142,212.077,7.5,0.380282,227.704,6.97887,0.316901,H Masakadza,0,0,0,0,0,0,0,0,4,6,10,4,6,10,261,152,8,1,1,3.11215,0.186916,26.972,70.0485,107,4,6.49331,-0.493314
New Zealand,184,233.745,7.39674,0.36413,227.951,7.30435,0.353261,MJ Guptill,0,0,0,0,0,0,0,0,0,5,5,0,5,5,0,156,0,1,1,4.8087,0.313043,38.1217,82.7482,115,4,7.05259,-2.05259
New Zealand,184,233.745,7.39674,0.36413,227.951,7.30435,0.353261,JD Ryder,0,0,0,0,0,0,0,0,50,7,57,50,7,57,0,283,0,1,1,4.88571,0.257143,34.4,97.2536,35,0,6.81018,0.189818
West Indies,176,217.33,7.15909,0.3125,225.278,7.57386,0.380682,LMP Simmons,0,0,0,0,0,0,0,0,10,9,19,10,9,19,284,124,1,0,1,3.3125,0.28125,30.5938,71.4338,64,4,6.96728,2.03272
West Indies,176,217.33,7.15909,0.3125,225.278,7.57386,0.380682,KOA Powell,0,0,0,0,0,0,0,0,34,3,37,34,3,37,0,363,0,0,1,3.59259,0.222222,26.4815,80.6088,27,4,5.87734,-2.87734
New Zealand,184,233.745,7.39674,0.36413,227.951,7.30435,0.353261,MJ Guptill,0,0,0,0,0,0,0,0,22,2,24,22,2,24,0,292,2,1,1,4.8087,0.313043,38.1217,82.7482,115,4,7.05259,-5.05259
India,259,242.378,7.15058,0.339768,244.568,7.12741,0.30888,RG Sharma,0,0,0,0,0,0,0,0,4,6,10,4,6,10,272,277,0,0,1,3.82836,0.268657,35.9179,83.083,134,4,7.66219,-1.66219
India,259,242.378,7.15058,0.339768,244.568,7.12741,0.30888,RG Sharma,0,0,0,0,0,0,0,0,14,11,25,14,11,25,315,314,0,0,1,3.82836,0.268657,35.9179,83.083,134,4,8.68828,2.31172
England,221,237.176,7.17647,0.289593,230.633,7.45701,0.384615,AD Hales,0,0,0,0,0,0,0,0,12,4,16,12,4,16,0,206,0,1,1,4.2963,0.296296,34.1111,85.1201,27,4,7.9139,-3.9139
England,221,237.176,7.17647,0.289593,230.633,7.45701,0.384615,MA Carberry,0,0,0,0,0,0,0,0,8,14,22,8,14,22,257,99,4,1,1,2.8,0.2,22.6,63.4831,5,1,10.819,3.181
Sri Lanka,244,223.373,7.09016,0.344262,227.578,7.47541,0.385246,HDRL Thirimanne,0,0,0,0,0,0,0,0,8,7,15,8,7,15,0,67,2,0,1,2.77778,0.246914,31.5802,71.4725,81,4,7.29478,-0.294781
Sri Lanka,244,223.373,7.09016,0.344262,227.578,7.47541,0.385246,TM Dilshan,0,0,0,0,0,0,0,0,16,10,26,16,10,26,220,222,9,0,1,4.60199,0.273632,38.3632,86.0219,201,4,7.98484,2.01516
Bangladesh,160,218.438,7.70625,0.4,211.106,7.05,0.325,Anamul Haque,0,0,0,0,0,0,0,0,12,7,19,12,7,19,0,265,3,1,1,4.12,0.24,36.8,69.6442,25,4,6.14827,0.851728
Bangladesh,160,218.438,7.70625,0.4,211.106,7.05,0.325,Mushfiqur Rahim,0,0,0,0,0,0,0,0,12,7,19,12,7,19,0,265,3,1,1,2.61111,0.18254,27.7778,75.2526,126,4,6.14827,0.851728
New Zealand,184,233.745,7.39674,0.36413,227.951,7.30435,0.353261,AP Devcich,0,0,0,0,0,0,0,0,12,4,16,12,4,16,266,162,0,0,1,3.125,0.125,22.125,73.444,8,1,7.12976,-3.12976
New Zealand,184,233.745,7.39674,0.36413,227.951,7.30435,0.353261,GD Elliott,0,0,0,0,0,0,0,0,12,4,16,12,4,16,266,162,0,0,1,2.67188,0.203125,29.4375,79.7629,64,4,7.12976,-3.12976
Bangladesh,160,218.438,7.70625,0.4,211.106,7.05,0.325,Tamim Iqbal,0,0,0,0,0,0,0,0,12,2,14,12,2,14,0,247,1,1,1,4.05344,0.274809,31.8015,76.8068,131,4,6.14827,-4.14827
Sri Lanka,244,223.373,7.09016,0.344262,227.578,7.47541,0.385246,KC Sangakkara,0,0,0,0,0,0,0,0,16,8,24,16,8,24,0,138,0,1,1,4.33659,0.360976,41.9854,80.6276,205,4,7.45349,0.546508
Sri Lanka,244,223.373,7.09016,0.344262,227.578,7.47541,0.385246,TM Dilshan,0,0,0,0,0,0,0,0,24,4,28,24,4,28,0,211,2,1,1,4.60199,0.273632,38.3632,86.0219,201,4,7.45349,-3.45349
South Africa,190,234.274,7.4,0.373684,232.363,7.33158,0.342105,HM Amla,0,0,0,0,0,0,0,0,12,8,20,12,8,20,219,195,1,1,1,5.20168,0.403361,48.7899,86.9292,119,4,7.76709,0.232906
Pakistan,211,222.621,7.38389,0.393365,235.517,7.54976,0.336493,Mohammad Hafeez,0,0,0,0,0,0,0,0,4,12,16,4,12,16,0,262,2,0,1,4.04511,0.255639,34.3534,78.0625,133,4,7.17136,4.82864
South Africa,190,234.274,7.4,0.373684,232.363,7.33158,0.342105,Q de Kock,0,0,0,0,0,0,0,0,4,5,9,4,5,9,263,261,0,1,1,5.12963,0.240741,39.1111,91.2311,54,4,7.47282,-2.47282
South Africa,190,234.274,7.4,0.373684,232.363,7.33158,0.342105,HM Amla,0,0,0,0,0,0,0,0,24,10,34,24,10,34,180,181,0,1,1,5.20168,0.403361,48.7899,86.9292,119,4,7.9397,2.0603
Sri Lanka,244,223.373,7.09016,0.344262,227.578,7.47541,0.385246,KC Sangakkara,0,0,0,0,0,0,0,0,14,11,25,14,11,25,0,180,2,0,1,4.33659,0.360976,41.9854,80.6276,205,4,7.29478,3.70522
Sri Lanka,244,223.373,7.09016,0.344262,227.578,7.47541,0.385246,TM Dilshan,0,0,0,0,0,0,0,0,16,9,25,16,9,25,0,289,0,0,1,4.60199,0.273632,38.3632,86.0219,201,4,7.29478,1.70522
Bangladesh,160,218.438,7.70625,0.4,211.106,7.05,0.325,Shamsur Rahman,0,0,0,0,0,0,0,0,0,6,6,0,6,6,290,228,1,1,1,3.55556,0.222222,29.5556,74.5098,9,4,6.9827,-0.982698
Sri Lanka,244,223.373,7.09016,0.344262,227.578,7.47541,0.385246,HDRL Thirimanne,0,0,0,0,0,0,0,0,12,9,21,12,9,21,241,246,2,0,1,2.77778,0.246914,31.5802,71.4725,81,4,8.63777,0.362229
Ireland,55,219.527,7.65455,0.290909,202.727,7.56364,0.4,PR Stirling,0,0,0,0,0,0,0,0,8,3,11,8,3,11,220,140,0,1,1,3.47826,0.173913,24.2174,88.1329,23,0,7.66942,-4.66942
India,259,242.378,7.15058,0.339768,244.568,7.12741,0.30888,S Dhawan,0,0,0,0,0,0,0,0,8,3,11,8,3,11,280,280,0,0,1,5.65217,0.362319,43.2174,88.9088,69,4,7.66219,-4.66219
India,259,242.378,7.15058,0.339768,244.568,7.12741,0.30888,RG Sharma,0,0,0,0,0,0,0,0,22,6,28,22,6,28,0,245,2,0,1,3.82836,0.268657,35.9179,83.083,134,4,8.02085,-2.02085
Bangladesh,160,218.438,7.70625,0.4,211.106,7.05,0.325,Shamsur Rahman,0,0,0,0,0,0,0,0,8,8,16,8,8,16,0,204,0,1,1,3.55556,0.222222,29.5556,74.5098,9,4,6.14827,1.85173
Sri Lanka,244,223.373,7.09016,0.344262,227.578,7.47541,0.385246,MDKJ Perera,0,0,0,0,0,0,0,0,8,7,15,8,7,15,205,208,1,0,1,3.30435,0.195652,25.7391,90.5199,46,0,8.22192,-1.22192
Pakistan,211,222.621,7.38389,0.393365,235.517,7.54976,0.336493,Sharjeel Khan,0,0,0,0,0,0,0,0,12,5,17,12,5,17,0,260,1,0,1,2.6,0.1,16.9,81.25,10,1,7.44224,-2.44224
South Africa,190,234.274,7.4,0.373684,232.363,7.33158,0.342105,RR Rossouw,0,0,0,0,0,0,0,0,12,5,17,12,5,17,0,279,3,1,1,3.80769,0.230769,31.3846,93.1507,26,0,7.23992,-2.23992
West Indies,176,217.33,7.15909,0.3125,225.278,7.57386,0.380682,CH Gayle,0,0,0,0,0,0,0,0,28,14,42,28,14,42,280,164,1,0,1,4.58621,0.206897,31.1293,89.4255,116,4,6.96728,7.03272
West Indies,176,217.33,7.15909,0.3125,225.278,7.57386,0.380682,N Deonarine,0,0,0,0,0,0,0,0,12,2,14,12,2,14,0,122,4,0,1,2.09091,0.136364,20.9545,65.7632,22,1,6.30204,-4.30204
South Africa,190,234.274,7.4,0.373684,232.363,7.33158,0.342105,RR Rossouw,0,0,0,0,0,0,0,0,20,1,21,20,1,21,0,262,6,1,1,3.80769,0.230769,31.3846,93.1507,26,0,7.23992,-6.23992
South Africa,190,234.274,7.4,0.373684,232.363,7.33158,0.342105,F du Plessis,0,0,0,0,0,0,0,0,16,4,20,16,4,20,0,361,3,1,1,3.45122,0.292683,34.9268,83.135,82,4,7.50981,-3.50981
West Indies,176,217.33,7.15909,0.3125,225.278,7.57386,0.380682,CH Gayle,0,0,0,0,0,0,0,0,22,7,29,22,7,29,362,230,3,0,1,4.58621,0.206897,31.1293,89.4255,116,4,10.7312,-3.73117
Pakistan,211,222.621,7.38389,0.393365,235.517,7.54976,0.336493,Sarfraz Ahmed,0,0,0,0,0,0,0,0,4,13,17,4,13,17,232,230,1,0,1,2.04878,0.097561,25.4878,83.9357,41,4,8.94451,4.05549
Sri Lanka,244,223.373,7.09016,0.344262,227.578,7.47541,0.385246,MDKJ Perera,0,0,0,0,0,0,0,0,16,8,24,16,8,24,305,229,1,1,1,3.30435,0.195652,25.7391,90.5199,46,0,6.96253,1.03747
Sri Lanka,244,223.373,7.09016,0.344262,227.578,7.47541,0.385246,TM Dilshan,0,0,0,0,0,0,0,0,24,13,37,24,13,37,0,267,1,1,1,4.60199,0.273632,38.3632,86.0219,201,4,7.45349,5.54651
South Africa,190,234.274,7.4,0.373684,232.363,7.33158,0.342105,AB de Villiers,0,0,0,0,0,0,0,0,20,5,25,20,5,25,268,180,1,0,1,5.04969,0.403727,47.2174,98.8428,161,4,8.11927,-3.11927
Bangladesh,160,218.438,7.70625,0.4,211.106,7.05,0.325,Tamim Iqbal,0,0,0,0,0,0,0,0,0,15,15,0,15,15,0,217,1,0,1,4.05344,0.274809,31.8015,76.8068,131,4,8.00813,6.99187
West Indies,176,217.33,7.15909,0.3125,225.278,7.57386,0.380682,KA Edwards,0,0,0,0,0,0,0,0,0,8,8,0,8,8,218,219,0,1,1,1.875,0.0625,20.6875,64.902,16,1,5.75801,2.24199
West Indies,176,217.33,7.15909,0.3125,225.278,7.57386,0.380682,CH Gayle,0,0,0,0,0,0,0,0,10,2,12,10,2,12,0,247,1,1,1,4.58621,0.206897,31.1293,89.4255,116,4,6.4592,-4.4592
West Indies,176,217.33,7.15909,0.3125,225.278,7.57386,0.380682,DM Bravo,0,0,0,0,0,0,0,0,10,2,12,10,2,12,0,247,1,1,1,3,0.226667,28.52,67.4551,75,4,6.4592,-4.4592
Bangladesh,160,218.438,7.70625,0.4,211.106,7.05,0.325,Tamim Iqbal,0,0,0,0,0,0,0,0,6,5,11,6,5,11,248,70,1,0,1,4.05344,0.274809,31.8015,76.8068,131,4,7.27933,-2.27933
Bangladesh,160,218.438,7.70625,0.4,211.106,7.05,0.325,Imrul Kayes,0,0,0,0,0,0,0,0,6,5,11,6,5,11,248,70,1,0,1,3,0.207547,26.2642,63.6488,53,4,7.27933,-2.27933
Bangladesh,160,218.438,7.70625,0.4,211.106,7.05,0.325,Tamim Iqbal,0,0,0,0,0,0,0,0,8,7,15,8,7,15,339,247,0,0,1,4.05344,0.274809,31.8015,76.8068,131,4,6.66841,0.33159
Bangladesh,160,218.438,7.70625,0.4,211.106,7.05,0.325,Anamul Haque,0,0,0,0,0,0,0,0,8,7,15,8,7,15,339,247,0,0,1,4.12,0.24,36.8,69.6442,25,4,6.66841,0.33159
South Africa,190,234.274,7.4,0.373684,232.363,7.33158,0.342105,Q de Kock,0,0,0,0,0,0,0,0,12,7,19,12,7,19,0,309,0,0,1,5.12963,0.240741,39.1111,91.2311,54,4,7.75548,-0.755482
Zimbabwe,142,212.077,7.5,0.380282,227.704,6.97887,0.316901,R Mutumbami,0,0,0,0,0,0,0,0,4,8,12,4,8,12,258,196,2,1,1,1.93333,0.0666667,15.4667,69.8795,15,1,7.91462,0.0853753
Australia,228,239.627,7.69737,0.372807,232.079,7.23246,0.337719,PJ Hughes,0,0,0,0,0,0,0,0,12,14,26,12,14,26,0,327,1,0,1,4.52381,0.285714,38.7619,74.7475,21,4,7.75388,6.24612
Zimbabwe,142,212.077,7.5,0.380282,227.704,6.97887,0.316901,Sikandar Raza,0,0,0,0,0,0,0,0,4,5,9,4,5,9,210,211,0,1,1,3,0.131579,26.1842,81.1582,38,4,6.33557,-1.33557
South Africa,190,234.274,7.4,0.373684,232.363,7.33158,0.342105,HM Amla,0,0,0,0,0,0,0,0,8,8,16,8,8,16,283,220,5,0,1,5.20168,0.403361,48.7899,86.9292,119,4,7.8536,0.146398
South Africa,190,234.274,7.4,0.373684,232.363,7.33158,0.342105,F du Plessis,0,0,0,0,0,0,0,0,8,8,16,8,8,16,283,220,5,0,1,3.45122,0.292683,34.9268,83.135,82,4,7.8536,0.146398
Zimbabwe,142,212.077,7.5,0.380282,227.704,6.97887,0.316901,V Sibanda,0,0,0,0,0,0,0,0,8,12,20,8,12,20,272,208,1,1,1,2.9697,0.181818,23.5152,63.5545,66,1,6.85686,5.14314
Australia,228,239.627,7.69737,0.372807,232.079,7.23246,0.337719,SPD Smith,0,0,0,0,0,0,0,0,16,11,27,16,11,27,0,217,3,0,1,3.19298,0.22807,34.5614,87.0526,57,4,7.75388,3.24612
New Zealand,184,233.745,7.39674,0.36413,227.951,7.30435,0.353261,DG Brownlie,0,0,0,0,0,0,0,0,12,6,18,12,6,18,253,255,4,0,1,3,0,22.5556,72.5,9,1,7.38032,-1.38032
New Zealand,184,233.745,7.39674,0.36413,227.951,7.30435,0.353261,MJ Guptill,0,0,0,0,0,0,0,0,8,10,18,8,10,18,0,299,1,0,1,4.8087,0.313043,38.1217,82.7482,115,4,7.05619,2.94381
Pakistan,211,222.621,7.38389,0.393365,235.517,7.54976,0.336493,Ahmed Shehzad,0,0,0,0,0,0,0,0,8,10,18,8,10,18,300,292,0,0,1,3.67143,0.242857,33.2714,70.8118,70,4,7.96893,2.03107
Pakistan,211,222.621,7.38389,0.393365,235.517,7.54976,0.336493,Younis Khan,0,0,0,0,0,0,0,0,8,10,18,8,10,18,300,292,0,0,1,2.64655,0.215517,28.5,73.2713,116,4,7.96893,2.03107
New Zealand,184,233.745,7.39674,0.36413,227.951,7.30435,0.353261,KS Williamson,0,0,0,0,0,0,0,0,20,9,29,20,9,29,0,275,1,0,1,4.31707,0.390244,43.0488,82.8833,82,4,7.05619,1.94381
England,221,237.176,7.17647,0.289593,230.633,7.45701,0.384615,JE Root,0,0,0,0,0,0,0,0,20,15,35,20,15,35,0,408,0,1,1,3.68852,0.327869,41.6721,83.3443,61,4,7.9139,7.0861
England,221,237.176,7.17647,0.289593,230.633,7.45701,0.384615,AD Hales,0,0,0,0,0,0,0,0,20,15,35,20,15,35,0,408,0,1,1,4.2963,0.296296,34.1111,85.1201,27,4,7.9139,7.0861
England,221,237.176,7.17647,0.289593,230.633,7.45701,0.384615,AD Hales,0,0,0,0,0,0,0,0,16,10,26,16,10,26,0,302,2,1,1,4.2963,0.296296,34.1111,85.1201,27,4,7.9139,2.0861
New Zealand,184,233.745,7.39674,0.36413,227.951,7.30435,0.353261,BB McCullum,0,0,0,0,0,0,0,0,8,16,24,8,16,24,0,349,1,0,1,3.98611,0.201389,29.9028,98.4004,144,0,7.22414,8.77586
England,221,237.176,7.17647,0.289593,230.633,7.45701,0.384615,JJ Roy,0,0,0,0,0,0,0,0,8,9,17,8,9,17,284,192,6,1,1,4.36842,0.210526,29.3684,95.3846,19,0,7.73338,1.26662
Ireland,55,219.527,7.65455,0.290909,202.727,7.56364,0.4,WTS Porterfield,0,0,0,0,0,0,0,0,12,10,22,12,10,22,223,157,2,1,1,2.6,0.142857,24.6857,56.2866,35,3,7.15528,2.84472
Ireland,55,219.527,7.65455,0.290909,202.727,7.56364,0.4,NJ O'Brien,0,0,0,0,0,0,0,0,12,10,22,12,10,22,223,157,2,1,1,2.55882,0.176471,25.5882,69.378,34,4,7.15528,2.84472
England,221,237.176,7.17647,0.289593,230.633,7.45701,0.384615,AD Hales,0,0,0,0,0,0,0,0,30,5,35,30,5,35,306,246,0,1,1,4.2963,0.296296,34.1111,85.1201,27,4,7.69462,-2.69462
Australia,228,239.627,7.69737,0.372807,232.079,7.23246,0.337719,JA Burns,0,0,0,0,0,0,0,0,4,5,9,4,5,9,139,140,4,0,1,2.83333,0.166667,24.3333,77.2487,6,4,8,-3
India,259,242.378,7.15058,0.339768,244.568,7.12741,0.30888,AM Rahane,0,0,0,0,0,0,0,0,12,11,23,12,11,23,273,153,2,0,1,3.55738,0.262295,32.2295,78.0159,61,4,7.66219,3.33781
Pakistan,211,222.621,7.38389,0.393365,235.517,7.54976,0.336493,Sharjeel Khan,0,0,0,0,0,0,0,0,0,4,4,0,4,4,0,102,2,0,1,2.6,0.1,16.9,81.25,10,1,7.44224,-3.44224
Sri Lanka,244,223.373,7.09016,0.344262,227.578,7.47541,0.385246,WU Tharanga,0,0,0,0,0,0,0,0,24,7,31,24,7,31,103,104,3,1,1,3.93985,0.263158,32.9699,71.6035,133,4,7.6405,-0.640496
Sri Lanka,244,223.373,7.09016,0.344262,227.578,7.47541,0.385246,TM Dilshan,0,0,0,0,0,0,0,0,24,7,31,24,7,31,103,104,3,1,1,4.60199,0.273632,38.3632,86.0219,201,4,7.6405,-0.640496
New Zealand,184,233.745,7.39674,0.36413,227.951,7.30435,0.353261,MJ Guptill,0,0,0,0,0,0,0,0,12,5,17,12,5,17,0,230,3,1,1,4.8087,0.313043,38.1217,82.7482,115,4,7.05259,-2.05259
New Zealand,184,233.745,7.39674,0.36413,227.951,7.30435,0.353261,JDS Neesham,0,0,0,0,0,0,0,0,12,5,17,12,5,17,0,230,3,1,1,1.75,0,14.875,93.7008,16,0,6.81018,-1.81018
New Zealand,184,233.745,7.39674,0.36413,227.951,7.30435,0.353261,KS Williamson,0,0,0,0,0,0,0,0,32,12,44,32,12,44,219,219,4,1,1,4.31707,0.390244,43.0488,82.8833,82,4,7.59315,4.40685
New Zealand,184,233.745,7.39674,0.36413,227.951,7.30435,0.353261,BB McCullum,0,0,0,0,0,0,0,0,16,12,28,16,12,28,0,248,0,1,1,3.98611,0.201389,29.9028,98.4004,144,0,6.81018,5.18982
New Zealand,184,233.745,7.39674,0.36413,227.951,7.30435,0.353261,MJ Guptill,0,0,0,0,0,0,0,0,12,13,25,12,13,25,277,280,1,1,1,4.8087,0.313043,38.1217,82.7482,115,4,7.55801,5.44199
New Zealand,184,233.745,7.39674,0.36413,227.951,7.30435,0.353261,BB McCullum,0,0,0,0,0,0,0,0,12,13,25,12,13,25,277,280,1,1,1,3.98611,0.201389,29.9028,98.4004,144,0,7.14779,5.85221
Sri Lanka,244,223.373,7.09016,0.344262,227.578,7.47541,0.385246,TM Dilshan,0,0,0,0,0,0,0,0,8,9,17,8,9,17,361,252,5,0,1,4.60199,0.273632,38.3632,86.0219,201,4,9.73572,-0.735723
Sri Lanka,244,223.373,7.09016,0.344262,227.578,7.47541,0.385246,HDRL Thirimanne,0,0,0,0,0,0,0,0,12,8,20,12,8,20,316,195,1,0,1,2.77778,0.246914,31.5802,71.4725,81,4,7.35185,0.648148
New Zealand,184,233.745,7.39674,0.36413,227.951,7.30435,0.353261,BB McCullum,0,0,0,0,0,0,0,0,18,10,28,18,10,28,0,369,2,1,1,3.98611,0.201389,29.9028,98.4004,144,0,6.81018,3.18982
Sri Lanka,244,223.373,7.09016,0.344262,227.578,7.47541,0.385246,MDKJ Perera,0,0,0,0,0,0,0,0,16,9,25,16,9,25,0,317,1,1,1,3.30435,0.195652,25.7391,90.5199,46,0,7.45349,1.54651
England,221,237.176,7.17647,0.289593,230.633,7.45701,0.384615,JWA Taylor,0,0,0,0,0,0,0,0,4,9,13,4,9,13,0,265,1,0,1,3.375,0.333333,35.9167,79.8888,24,4,7.75548,1.24452
Sri Lanka,244,223.373,7.09016,0.344262,227.578,7.47541,0.385246,TM Dilshan,0,0,0,0,0,0,0,0,20,6,26,20,6,26,266,267,2,1,1,4.60199,0.273632,38.3632,86.0219,201,4,7.63536,-1.63536
England,221,237.176,7.17647,0.289593,230.633,7.45701,0.384615,JWA Taylor,0,0,0,0,0,0,0,0,18,7,25,18,7,25,240,240,0,0,1,3.375,0.333333,35.9167,79.8888,24,4,8.99032,-1.99032
Australia,228,239.627,7.69737,0.372807,232.079,7.23246,0.337719,AJ Finch,0,0,0,0,0,0,0,0,0,10,10,0,10,10,0,300,2,1,1,4.52941,0.313725,37.2549,83.4431,51,4,8.22214,1.77786
South Africa,190,234.274,7.4,0.373684,232.363,7.33158,0.342105,HM Amla,0,0,0,0,0,0,0,0,12,6,18,12,6,18,155,157,2,0,1,5.20168,0.403361,48.7899,86.9292,119,4,9.17507,-3.17507
South Africa,190,234.274,7.4,0.373684,232.363,7.33158,0.342105,HM Amla,0,0,0,0,0,0,0,0,12,10,22,12,10,22,0,267,5,0,1,5.20168,0.403361,48.7899,86.9292,119,4,7.75548,2.24452
Australia,228,239.627,7.69737,0.372807,232.079,7.23246,0.337719,AJ Finch,0,0,0,0,0,0,0,0,4,11,15,4,11,15,268,268,0,1,1,4.52941,0.313725,37.2549,83.4431,51,4,8.53635,2.46365
Australia,228,239.627,7.69737,0.372807,232.079,7.23246,0.337719,DA Warner,0,0,0,0,0,0,0,0,26,10,36,26,10,36,281,275,1,1,1,4.20312,0.265625,35.2031,87.7336,64,4,9.4603,0.539704
England,221,237.176,7.17647,0.289593,230.633,7.45701,0.384615,IR Bell,0,0,0,0,0,0,0,0,8,5,13,8,5,13,0,234,2,0,1,3.63433,0.246269,35.3806,75.6623,134,4,7.75548,-2.75548
England,221,237.176,7.17647,0.289593,230.633,7.45701,0.384615,JE Root,0,0,0,0,0,0,0,0,8,5,13,8,5,13,0,234,2,0,1,3.68852,0.327869,41.6721,83.3443,61,4,7.75548,-2.75548
Australia,228,239.627,7.69737,0.372807,232.079,7.23246,0.337719,DA Warner,0,0,0,0,0,0,0,0,16,8,24,16,8,24,235,235,0,1,1,4.20312,0.265625,35.2031,87.7336,64,4,8.62946,-0.629457
India,259,242.378,7.15058,0.339768,244.568,7.12741,0.30888,AM Rahane,0,0,0,0,0,0,0,0,0,6,6,0,6,6,0,153,2,0,1,3.55738,0.262295,32.2295,78.0159,61,4,8.02085,-2.02085
India,259,242.378,7.15058,0.339768,244.568,7.12741,0.30888,S Dhawan,0,0,0,0,0,0,0,0,0,6,6,0,6,6,0,153,2,0,1,5.65217,0.362319,43.2174,88.9088,69,4,8.02085,-2.02085
England,221,237.176,7.17647,0.289593,230.633,7.45701,0.384615,MM Ali,0,0,0,0,0,0,0,0,12,17,29,12,17,29,154,156,2,0,1,2.67647,0.117647,21.3824,94.5384,34,0,8.57447,8.42553
Australia,228,239.627,7.69737,0.372807,232.079,7.23246,0.337719,AJ Finch,0,0,0,0,0,0,0,0,28,8,36,28,8,36,304,304,3,1,1,4.52941,0.313725,37.2549,83.4431,51,4,8.47193,-0.471931
England,221,237.176,7.17647,0.289593,230.633,7.45701,0.384615,JWA Taylor,0,0,0,0,0,0,0,0,8,6,14,8,6,14,201,201,2,0,1,3.375,0.333333,35.9167,79.8888,24,4,8.33739,-2.33739
Australia,228,239.627,7.69737,0.372807,232.079,7.23246,0.337719,SPD Smith,0,0,0,0,0,0,0,0,16,9,25,16,9,25,0,278,0,1,1,3.19298,0.22807,34.5614,87.0526,57,4,8.22214,0.777863
Bangladesh,160,218.438,7.70625,0.4,211.106,7.05,0.325,Tamim Iqbal,0,0,0,0,0,0,0,0,4,4,8,4,4,8,0,281,0,1,1,4.05344,0.274809,31.8015,76.8068,131,4,6.14827,-2.14827
Bangladesh,160,218.438,7.70625,0.4,211.106,7.05,0.325,Mominul Haque,0,0,0,0,0,0,0,0,4,4,8,4,4,8,0,281,0,1,1,2.57143,0.0952381,23.3333,73.4633,21,4,6.14827,-2.14827
Bangladesh,160,218.438,7.70625,0.4,211.106,7.05,0.325,Tamim Iqbal,0,0,0,0,0,0,0,0,10,5,15,10,5,15,0,297,4,1,1,4.05344,0.274809,31.8015,76.8068,131,4,6.14827,-1.14827
Bangladesh,160,218.438,7.70625,0.4,211.106,7.05,0.325,Anamul Haque,0,0,0,0,0,0,0,0,8,6,14,8,6,14,0,256,4,1,1,4.12,0.24,36.8,69.6442,25,4,6.14827,-0.148272
Zimbabwe,142,212.077,7.5,0.380282,227.704,6.97887,0.316901,H Masakadza,0,0,0,0,0,0,0,0,16,7,23,16,7,23,257,235,3,0,1,3.11215,0.186916,26.972,70.0485,107,4,8.56603,-1.56603
Zimbabwe,142,212.077,7.5,0.380282,227.704,6.97887,0.316901,V Sibanda,0,0,0,0,0,0,0,0,12,5,17,12,5,17,0,128,1,0,1,2.9697,0.181818,23.5152,63.5545,66,1,6.3628,-1.3628
West Indies,176,217.33,7.15909,0.3125,225.278,7.57386,0.380682,DR Smith,0,0,0,0,0,0,0,0,12,4,16,12,4,16,0,321,3,0,1,2.5,0.12,17.96,84.5574,50,1,6.30204,-2.30204
India,259,242.378,7.15058,0.339768,244.568,7.12741,0.30888,AM Rahane,0,0,0,0,0,0,0,0,8,10,18,8,10,18,0,330,2,1,1,3.55738,0.262295,32.2295,78.0159,61,4,7.08899,2.91101
Sri Lanka,244,223.373,7.09016,0.344262,227.578,7.47541,0.385246,TM Dilshan,0,0,0,0,0,0,0,0,8,7,15,8,7,15,0,274,6,0,1,4.60199,0.273632,38.3632,86.0219,201,4,7.29478,-0.294781
India,259,242.378,7.15058,0.339768,244.568,7.12741,0.30888,RG Sharma,0,0,0,0,0,0,0,0,16,8,24,16,8,24,0,404,0,1,1,3.82836,0.268657,35.9179,83.083,134,4,7.08899,0.911011
Sri Lanka,244,223.373,7.09016,0.344262,227.578,7.47541,0.385246,LD Chandimal,0,0,0,0,0,0,0,0,20,4,24,20,4,24,405,251,1,0,1,2.18478,0.184783,25.7391,73.8615,92,4,5.08426,-1.08426
India,259,242.378,7.15058,0.339768,244.568,7.12741,0.30888,RG Sharma,0,0,0,0,0,0,0,0,8,5,13,8,5,13,287,288,1,1,1,3.82836,0.268657,35.9179,83.083,134,4,7.48586,-2.48586
South Africa,190,234.274,7.4,0.373684,232.363,7.33158,0.342105,HM Amla,0,0,0,0,0,0,0,0,8,2,10,8,2,10,0,262,0,1,1,5.20168,0.403361,48.7899,86.9292,119,4,7.50981,-5.50981
England,221,237.176,7.17647,0.289593,230.633,7.45701,0.384615,JJ Roy,0,0,0,0,0,0,0,0,12,5,17,12,5,17,0,262,1,0,1,4.36842,0.210526,29.3684,95.3846,19,0,8.09504,-3.09504
South Africa,190,234.274,7.4,0.373684,232.363,7.33158,0.342105,Q de Kock,0,0,0,0,0,0,0,0,8,4,12,8,4,12,0,162,5,0,1,5.12963,0.240741,39.1111,91.2311,54,4,7.75548,-3.75548
Bangladesh,160,218.438,7.70625,0.4,211.106,7.05,0.325,Liton Das,0,0,0,0,0,0,0,0,26,6,32,26,6,32,163,167,1,1,1,1,0,7.66667,69.697,6,1,8.35335,-2.35335
South Africa,190,234.274,7.4,0.373684,232.363,7.33158,0.342105,Q de Kock,0,0,0,0,0,0,0,0,8,9,17,8,9,17,0,168,0,0,1,5.12963,0.240741,39.1111,91.2311,54,4,7.75548,1.24452
South Africa,190,234.274,7.4,0.373684,232.363,7.33158,0.342105,MN van Wyk,0,0,0,0,0,0,0,0,14,7,21,14,7,21,0,304,4,1,1,3.33333,0.266667,27.2,66.9951,15,4,7.50981,-0.509812
South Africa,190,234.274,7.4,0.373684,232.363,7.33158,0.342105,HM Amla,0,0,0,0,0,0,0,0,14,7,21,14,7,21,0,304,4,1,1,5.20168,0.403361,48.7899,86.9292,119,4,7.50981,-0.509812
South Africa,190,234.274,7.4,0.373684,232.363,7.33158,0.342105,MN van Wyk,0,0,0,0,0,0,0,0,16,4,20,16,4,20,0,204,0,1,1,3.33333,0.266667,27.2,66.9951,15,4,7.50981,-3.50981
South Africa,190,234.274,7.4,0.373684,232.363,7.33158,0.342105,RR Rossouw,0,0,0,0,0,0,0,0,16,4,20,16,4,20,0,204,0,1,1,3.80769,0.230769,31.3846,93.1507,26,0,7.23992,-3.23992
New Zealand,184,233.745,7.39674,0.36413,227.951,7.30435,0.353261,MJ Guptill,0,0,0,0,0,0,0,0,8,9,17,8,9,17,284,221,1,0,1,4.8087,0.313043,38.1217,82.7482,115,4,7.55801,1.44199
Pakistan,211,222.621,7.38389,0.393365,235.517,7.54976,0.336493,Sarfraz Ahmed,0,0,0,0,0,0,0,0,8,10,18,8,10,18,0,239,2,0,1,2.04878,0.097561,25.4878,83.9357,41,4,7.17136,2.82864
Bangladesh,160,218.438,7.70625,0.4,211.106,7.05,0.325,Tamim Iqbal,0,0,0,0,0,0,0,0,36,1,37,36,1,37,240,240,1,1,1,4.05344,0.274809,31.8015,76.8068,131,4,4.79792,-3.79792
Bangladesh,160,218.438,7.70625,0.4,211.106,7.05,0.325,Tamim Iqbal,0,0,0,0,0,0,0,0,16,5,21,16,5,21,251,251,2,1,1,4.05344,0.274809,31.8015,76.8068,131,4,7.16589,-2.16589
Pakistan,211,222.621,7.38389,0.393365,235.517,7.54976,0.336493,Ahmed Shehzad,0,0,0,0,0,0,0,0,16,8,24,16,8,24,256,259,0,0,1,3.67143,0.242857,33.2714,70.8118,70,4,8.89766,-0.897659
Pakistan,211,222.621,7.38389,0.393365,235.517,7.54976,0.336493,Azhar Ali,0,0,0,0,0,0,0,0,0,11,11,0,11,11,0,287,5,0,1,3.83333,0.3,38.5333,73.6775,30,4,7.17136,3.82864
Sri Lanka,244,223.373,7.09016,0.344262,227.578,7.47541,0.385246,MDKJ Perera,0,0,0,0,0,0,0,0,58,5,63,58,5,63,288,288,2,1,1,3.30435,0.195652,25.7391,90.5199,46,0,7.65338,-2.65338
Pakistan,211,222.621,7.38389,0.393365,235.517,7.54976,0.336493,Ahmed Shehzad,0,0,0,0,0,0,0,0,0,13,13,0,13,13,0,316,4,0,1,3.67143,0.242857,33.2714,70.8118,70,4,7.17136,5.82864
Sri Lanka,244,223.373,7.09016,0.344262,227.578,7.47541,0.385246,TM Dilshan,0,0,0,0,0,0,0,0,12,10,22,12,10,22,0,368,0,1,1,4.60199,0.273632,38.3632,86.0219,201,4,7.45349,2.54651
Pakistan,211,222.621,7.38389,0.393365,235.517,7.54976,0.336493,Azhar Ali,0,0,0,0,0,0,0,0,4,10,14,4,10,14,369,203,3,0,1,3.83333,0.3,38.5333,73.6775,30,4,11.3911,-1.39113
Zimbabwe,142,212.077,7.5,0.380282,227.704,6.97887,0.316901,CJ Chibhabha,0,0,0,0,0,0,0,0,8,5,13,8,5,13,0,268,2,0,1,2.56716,0.149254,23.5373,64.7373,67,1,6.3628,-1.3628
Bangladesh,160,218.438,7.70625,0.4,211.106,7.05,0.325,Tamim Iqbal,0,0,0,0,0,0,0,0,8,17,25,8,17,25,0,307,2,1,1,4.05344,0.274809,31.8015,76.8068,131,4,6.14827,10.8517
India,259,242.378,7.15058,0.339768,244.568,7.12741,0.30888,RG Sharma,0,0,0,0,0,0,0,0,4,15,19,4,15,19,308,228,9,0,1,3.82836,0.268657,35.9179,83.083,134,4,8.76484,6.23516
India,259,242.378,7.15058,0.339768,244.568,7.12741,0.30888,S Dhawan,0,0,0,0,0,0,0,0,4,15,19,4,15,19,308,228,9,0,1,5.65217,0.362319,43.2174,88.9088,69,4,8.76484,6.23516
India,259,242.378,7.15058,0.339768,244.568,7.12741,0.30888,S Dhawan,0,0,0,0,0,0,0,0,16,7,23,16,7,23,0,200,5,0,1,5.65217,0.362319,43.2174,88.9088,69,4,8.02085,-1.02085
India,259,242.378,7.15058,0.339768,244.568,7.12741,0.30888,RG Sharma,0,0,0,0,0,0,0,0,8,16,24,8,16,24,0,317,2,0,1,3.82836,0.268657,35.9179,83.083,134,4,8.02085,7.97915
Bangladesh,160,218.438,7.70625,0.4,211.106,7.05,0.325,Litton Das,0,0,0,0,0,0,0,0,22,7,29,22,7,29,318,240,5,1,1,2.66667,0,25.3333,72.381,3,4,7.25964,-0.259643
India,259,242.378,7.15058,0.339768,244.568,7.12741,0.30888,AM Rahane,0,0,0,0,0,0,0,0,8,8,16,8,8,16,0,271,1,0,1,3.55738,0.262295,32.2295,78.0159,61,4,8.02085,-0.020853
Zimbabwe,142,212.077,7.5,0.380282,227.704,6.97887,0.316901,CR Ervine,0,0,0,0,0,0,0,0,12,3,15,12,3,15,0,235,0,1,1,3.06667,0.2,30.5333,73.9903,30,4,6.39467,-3.39467
Australia,228,239.627,7.69737,0.372807,232.079,7.23246,0.337719,DA Warner,0,0,0,0,0,0,0,0,8,11,19,8,11,19,310,310,2,1,1,4.20312,0.265625,35.2031,87.7336,64,4,8.47193,2.52807
Australia,228,239.627,7.69737,0.372807,232.079,7.23246,0.337719,GJ Bailey,0,0,0,0,0,0,0,0,8,11,19,8,11,19,310,310,2,1,1,3.34921,0.301587,36.3492,84.658,63,4,8.47193,2.52807
India,259,242.378,7.15058,0.339768,244.568,7.12741,0.30888,V Kohli,0,0,0,0,0,0,0,0,8,7,15,8,7,15,0,295,1,0,1,4.66456,0.379747,44.9937,88.3325,158,4,8.02085,-1.02085
Australia,228,239.627,7.69737,0.372807,232.079,7.23246,0.337719,AJ Finch,0,0,0,0,0,0,0,0,32,8,40,32,8,40,0,348,0,1,1,4.52941,0.313725,37.2549,83.4431,51,4,8.22214,-0.222137
India,259,242.378,7.15058,0.339768,244.568,7.12741,0.30888,RG Sharma,0,0,0,0,0,0,0,0,14,16,30,14,16,30,349,323,0,0,1,3.82836,0.268657,35.9179,83.083,134,4,9.69218,6.30782
Australia,228,239.627,7.69737,0.372807,232.079,7.23246,0.337719,AJ Finch,0,0,0,0,0,0,0,0,12,16,28,12,16,28,0,330,2,1,1,4.52941,0.313725,37.2549,83.4431,51,4,8.22214,7.77786
Australia,228,239.627,7.69737,0.372807,232.079,7.23246,0.337719,SPD Smith,0,0,0,0,0,0,0,0,12,16,28,12,16,28,0,330,2,1,1,3.19298,0.22807,34.5614,87.0526,57,4,8.22214,7.77786
England,221,237.176,7.17647,0.289593,230.633,7.45701,0.384615,JWA Taylor,0,0,0,0,0,0,0,0,12,7,19,12,7,19,0,216,0,0,1,3.375,0.333333,35.9167,79.8888,24,4,7.75548,-0.755482
Pakistan,211,222.621,7.38389,0.393365,235.517,7.54976,0.336493,Bilal Asif,0,0,0,0,0,0,0,0,16,4,20,16,4,20,217,217,3,0,1,2.33333,0,13.3333,76.9231,3,1,7.29199,-3.29199
England,221,237.176,7.17647,0.289593,230.633,7.45701,0.384615,JJ Roy,0,0,0,0,0,0,0,0,12,6,18,12,6,18,0,283,0,0,1,4.36842,0.210526,29.3684,95.3846,19,0,8.09504,-2.09504
Pakistan,211,222.621,7.38389,0.393365,235.517,7.54976,0.336493,Azhar Ali,0,0,0,0,0,0,0,0,0,8,8,0,8,8,284,188,2,0,1,3.83333,0.3,38.5333,73.6775,30,4,7.18167,0.818334
Pakistan,211,222.621,7.38389,0.393365,235.517,7.54976,0.336493,Azhar Ali,0,0,0,0,0,0,0,0,4,10,14,4,10,14,0,208,1,0,1,3.83333,0.3,38.5333,73.6775,30,4,7.17136,2.82864
England,221,237.176,7.17647,0.289593,230.633,7.45701,0.384615,AD Hales,0,0,0,0,0,0,0,0,12,11,23,12,11,23,209,210,0,0,1,4.2963,0.296296,34.1111,85.1201,27,4,8.33739,2.66261
England,221,237.176,7.17647,0.289593,230.633,7.45701,0.384615,JJ Roy,0,0,0,0,0,0,0,0,4,17,21,4,17,21,0,355,3,0,1,4.36842,0.210526,29.3684,95.3846,19,0,8.09504,8.90496
India,259,242.378,7.15058,0.339768,244.568,7.12741,0.30888,RG Sharma,0,0,0,0,0,0,0,0,20,5,25,20,5,25,304,298,1,1,1,3.82836,0.268657,35.9179,83.083,134,4,7.88094,-2.88094
India,259,242.378,7.15058,0.339768,244.568,7.12741,0.30888,S Dhawan,0,0,0,0,0,0,0,0,16,13,29,16,13,29,0,299,0,1,1,5.65217,0.362319,43.2174,88.9088,69,4,7.08899,5.91101
South Africa,190,234.274,7.4,0.373684,232.363,7.33158,0.342105,HM Amla,0,0,0,0,0,0,0,0,16,16,32,16,16,32,300,264,4,0,1,5.20168,0.403361,48.7899,86.9292,119,4,9.2114,6.7886
South Africa,190,234.274,7.4,0.373684,232.363,7.33158,0.342105,Q de Kock,0,0,0,0,0,0,0,0,36,7,43,36,7,43,0,438,1,0,1,5.12963,0.240741,39.1111,91.2311,54,4,7.75548,-0.755482
Sri Lanka,244,223.373,7.09016,0.344262,227.578,7.47541,0.385246,TM Dilshan,0,0,0,0,0,0,0,0,8,10,18,8,10,18,0,188,2,0,1,4.60199,0.273632,38.3632,86.0219,201,4,7.29478,2.70522
Sri Lanka,244,223.373,7.09016,0.344262,227.578,7.47541,0.385246,TM Dilshan,0,0,0,0,0,0,0,0,16,9,25,16,9,25,295,258,1,0,1,4.60199,0.273632,38.3632,86.0219,201,4,8.0636,0.9364
Sri Lanka,244,223.373,7.09016,0.344262,227.578,7.47541,0.385246,LD Chandimal,0,0,0,0,0,0,0,0,16,9,25,16,9,25,295,258,1,0,1,2.18478,0.184783,25.7391,73.8615,92,4,8.0636,0.9364
New Zealand,184,233.745,7.39674,0.36413,227.951,7.30435,0.353261,BB McCullum,0,0,0,0,0,0,0,0,26,2,28,26,2,28,0,307,0,1,1,3.98611,0.201389,29.9028,98.4004,144,0,6.81018,-4.81018
Australia,228,239.627,7.69737,0.372807,232.079,7.23246,0.337719,DA Warner,0,0,0,0,0,0,0,0,16,11,27,16,11,27,308,148,2,0,1,4.20312,0.265625,35.2031,87.7336,64,4,8.74127,2.25873
New Zealand,184,233.745,7.39674,0.36413,227.951,7.30435,0.353261,MJ Guptill,0,0,0,0,0,0,0,0,26,8,34,26,8,34,0,281,2,1,1,4.8087,0.313043,38.1217,82.7482,115,4,7.05259,0.947405
Australia,228,239.627,7.69737,0.372807,232.079,7.23246,0.337719,DA Warner,0,0,0,0,0,0,0,0,26,9,35,26,9,35,282,283,2,0,1,4.20312,0.265625,35.2031,87.7336,64,4,8.57309,0.426912
Australia,228,239.627,7.69737,0.372807,232.079,7.23246,0.337719,UT Khawaja,0,0,0,0,0,0,0,0,26,13,39,26,13,39,247,191,0,0,1,2.8,0.2,21.6,84.375,5,4,9.99733,3.00267
West Indies,176,217.33,7.15909,0.3125,225.278,7.57386,0.380682,J Charles,0,0,0,0,0,0,0,0,8,7,15,8,7,15,0,159,6,0,1,3.82353,0.147059,28.2353,81.2183,34,4,5.87734,1.12266
West Indies,176,217.33,7.15909,0.3125,225.278,7.57386,0.380682,MN Samuels,0,0,0,0,0,0,0,0,8,7,15,8,7,15,0,159,6,0,1,3.74757,0.23301,31.6214,74.5821,103,4,5.87734,1.12266
Sri Lanka,244,223.373,7.09016,0.344262,227.578,7.47541,0.385246,MDKJ Perera,0,0,0,0,0,0,0,0,34,13,47,34,13,47,160,164,1,1,1,3.30435,0.195652,25.7391,90.5199,46,0,8.81307,4.18693
West Indies,176,217.33,7.15909,0.3125,225.278,7.57386,0.380682,J Blackwood,0,0,0,0,0,0,0,0,12,12,24,12,12,24,0,214,6,0,1,0.5,0,5.5,44,2,3,6.42326,5.57674
Pakistan,211,222.621,7.38389,0.393365,235.517,7.54976,0.336493,Azhar Ali,0,0,0,0,0,0,0,0,4,7,11,4,7,11,0,259,1,0,1,3.83333,0.3,38.5333,73.6775,30,4,7.17136,-0.171365
Zimbabwe,142,212.077,7.5,0.380282,227.704,6.97887,0.316901,CJ Chibhabha,0,0,0,0,0,0,0,0,4,6,10,4,6,10,260,128,1,1,1,2.56716,0.149254,23.5373,64.7373,67,1,6.77036,-0.770362
Zimbabwe,142,212.077,7.5,0.380282,227.704,6.97887,0.316901,H Masakadza,0,0,0,0,0,0,0,0,8,7,15,8,7,15,0,276,1,1,1,3.11215,0.186916,26.972,70.0485,107,4,6.39467,0.605334
Pakistan,211,222.621,7.38389,0.393365,235.517,7.54976,0.336493,Azhar Ali,0,0,0,0,0,0,0,0,12,3,15,12,3,15,277,256,2,0,1,3.83333,0.3,38.5333,73.6775,30,4,8.37127,-5.37127
Pakistan,211,222.621,7.38389,0.393365,235.517,7.54976,0.336493,Bilal Asif,0,0,0,0,0,0,0,0,12,3,15,12,3,15,277,256,2,0,1,2.33333,0,13.3333,76.9231,3,1,8.37127,-5.37127
Ireland,55,219.527,7.65455,0.290909,202.727,7.56364,0.4,WTS Porterfield,0,0,0,0,0,0,0,0,12,4,16,12,4,16,0,219,0,0,1,2.6,0.142857,24.6857,56.2866,35,3,5.51713,-1.51713
Zimbabwe,142,212.077,7.5,0.380282,227.704,6.97887,0.316901,R Mutumbami,0,0,0,0,0,0,0,0,12,10,22,12,10,22,269,270,7,1,1,1.93333,0.0666667,15.4667,69.8795,15,1,6.85686,3.14314
Bangladesh,160,218.438,7.70625,0.4,211.106,7.05,0.325,Tamim Iqbal,0,0,0,0,0,0,0,0,12,6,18,12,6,18,0,273,1,1,1,4.05344,0.274809,31.8015,76.8068,131,4,6.14827,-0.148272
Bangladesh,160,218.438,7.70625,0.4,211.106,7.05,0.325,Liton Das,0,0,0,0,0,0,0,0,12,6,18,12,6,18,0,273,1,1,1,1,0,7.66667,69.697,6,1,4.97499,1.02501
Bangladesh,160,218.438,7.70625,0.4,211.106,7.05,0.325,Imrul Kayes,0,0,0,0,0,0,0,0,12,9,21,12,9,21,0,241,0,1,1,3,0.207547,26.2642,63.6488,53,4,6.14827,2.85173
Zimbabwe,142,212.077,7.5,0.380282,227.704,6.97887,0.316901,RW Chakabva,0,0,0,0,0,0,0,0,10,5,15,10,5,15,242,183,8,0,1,0.846154,0,13.2692,51.3393,26,3,5.90544,-0.905437
Bangladesh,160,218.438,7.70625,0.4,211.106,7.05,0.325,Tamim Iqbal,0,0,0,0,0,0,0,0,14,7,21,14,7,21,0,276,0,1,1,4.05344,0.274809,31.8015,76.8068,131,4,6.14827,0.851728
Zimbabwe,142,212.077,7.5,0.380282,227.704,6.97887,0.316901,RW Chakabva,0,0,0,0,0,0,0,0,20,7,27,20,7,27,277,215,3,0,1,0.846154,0,13.2692,51.3393,26,3,6.96728,0.0327249
