Batsman,Total Runs Scored,Home Run Hitting Ability,Home Runs,Non Home Runs,Number of Milestones Reached,Average Balls Faced,Team
JA Morkel,66,7.0,34,32,0,9.55555555556,South Africa
HH Gibbs,137,13.0,64,73,0,13.3,South Africa
T Thushara,28,3.0,12,16,0,9.4,Sri Lanka
V Sehwag,166,21.0,92,74,0,13.4,India
KA Edwards,36,3.0,14,22,0,16.3333333333,West Indies
SC Williams,194,12.0,50,144,0,10.2916666667,Zimbabwe
DE Bernard,12,2.0,8,4,0,9.0,West Indies
MJ Guptill,188,18.0,84,104,0,13.1333333333,New Zealand
CT Tremlett,7,1.0,4,3,0,9.5,England
CK Kapugedera,173,9.0,40,133,0,12.0869565217,Sri Lanka
N Deonarine,18,1.0,4,14,0,7.16666666667,West Indies
CR Brathwaite,8,1.0,4,4,0,8.5,West Indies
MC Sorensen,12,1.0,4,8,0,17.0,Ireland
NW Bracken,11,2.0,8,3,0,12.0,Australia
SR Patel,47,4.0,18,29,0,8.3,England
CK Coventry,42,4.0,16,26,0,12.0,Zimbabwe
D Mongia,20,2.0,8,12,0,12.5,India
D Ganga,5,1.0,4,1,0,4.0,West Indies
MJ Santner,25,2.0,8,17,0,13.3333333333,New Zealand
CT Mutombodzi,10,1.0,4,6,0,7.0,Zimbabwe
CR Ervine,128,11.0,44,84,0,12.3846153846,Zimbabwe
IR Bell,311,18.0,80,231,0,12.2258064516,England
A Symonds,218,20.0,86,132,0,13.35,Australia
Umar Gul,18,1.0,4,14,0,6.71428571429,Pakistan
HDRL Thirimanne,344,26.0,112,232,0,11.9705882353,Sri Lanka
SW Billings,10,1.0,4,6,0,13.0,England
H Masakadza,200,15.0,68,132,0,13.5,Zimbabwe
KO Meth,7,1.0,4,3,0,9.0,Zimbabwe
B Lee,31,3.0,12,19,0,10.5,Australia
R Mutumbami,24,2.0,8,16,0,8.5,Zimbabwe
TWM Latham,32,1.0,4,28,0,11.75,New Zealand
JH Kallis,289,17.0,70,219,0,12.4285714286,South Africa
LRPL Taylor,553,34.0,146,407,0,13.7678571429,New Zealand
CH Gayle,147,17.0,78,69,0,13.25,West Indies
PC de Silva,24,3.0,12,12,0,12.5,Sri Lanka
MDKJ Perera,39,4.0,20,19,0,6.4,Sri Lanka
SP Narine,38,3.0,14,24,0,8.25,West Indies
SJ Benn,40,5.0,22,18,0,9.5,West Indies
IJL Trott,285,17.0,68,217,0,13.1153846154,England
CJ Anderson,103,10.0,50,53,0,9.14285714286,New Zealand
Mahbubul Alam,8,1.0,4,4,0,12.0,Bangladesh
Hammad Azam,12,1.0,4,8,0,10.0,Pakistan
DPMD Jayawardene,810,69.0,290,520,0,12.9027777778,Sri Lanka
PG Fulton,81,3.0,12,69,0,11.875,New Zealand
ST Finn,15,1.0,4,11,0,9.5,England
SL Malinga,27,2.0,12,15,0,5.66666666667,Sri Lanka
LM Jongwe,10,1.0,4,6,0,7.5,Zimbabwe
Abdur Razzak,83,10.0,42,41,0,8.0,Bangladesh
Mahmudullah,265,21.0,90,175,0,14.2941176471,Bangladesh
DJG Sammy,323,44.0,204,119,0,11.0,West Indies
JR Hopes,78,3.0,12,66,0,9.14285714286,Australia
E Chigumbura,363,24.0,106,257,0,12.5714285714,Zimbabwe
KP Pietersen,222,12.0,54,168,0,12.16,England
VD Philander,18,2.0,8,10,0,8.0,South Africa
CJ Ferguson,80,6.0,24,56,0,12.9,Australia
DL Vettori,197,18.0,76,121,0,9.79166666667,New Zealand
A Mishra,5,1.0,4,1,0,7.0,India
RA Jadeja,183,16.0,70,113,0,11.0,India
LD Chandimal,319,21.0,92,227,0,11.4848484848,Sri Lanka
BMAJ Mendis,63,7.0,30,33,0,11.625,Sri Lanka
SMA Priyanjan,61,5.0,20,41,0,12.5714285714,Sri Lanka
JP Duminy,446,22.0,88,358,0,12.0181818182,South Africa
NO Miller,62,6.0,28,34,0,12.3333333333,West Indies
DJ Hussey,266,22.0,92,174,0,11.8518518519,Australia
MG Johnson,34,3.0,14,20,0,6.4,Australia
SM Pollock,92,10.0,44,48,0,13.8571428571,South Africa
PD Collingwood,459,33.0,142,317,0,12.9782608696,England
CH Morris,15,3.0,12,3,0,7.66666666667,South Africa
Asad Shafiq,193,14.0,56,137,0,10.5909090909,Pakistan
Bazid Khan,13,1.0,6,7,0,18.0,Pakistan
PJ Forrest,54,5.0,22,32,0,16.0,Australia
Sikandar Raza,75,6.0,24,51,0,9.72727272727,Zimbabwe
IK Pathan,49,5.0,26,23,0,9.88888888889,India
AC Gilchrist,22,1.0,4,18,0,10.5,Australia
M Morkel,17,2.0,8,9,0,5.42857142857,South Africa
ST Jayasuriya,68,5.0,24,44,0,15.6,Sri Lanka
CJ Chibhabha,113,6.0,26,87,0,11.0714285714,Zimbabwe
Tamim Iqbal,129,11.0,48,81,0,11.1428571429,Bangladesh
JM How,57,6.0,26,31,0,14.75,New Zealand
N Madziva,11,1.0,4,7,0,22.0,Zimbabwe
D Wiese,20,2.0,8,12,0,7.66666666667,South Africa
DR Martyn,40,5.0,20,20,0,15.6666666667,Australia
Sohaib Maqsood,127,12.0,56,71,0,11.5384615385,Pakistan
JWA Taylor,86,9.0,40,46,0,12.7142857143,England
HMCM Bandara,9,1.0,4,5,0,6.5,Sri Lanka
LMP Simmons,160,15.0,68,92,0,13.0,West Indies
EC Joyce,99,8.0,32,67,0,14.625,England
Mushfiqur Rahim,505,50.0,212,293,0,11.8653846154,Bangladesh
Mohammad Ashraful,122,13.0,54,68,0,11.1428571429,Bangladesh
Sohag Gazi,12,1.0,4,8,0,8.0,Bangladesh
Iftikhar Anjum,31,3.0,12,19,0,12.4,Pakistan
Farhad Reza,39,4.0,16,23,0,10.2222222222,Bangladesh
TD Paine,19,2.0,8,11,0,13.5,Australia
KA Pollard,214,18.0,92,122,0,10.5666666667,West Indies
SR Watson,255,28.0,130,125,0,9.68,Australia
NLTC Perera,125,14.0,76,49,0,9.06666666667,Sri Lanka
R McLaren,72,7.0,30,42,0,11.8,South Africa
JC Buttler,254,24.0,96,158,0,11.32,England
KM Dabengwa,42,4.0,18,24,0,12.6,Zimbabwe
GC Smith,136,14.0,62,74,0,12.5454545455,South Africa
MK Tiwary,29,3.0,12,17,0,10.0,India
Inzamam-ul-Haq,53,6.0,24,29,0,9.83333333333,Pakistan
MEK Hussey,604,42.0,174,430,0,13.2666666667,Australia
JDP Oram,161,13.0,56,105,0,11.5882352941,New Zealand
Khurram Manzoor,27,4.0,16,11,0,23.0,Pakistan
DJ Bravo,330,28.0,128,202,0,12.2162162162,West Indies
Shamsur Rahman,15,2.0,10,5,0,19.0,Bangladesh
BJ Hodge,31,2.0,8,23,0,9.8,Australia
HM Amla,388,35.0,154,234,0,12.1290322581,South Africa
GJ Bailey,340,32.0,138,202,0,12.2666666667,Australia
R Dravid,133,9.0,36,97,0,10.1333333333,India
RP Singh,17,2.0,8,9,0,10.25,India
SHT Kandamby,111,8.0,32,79,0,12.3571428571,Sri Lanka
SB Styris,266,24.0,100,166,0,12.375,New Zealand
N Mushangwe,6,1.0,6,0,0,5.0,Zimbabwe
Raqibul Hasan,132,9.0,40,92,0,13.9375,Bangladesh
Fawad Alam,127,9.0,38,89,0,11.7333333333,Pakistan
JM Kemp,68,7.0,32,36,0,10.0,South Africa
WTS Porterfield,39,2.0,8,31,0,10.8,Ireland
Yuvraj Singh,602,63.0,280,322,0,12.9230769231,India
Abdur Rehman,14,2.0,8,6,0,9.0,Pakistan
SW Masakadza,17,3.0,12,5,0,7.33333333333,Zimbabwe
MS Dhoni,964,75.0,322,642,0,12.3063063063,India
AC Voges,91,5.0,20,71,0,11.0,Australia
AJ Strauss,106,11.0,48,58,0,14.0,England
S Prasanna,33,5.0,26,7,0,8.4,Sri Lanka
SCJ Broad,54,5.0,22,32,0,8.77777777778,England
Saad Nasim,14,2.0,8,6,0,21.0,Pakistan
NJ O'Brien,97,10.0,44,53,0,13.75,Ireland
A Balbirnie,33,3.0,12,21,0,11.0,Ireland
Mohammad Yousuf,270,19.0,80,190,0,12.8518518519,Pakistan
Z Khan,44,2.0,8,36,0,12.7142857143,India
Ahmed Shehzad,127,15.0,66,61,0,10.9090909091,Pakistan
AD Russell,89,10.0,46,43,0,8.4,West Indies
Babar Azam,25,2.0,8,17,0,12.0,Pakistan
R Ashwin,89,9.0,36,53,0,10.5384615385,India
CL White,269,21.0,90,179,0,11.875,Australia
YK Pathan,84,11.0,54,30,0,10.75,India
Imran Nazir,18,2.0,8,10,0,12.0,Pakistan
Imran Farhat,34,4.0,16,18,0,11.3333333333,Pakistan
CMW Read,15,1.0,4,11,0,11.0,England
AM Rahane,169,19.0,78,91,0,14.2727272727,India
AU Rashid,28,4.0,18,10,0,12.0,England
KM Jadhav,16,2.0,8,8,0,9.5,India
Mashrafe Mortaza,55,1.0,4,51,0,8.94117647059,Bangladesh
SF Mire,48,4.0,22,26,0,13.25,Zimbabwe
GB Brent,17,1.0,4,13,0,9.5,Zimbabwe
M Vijay,11,1.0,6,5,0,8.0,India
CD McMillan,67,8.0,38,29,0,11.625,New Zealand
Sohail Tanvir,27,5.0,20,7,0,12.25,Pakistan
V Sibanda,73,6.0,30,43,0,16.2,Zimbabwe
Aftab Ahmed,40,5.0,22,18,0,12.5,Bangladesh
C Kieswetter,33,2.0,8,25,0,12.6666666667,England
Abdul Razzaq,124,13.0,54,70,0,11.2222222222,Pakistan
DR Tuffey,14,1.0,4,10,0,6.0,New Zealand
Mohammad Irfan,5,1.0,4,1,0,5.33333333333,Pakistan
Alok Kapali,44,4.0,18,26,0,15.5,Bangladesh
Sabbir Rahman,95,12.0,48,47,0,14.1428571429,Bangladesh
GD Elliott,286,26.0,108,178,0,11.8275862069,New Zealand
Mohammad Hafeez,219,14.0,64,155,0,12.7727272727,Pakistan
JL Pattinson,5,1.0,4,1,0,6.0,Australia
Mohammad Rizwan,31,2.0,10,21,0,9.0,Pakistan
S Matsikenyeri,102,6.0,24,78,0,11.5,Zimbabwe
D Ramdin,256,24.0,100,156,0,10.4615384615,West Indies
CS Baugh,42,1.0,4,38,0,10.875,West Indies
Haris Sohail,81,6.0,24,57,0,11.1,Pakistan
S Dhawan,161,16.0,68,93,0,12.6666666667,India
JM Bairstow,24,1.0,6,18,0,7.5,England
RR Powar,23,2.0,10,13,0,16.5,India
TG Southee,32,2.0,8,24,0,6.8,New Zealand
SE Marsh,108,6.0,26,82,0,12.5,Australia
BRM Taylor,313,23.0,106,207,0,13.3666666667,Zimbabwe
CA Ingram,71,6.0,24,47,0,15.2,South Africa
SC Ganguly,49,4.0,16,33,0,11.6,India
MV Boucher,161,15.0,60,101,0,9.25,South Africa
AD Mathews,391,26.0,110,281,0,11.0181818182,Sri Lanka
NT Broom,50,3.0,12,38,0,11.0,New Zealand
C de Grandhomme,24,3.0,16,8,0,19.0,New Zealand
Mominul Haque,56,7.0,28,28,0,16.0,Bangladesh
Yasir Shah,9,1.0,4,5,0,7.0,Pakistan
R Vinay Kumar,7,1.0,4,3,0,15.0,India
GH Worker,10,1.0,4,6,0,10.0,New Zealand
GC Wilson,64,5.0,22,42,0,13.4285714286,Ireland
Salman Butt,78,8.0,32,46,0,14.1666666667,Pakistan
SI Mahmood,8,1.0,4,4,0,7.0,England
TA Boult,6,1.0,4,2,0,9.0,New Zealand
MR Gillespie,21,4.0,18,3,0,16.0,New Zealand
S Chanderpaul,289,19.0,78,211,0,13.0333333333,West Indies
DA Warner,70,6.0,24,46,0,12.3333333333,Australia
FL Reifer,24,2.0,8,16,0,14.0,West Indies
TAM Siriwardana,17,1.0,4,13,0,6.0,Sri Lanka
EJG Morgan,589,52.0,240,349,0,11.8448275862,England
KC Sangakkara,900,73.0,302,598,0,12.9113924051,Sri Lanka
AT Rayudu,101,9.0,38,63,0,13.5,India
SR Tendulkar,231,24.0,100,131,0,13.3,India
RK Kleinveldt,20,3.0,14,6,0,21.0,South Africa
AD Mascarenhas,25,1.0,4,21,0,13.6666666667,England
BCJ Cutting,12,1.0,4,8,0,14.0,Australia
MM Ali,30,1.0,6,24,0,8.6,England
DSNFG Jayasuriya,10,2.0,8,2,0,10.0,Sri Lanka
T Panyangara,13,2.0,8,5,0,4.33333333333,Zimbabwe
Younis Khan,298,20.0,88,210,0,13.4230769231,Pakistan
Wahab Riaz,29,3.0,12,17,0,7.27272727273,Pakistan
MN van Wyk,11,1.0,4,7,0,6.66666666667,South Africa
HMRKB Herath,21,4.0,16,5,0,7.0,Sri Lanka
F du Plessis,322,27.0,116,206,0,11.7,South Africa
WU Tharanga,293,27.0,108,185,0,14.75,Sri Lanka
AN Petersen,33,2.0,10,23,0,9.5,South Africa
AC Botha,21,2.0,10,11,0,8.0,Ireland
DG Brownlie,11,2.0,8,3,0,12.0,New Zealand
S Badrinath,9,1.0,4,5,0,21.0,India
MA Carberry,14,2.0,8,6,0,13.0,England
NL McCullum,148,10.0,48,100,0,10.0869565217,New Zealand
A Flintoff,151,17.0,74,77,0,11.3684210526,England
J Charles,27,2.0,8,19,0,10.6666666667,West Indies
G Gambhir,322,22.0,92,230,0,12.2962962963,India
DT Johnston,32,3.0,14,18,0,11.6,Ireland
Faisal Iqbal,7,1.0,4,3,0,8.0,Pakistan
Sarfraz Ahmed,101,5.0,20,81,0,9.375,Pakistan
HM Nicholls,28,2.0,8,20,0,11.3333333333,New Zealand
Anwar Ali,29,4.0,16,13,0,10.3333333333,Pakistan
CR Woakes,111,9.0,38,73,0,11.0,England
Naeem Islam,125,11.0,44,81,0,13.8125,Bangladesh
Anamul Haque,75,4.0,16,59,0,14.0,Bangladesh
RS Morton,111,8.0,34,77,0,14.9090909091,West Indies
M Muralitharan,21,3.0,14,7,0,3.8,Sri Lanka
KJ O'Brien,182,23.0,106,76,0,12.375,Ireland
AF Milne,12,2.0,10,2,0,3.0,New Zealand
DM Bravo,198,20.0,92,106,0,11.9130434783,West Indies
R Clarke,11,1.0,4,7,0,17.0,England
JD Ryder,32,3.0,12,20,0,10.75,New Zealand
RV Uthappa,39,3.0,14,25,0,15.0,India
MM Sharma,4,1.0,4,0,0,3.5,India
MA Starc,8,1.0,4,4,0,8.0,Australia
AG Cremer,72,6.0,24,48,0,13.4,Zimbabwe
I Sharma,15,2.0,8,7,0,8.4,India
AJ Finch,130,12.0,54,76,0,16.0,Australia
ML Hayden,76,7.0,34,42,0,10.4285714286,Australia
AR White,40,6.0,24,16,0,10.5,Ireland
Shahid Afridi,485,55.0,254,231,0,9.81818181818,Pakistan
SP Fleming,29,2.0,8,21,0,10.5,New Zealand
JJ Roy,9,1.0,4,5,0,15.0,England
JDS Neesham,13,1.0,4,9,0,12.5,New Zealand
DW Steyn,32,5.0,22,10,0,9.0,South Africa
BJ Watling,71,8.0,32,39,0,13.8,New Zealand
Kamran Akmal,91,6.0,24,67,0,9.33333333333,Pakistan
CJ McKay,22,3.0,12,10,0,6.0,Australia
CRD Fernando,15,2.0,8,7,0,5.8,Sri Lanka
SPD Smith,239,21.0,88,151,0,11.1666666667,Australia
ME Trescothick,31,3.0,14,17,0,10.3333333333,England
C Munro,56,6.0,26,30,0,11.75,New Zealand
MF Maharoof,28,2.0,8,20,0,7.5,Sri Lanka
ND McKenzie,22,2.0,8,14,0,18.5,South Africa
JE Taylor,8,1.0,4,4,0,3.5,West Indies
JEC Franklin,95,3.0,12,83,0,9.94736842105,New Zealand
LJ Wright,119,11.0,54,65,0,11.3076923077,England
RR Rossouw,93,10.0,40,53,0,13.1428571429,South Africa
MS Atapattu,35,2.0,8,27,0,13.25,Sri Lanka
KAJ Roach,26,3.0,12,14,0,9.16666666667,West Indies
GP Swann,48,6.0,24,24,0,7.6,England
Naved-ul-Hasan,30,3.0,14,16,0,9.5,Pakistan
RS Bopara,311,19.0,82,229,0,10.2380952381,England
RP Arnold,44,1.0,4,40,0,10.8333333333,Sri Lanka
Shoaib Malik,431,34.0,150,281,0,11.8636363636,Pakistan
Nasir Jamshed,53,3.0,14,39,0,11.8,Pakistan
Shuvagoto Hom,22,4.0,16,6,0,12.5,Bangladesh
RW Price,36,6.0,24,12,0,11.6666666667,Zimbabwe
WD Parnell,52,7.0,28,24,0,12.1666666667,South Africa
TT Bresnan,116,15.0,60,56,0,9.46153846154,England
MS Wade,99,6.0,24,75,0,11.6428571429,Australia
KD Mills,45,2.0,8,37,0,7.15384615385,New Zealand
JWM Dalrymple,53,2.0,8,45,0,10.0909090909,England
KMDN Kulasekara,97,5.0,24,73,0,9.83333333333,Sri Lanka
Suhrawadi Shuvo,9,1.0,4,5,0,5.66666666667,Bangladesh
RR Sarwan,202,18.0,78,124,0,12.5555555556,West Indies
Arafat Sunny,5,1.0,4,1,0,12.0,Bangladesh
Q de Kock,125,13.0,58,67,0,15.375,South Africa
Yasir Hameed,26,1.0,4,22,0,20.0,Pakistan
MJ Prior,66,7.0,28,38,0,11.0,England
J Botha,58,4.0,16,42,0,9.11111111111,South Africa
DA Miller,179,19.0,80,99,0,11.35,South Africa
RT Ponting,347,28.0,122,225,0,12.1875,Australia
MJ Clarke,610,44.0,182,428,0,12.4444444444,Australia
Habibul Bashar,40,3.0,12,28,0,12.8333333333,Bangladesh
GH Dockrell,31,3.0,14,17,0,15.0,Ireland
GJ Maxwell,188,23.0,98,90,0,9.88235294118,Australia
RJ Nicol,33,3.0,12,21,0,16.0,New Zealand
RJ Peterson,17,1.0,4,13,0,7.6,South Africa
MR Marsh,119,10.0,46,73,0,13.5,Australia
J Lewis,9,2.0,8,1,0,4.0,England
MN Waller,137,14.0,58,79,0,11.3888888889,Zimbabwe
R Rampaul,60,8.0,34,26,0,10.4,West Indies
D Langford-Smith,17,2.0,10,7,0,10.0,Ireland
KD Karthik,93,6.0,24,69,0,13.1818181818,India
AG Prince,34,2.0,10,24,0,9.25,South Africa
JM Anderson,7,1.0,4,3,0,3.4,England
PJ Cummins,4,1.0,4,0,0,11.0,Australia
Mohammad Amir,18,3.0,18,0,0,13.0,Pakistan
S Randiv,53,6.0,24,29,0,11.2,Sri Lanka
JP Faulkner,88,12.0,54,34,0,12.4285714286,Australia
JL Carter,20,3.0,14,6,0,17.0,West Indies
SR Clark,10,1.0,4,6,0,9.0,Australia
F Behardien,86,4.0,18,68,0,10.9166666667,South Africa
Nasir Hossain,166,11.0,46,120,0,12.45,Bangladesh
IG Butler,18,1.0,6,12,0,13.5,New Zealand
TT Samaraweera,90,6.0,24,66,0,10.4285714286,Sri Lanka
JS Patel,12,1.0,4,8,0,8.5,New Zealand
Misbah-ul-Haq,687,55.0,240,447,0,13.5857142857,Pakistan
DBL Powell,31,4.0,20,11,0,16.0,West Indies
Shakib Al Hasan,609,52.0,210,399,0,12.1333333333,Bangladesh
Shahriar Nafees,37,3.0,12,25,0,15.3333333333,Bangladesh
Javed Omar,11,1.0,4,7,0,16.0,Bangladesh
KS Williamson,400,41.0,170,230,0,13.4,New Zealand
Soumya Sarkar,12,2.0,10,2,0,10.0,Bangladesh
LPC Silva,168,14.0,58,110,0,12.6315789474,Sri Lanka
P Utseya,95,3.0,12,83,0,10.5789473684,Zimbabwe
KM Jarvis,13,2.0,8,5,0,21.0,Zimbabwe
GJ Hopkins,50,4.0,16,34,0,12.6666666667,New Zealand
L Ronchi,118,12.0,50,68,0,12.3,New Zealand
WPUJC Vaas,42,4.0,16,26,0,13.75,Sri Lanka
BJ Haddin,177,15.0,72,105,0,11.85,Australia
AN Cook,113,8.0,32,81,0,13.8888888889,England
BC Lara,152,15.0,66,86,0,14.0833333333,West Indies
PJ Hughes,78,10.0,40,38,0,16.0,Australia
DT Christian,47,5.0,20,27,0,12.2,Australia
Mohammad Sami,15,1.0,4,11,0,16.0,Pakistan
T Taibu,215,14.0,60,155,0,14.3684210526,Zimbabwe
SMSM Senanayake,22,2.0,10,12,0,11.0,Sri Lanka
KTGD Prasad,21,4.0,20,1,0,4.5,Sri Lanka
AB de Villiers,1110,104.0,450,660,0,13.3580246914,South Africa
A Nel,12,1.0,4,8,0,11.0,South Africa
Aamer Yamin,18,3.0,14,4,0,18.0,Pakistan
JE Root,342,25.0,112,230,0,13.1034482759,England
Imad Wasim,11,1.0,4,7,0,14.0,Pakistan
TM Dilshan,467,40.0,164,303,0,12.3953488372,Sri Lanka
GS Ballance,16,1.0,4,12,0,12.0,England
RG Sharma,445,39.0,172,273,0,12.4358974359,India
DR Flynn,21,2.0,8,13,0,9.0,New Zealand
Harbhajan Singh,38,2.0,8,30,0,6.35714285714,India
Umar Amin,51,2.0,8,43,0,10.625,Pakistan
JO Holder,35,4.0,18,17,0,9.0,West Indies
SS Pathirana,17,1.0,6,11,0,13.5,Sri Lanka
Umar Akmal,424,40.0,174,250,0,11.2888888889,Pakistan
M Kaif,34,2.0,8,26,0,12.25,India
MH Yardy,68,2.0,8,60,0,13.375,England
TL Chatara,4,1.0,4,0,0,4.0,Zimbabwe
Imrul Kayes,62,4.0,20,42,0,8.75,Bangladesh
MN Samuels,447,50.0,224,223,0,14.2777777778,West Indies
MK Pandey,24,2.0,10,14,0,11.5,India
STR Binny,27,2.0,12,15,0,12.5,India
Dhiman Ghosh,13,2.0,10,3,0,6.33333333333,Bangladesh
DR Smith,33,4.0,16,17,0,7.85714285714,West Indies
BB McCullum,233,26.0,118,115,0,10.9166666667,New Zealand
SK Raina,787,79.0,344,443,0,11.5277777778,India
BA Stokes,65,5.0,20,45,0,7.84615384615,England
P Kumar,19,2.0,8,11,0,10.75,India
OA Shah,205,17.0,80,125,0,11.95,England
Azhar Ali,95,8.0,34,61,0,13.125,Pakistan
V Kohli,940,104.0,442,498,0,14.3620689655,India
SE Findlay,13,1.0,4,9,0,14.0,West Indies
