Batsman,Total Runs Scored,Home Run Hitting Ability,Home Runs,Non Home Runs,Number of Milestones Reached,Average Balls Faced,Team
Yasir Hameed,21,1.0,4,17,0,14.5,Pakistan
Salman Butt,135,10.0,40,95,0,12.4,Pakistan
JA Morkel,45,7.0,34,11,0,14.3333333333,South Africa
JM Bairstow,41,6.0,24,17,0,7.25,England
T Thushara,16,3.0,12,4,0,15.0,Sri Lanka
V Sehwag,276,30.0,138,138,0,14.1052631579,India
KA Edwards,30,2.0,8,22,0,10.75,West Indies
SC Williams,350,28.0,118,232,0,11.15,Zimbabwe
SI Mahmood,6,1.0,4,2,0,6.0,England
Inzamam-ul-Haq,64,7.0,32,32,0,15.6666666667,Pakistan
WK McCallan,18,1.0,4,14,0,8.75,Ireland
RT Ponting,595,51.0,214,381,0,13.2363636364,Australia
MEK Hussey,397,26.0,112,285,0,10.9473684211,Australia
MM Ali,17,1.0,6,11,0,9.0,England
Imrul Kayes,128,8.0,36,92,0,16.2307692308,Bangladesh
JDP Oram,71,7.0,30,41,0,8.85714285714,New Zealand
Mohammad Sami,7,1.0,4,3,0,13.0,Pakistan
MJ Guptill,464,49.0,212,252,0,12.525,New Zealand
MH Yardy,32,1.0,4,28,0,11.2,England
MJ Clarke,711,49.0,210,501,0,12.5542168675,Australia
GB Hogg,17,1.0,4,13,0,11.0,Australia
Habibul Bashar,21,1.0,6,15,0,7.0,Bangladesh
MJ Prior,85,5.0,22,63,0,10.6428571429,England
S Chanderpaul,244,11.0,44,200,0,10.9230769231,West Indies
DJ Bravo,255,20.0,86,169,0,9.475,West Indies
Haris Sohail,69,4.0,18,51,0,9.72727272727,Pakistan
Misbah-ul-Haq,558,44.0,196,362,0,12.5675675676,Pakistan
MJ Santner,11,1.0,4,7,0,13.5,New Zealand
Sabbir Rahman,26,2.0,8,18,0,10.5,Bangladesh
CK Kapugedera,176,15.0,64,112,0,12.2173913043,Sri Lanka
N Deonarine,47,3.0,14,33,0,13.6666666667,West Indies
PJ Forrest,49,4.0,16,33,0,12.5714285714,Australia
FL Reifer,8,1.0,4,4,0,18.0,West Indies
BJ Hodge,33,3.0,12,21,0,11.0,Australia
J Mubarak,42,2.0,8,34,0,10.6,Sri Lanka
TAM Siriwardana,11,1.0,4,7,0,6.0,Sri Lanka
EJG Morgan,571,55.0,236,335,0,12.3728813559,England
HM Amla,545,38.0,158,387,0,12.6923076923,South Africa
GH Dockrell,5,1.0,4,1,0,5.0,Ireland
SR Patel,30,2.0,12,18,0,8.25,England
SPD Smith,177,9.0,42,135,0,11.3684210526,Australia
KC Sangakkara,1033,65.0,264,769,0,12.610619469,Sri Lanka
GJ Bailey,310,25.0,104,206,0,12.0833333333,Australia
R Mutumbami,15,2.0,8,7,0,11.5,Zimbabwe
CK Coventry,40,4.0,16,24,0,12.1666666667,Zimbabwe
AT Rayudu,156,19.0,82,74,0,13.4615384615,India
SR Tendulkar,357,36.0,158,199,0,12.9,India
RK Kleinveldt,6,1.0,4,2,0,10.0,South Africa
JP Bray,30,4.0,16,14,0,13.0,Ireland
DM Richards,20,2.0,8,12,0,15.0,West Indies
DA Warner,171,16.0,74,97,0,11.9333333333,Australia
R Dravid,218,20.0,86,132,0,14.6666666667,India
MA Starc,17,2.0,8,9,0,10.5,Australia
MR Marsh,75,8.0,32,43,0,13.6666666667,Australia
CR Ervine,100,8.0,36,64,0,10.5384615385,Zimbabwe
IR Bell,528,33.0,136,392,0,13.0,England
A Symonds,122,9.0,44,78,0,9.84210526316,Australia
RS Bopara,290,23.0,96,194,0,11.5428571429,England
L Vincent,42,1.0,4,38,0,14.5,New Zealand
HDRL Thirimanne,314,25.0,102,212,0,13.875,Sri Lanka
DJG Sammy,110,11.0,50,60,0,9.2380952381,West Indies
MN Waller,78,7.0,28,50,0,11.4285714286,Zimbabwe
SL Malinga,40,6.0,26,14,0,6.33333333333,Sri Lanka
SHT Kandamby,100,4.0,16,84,0,12.3076923077,Sri Lanka
KD Karthik,81,7.0,30,51,0,12.5,India
SB Styris,203,8.0,32,171,0,11.1724137931,New Zealand
LD Chandimal,396,31.0,134,262,0,13.1219512195,Sri Lanka
Q de Kock,228,27.0,120,108,0,14.0,South Africa
Younis Khan,504,42.0,174,330,0,12.54,Pakistan
D Langford-Smith,19,3.0,14,5,0,12.0,Ireland
CJ Ferguson,44,3.0,12,32,0,8.44444444444,Australia
GJ Maxwell,139,17.0,78,61,0,11.6923076923,Australia
H Masakadza,310,28.0,122,188,0,12.4827586207,Zimbabwe
Fawad Alam,127,5.0,20,107,0,11.8823529412,Pakistan
HM Nicholls,48,6.0,26,22,0,10.8,New Zealand
PA Browne,12,2.0,8,4,0,17.0,West Indies
D Elgar,13,1.0,4,9,0,13.0,South Africa
JM Kemp,79,7.0,32,47,0,15.2,South Africa
TM Dowlin,34,2.0,8,26,0,14.6666666667,West Indies
MN van Wyk,42,4.0,16,26,0,14.75,South Africa
Yuvraj Singh,587,68.0,302,285,0,12.9444444444,India
PA Nixon,8,1.0,4,4,0,13.0,England
Tushar Imran,8,1.0,4,4,0,16.0,Bangladesh
WU Tharanga,419,38.0,158,261,0,14.8378378378,Sri Lanka
Raqibul Hasan,205,15.0,64,141,0,14.36,Bangladesh
DS Smith,82,5.0,24,58,0,15.0,West Indies
TWM Latham,111,10.0,42,69,0,13.0,New Zealand
AR Cusack,42,4.0,16,26,0,9.57142857143,Ireland
AN Petersen,40,3.0,12,28,0,11.6,South Africa
AC Botha,36,3.0,12,24,0,12.8,Ireland
JP Faulkner,20,3.0,12,8,0,6.0,Australia
AJ Redmond,11,1.0,4,7,0,26.0,New Zealand
JL Carter,20,2.0,10,10,0,6.8,West Indies
Abdul Razzaq,21,1.0,4,17,0,13.4,Pakistan
MS Dhoni,631,37.0,166,465,0,11.4941176471,India
JM Anderson,9,1.0,4,5,0,10.0,England
MA Carberry,14,1.0,4,10,0,14.0,England
TM Dilshan,675,59.0,242,433,0,12.0,Sri Lanka
F Behardien,40,4.0,16,24,0,9.5,South Africa
AJ Strauss,166,12.0,48,118,0,11.8333333333,England
NL McCullum,122,17.0,78,44,0,8.5,New Zealand
JH Kallis,424,26.0,110,314,0,13.2380952381,South Africa
PVD Chameera,6,1.0,4,2,0,11.0,Sri Lanka
AM Rahane,244,24.0,104,140,0,12.8571428571,India
KM Jadhav,7,1.0,4,3,0,9.5,India
LRPL Taylor,705,61.0,272,433,0,12.64,New Zealand
CH Gayle,178,13.0,60,118,0,11.4782608696,West Indies
J Charles,87,12.0,54,33,0,10.1428571429,West Indies
Nasir Hossain,115,11.0,44,71,0,12.3125,Bangladesh
G Gambhir,466,29.0,116,350,0,12.75,India
SCJ Broad,6,1.0,4,2,0,2.16666666667,England
MDKJ Perera,80,7.0,28,52,0,12.375,Sri Lanka
HH Gibbs,194,21.0,90,104,0,12.6875,South Africa
NJ Astle,20,1.0,4,16,0,9.33333333333,New Zealand
Hammad Azam,14,2.0,10,4,0,13.0,Pakistan
Faisal Iqbal,9,1.0,4,5,0,18.0,Pakistan
Sarfraz Ahmed,63,3.0,12,51,0,9.125,Pakistan
IJL Trott,379,17.0,72,307,0,13.7692307692,England
NJ O'Brien,93,8.0,34,59,0,9.9375,Ireland
JS Patel,6,1.0,4,2,0,7.5,New Zealand
A Balbirnie,41,3.0,12,29,0,15.5,Ireland
MF Maharoof,9,1.0,4,5,0,11.5,Sri Lanka
S Chattergoon,8,1.0,4,4,0,7.5,West Indies
AB Barath,27,2.0,10,17,0,15.3333333333,West Indies
Mohammad Yousuf,319,19.0,78,241,0,12.4864864865,Pakistan
Z Khan,9,1.0,4,5,0,6.66666666667,India
SM Katich,8,1.0,6,2,0,12.0,Australia
DPMD Jayawardene,783,59.0,242,541,0,12.5411764706,Sri Lanka
CR Woakes,13,1.0,4,9,0,4.25,England
Naeem Islam,78,8.0,34,44,0,10.6363636364,Bangladesh
PG Fulton,115,7.0,32,83,0,11.8125,New Zealand
F du Plessis,310,23.0,94,216,0,13.2941176471,South Africa
Anamul Haque,91,8.0,34,57,0,14.7777777778,Bangladesh
Shakib Al Hasan,575,52.0,216,359,0,11.6470588235,Bangladesh
Shahriar Nafees,62,8.0,32,30,0,13.5,Bangladesh
PP Chawla,7,1.0,4,3,0,7.0,India
Ahmed Shehzad,212,15.0,62,150,0,12.7826086957,Pakistan
RS Morton,55,3.0,12,43,0,12.375,West Indies
KOA Powell,77,7.0,32,45,0,14.1428571429,West Indies
Abdur Razzak,19,1.0,4,15,0,10.8571428571,Bangladesh
Javed Omar,10,1.0,4,6,0,14.0,Bangladesh
SP Fleming,88,10.0,44,44,0,14.5714285714,New Zealand
KS Williamson,499,42.0,184,315,0,12.6666666667,New Zealand
ND McKenzie,13,2.0,8,5,0,17.0,South Africa
SF Mire,35,6.0,24,11,0,15.3333333333,Zimbabwe
BAW Mendis,20,2.0,10,10,0,20.0,Sri Lanka
ADS Fletcher,23,1.0,4,19,0,11.3333333333,West Indies
JR Hopes,6,1.0,4,2,0,2.33333333333,Australia
Soumya Sarkar,62,9.0,40,22,0,11.1666666667,Bangladesh
R Ashwin,37,4.0,16,21,0,7.8,India
LPC Silva,148,17.0,70,78,0,12.7333333333,Sri Lanka
R Clarke,7,1.0,4,3,0,8.0,England
DT Christian,6,1.0,4,2,0,13.0,Australia
E Chigumbura,201,15.0,62,139,0,10.6486486486,Zimbabwe
P Utseya,51,4.0,16,35,0,10.2,Zimbabwe
AJ Ireland,4,1.0,4,0,0,17.0,Zimbabwe
SW Masakadza,8,1.0,6,2,0,9.0,Zimbabwe
Azhar Ali,96,3.0,14,82,0,11.3846153846,Pakistan
TT Bresnan,20,3.0,12,8,0,8.33333333333,England
DE Bernard,15,1.0,4,11,0,16.5,West Indies
CL White,245,22.0,94,151,0,12.5185185185,Australia
Yasir Arafat,19,4.0,16,3,0,17.0,Pakistan
YK Pathan,53,5.0,28,25,0,6.36363636364,India
DL Vettori,87,5.0,20,67,0,7.61111111111,New Zealand
L Ronchi,85,10.0,44,41,0,9.0,Australia
GW Flower,7,1.0,4,3,0,8.0,Zimbabwe
Imran Nazir,11,1.0,4,7,0,12.0,Pakistan
BJ Haddin,124,12.0,60,64,0,11.5,Australia
AG Cremer,26,3.0,12,14,0,15.0,Zimbabwe
RW Chakabva,48,2.0,8,40,0,11.4444444444,Zimbabwe
Imran Farhat,81,8.0,36,45,0,11.2857142857,Pakistan
AD Russell,92,13.0,68,24,0,10.0,West Indies
AN Cook,240,15.0,64,176,0,12.4814814815,England
CMW Read,4,1.0,4,0,0,6.0,England
AJ Finch,208,20.0,86,122,0,14.1875,Australia
BC Lara,80,10.0,40,40,0,11.5454545455,West Indies
JDS Neesham,34,2.0,8,26,0,8.0,New Zealand
F Mutizwa,35,3.0,12,23,0,11.8,Zimbabwe
RA Jadeja,90,7.0,30,60,0,13.1333333333,India
ML Hayden,199,18.0,78,121,0,12.0,Australia
AU Rashid,25,4.0,16,9,0,11.5,England
PJ Hughes,86,7.0,30,56,0,14.7142857143,Australia
JF Mooney,14,2.0,8,6,0,8.0,Ireland
PA Patel,23,2.0,10,13,0,9.5,India
AR White,29,4.0,16,13,0,12.5,Ireland
KA Pollard,309,34.0,168,141,0,11.5294117647,West Indies
GS Ballance,34,1.0,4,30,0,9.83333333333,England
Shahid Afridi,164,16.0,76,88,0,6.72,Pakistan
NT Broom,42,2.0,8,34,0,9.0,New Zealand
LL Tsotsobe,4,1.0,4,0,0,10.0,South Africa
Mashrafe Mortaza,51,8.0,34,17,0,10.125,Bangladesh
CD McMillan,53,7.0,32,21,0,9.77777777778,New Zealand
SMA Priyanjan,30,4.0,16,14,0,10.4,Sri Lanka
JP Duminy,428,30.0,124,304,0,12.0769230769,South Africa
V Sibanda,100,7.0,32,68,0,10.0,Zimbabwe
NO Miller,11,1.0,4,7,0,16.0,West Indies
XJ Doherty,5,1.0,4,1,0,12.0,Australia
DA Miller,163,14.0,60,103,0,11.380952381,South Africa
T Taibu,288,26.0,116,172,0,13.1923076923,Zimbabwe
JJ Roy,14,1.0,6,8,0,15.0,England
Jahurul Islam,32,3.0,12,20,0,12.25,Bangladesh
DJ Hussey,180,17.0,74,106,0,10.3913043478,Australia
SC Ganguly,103,7.0,36,67,0,13.6363636364,India
CJ Anderson,112,15.0,68,44,0,10.0,New Zealand
SMSM Senanayake,13,1.0,4,9,0,5.5,Sri Lanka
KW Richardson,19,3.0,16,3,0,13.0,Australia
DW Steyn,22,4.0,16,6,0,11.5,South Africa
SM Pollock,26,4.0,16,10,0,10.0,South Africa
Kamran Akmal,106,12.0,48,58,0,8.3125,Pakistan
PD Collingwood,441,40.0,170,271,0,11.6981132075,England
AB de Villiers,946,69.0,306,640,0,12.1685393258,South Africa
S Randiv,34,2.0,8,26,0,14.4,Sri Lanka
Aamer Yamin,6,1.0,4,2,0,14.0,Pakistan
Asad Shafiq,220,16.0,66,154,0,12.9583333333,Pakistan
AP Devcich,8,1.0,4,4,0,13.0,New Zealand
NLTC Perera,42,5.0,26,16,0,10.25,Sri Lanka
BB McCullum,225,18.0,82,143,0,10.65625,New Zealand
AD Mascarenhas,18,3.0,12,6,0,9.66666666667,England
Aftab Ahmed,90,6.0,24,66,0,12.3636363636,Bangladesh
ME Trescothick,46,3.0,12,34,0,14.6666666667,England
Babar Azam,62,7.0,30,32,0,10.5,Pakistan
C Kieswetter,67,8.0,38,29,0,10.4444444444,England
DR Martyn,45,3.0,14,31,0,13.2,Australia
Sikandar Raza,59,5.0,22,37,0,15.2857142857,Zimbabwe
JE Root,384,30.0,128,256,0,13.1052631579,England
Umar Amin,8,1.0,4,4,0,7.5,Pakistan
Nasir Jamshed,103,11.0,44,59,0,11.1818181818,Pakistan
IK Pathan,52,6.0,26,26,0,17.4,India
AC Gilchrist,77,9.0,38,39,0,14.6,Australia
AC Voges,68,2.0,10,58,0,14.375,Australia
ST Jayasuriya,176,20.0,90,86,0,14.3333333333,Sri Lanka
KJ O'Brien,52,4.0,20,32,0,6.8,Ireland
RG Sharma,538,42.0,192,346,0,12.84,India
DM Bravo,270,25.0,114,156,0,11.9696969697,West Indies
CJ Chibhabha,161,14.0,56,105,0,12.0,Zimbabwe
Tamim Iqbal,342,35.0,162,180,0,12.2121212121,Bangladesh
GD Elliott,214,15.0,62,152,0,11.5862068966,New Zealand
JM How,91,10.0,44,47,0,13.4444444444,New Zealand
Mohammad Hafeez,476,44.0,198,278,0,14.0487804878,Pakistan
DR Flynn,25,3.0,12,13,0,9.0,New Zealand
Mohammad Rizwan,26,3.0,12,14,0,9.0,Pakistan
JEC Franklin,106,9.0,40,66,0,14.5384615385,New Zealand
LJ Wright,30,1.0,4,26,0,10.5,England
MA Wood,13,2.0,8,5,0,14.0,England
Mahmudullah,155,16.0,64,91,0,10.44,Bangladesh
Harbhajan Singh,26,3.0,14,12,0,10.0,India
GH Bodi,12,2.0,8,4,0,16.0,South Africa
S Matsikenyeri,78,6.0,24,54,0,9.625,Zimbabwe
WTS Porterfield,67,5.0,20,47,0,11.875,Ireland
Sohaib Maqsood,106,9.0,36,70,0,9.8,Pakistan
D Ramdin,195,15.0,66,129,0,8.74193548387,West Indies
CS Baugh,14,1.0,4,10,0,9.16666666667,West Indies
JO Holder,82,10.0,48,34,0,8.125,West Indies
CR Brathwaite,18,2.0,10,8,0,5.0,West Indies
JW Hastings,8,2.0,8,0,0,9.0,Australia
RJ Peterson,40,3.0,12,28,0,15.0,South Africa
JWA Taylor,133,10.0,40,93,0,13.0,England
Junaid Siddique,64,3.0,12,52,0,10.4444444444,Bangladesh
P Mustard,19,2.0,10,9,0,8.0,England
S Dhawan,423,60.0,260,163,0,13.7916666667,India
DP Hyatt,18,2.0,10,8,0,19.0,West Indies
Umar Akmal,291,17.0,72,219,0,10.9285714286,Pakistan
M Kaif,21,1.0,4,17,0,13.3333333333,India
D Mongia,24,2.0,8,16,0,14.0,India
SE Findlay,20,3.0,14,6,0,17.0,West Indies
LMP Simmons,215,15.0,66,149,0,12.24,West Indies
GP Swann,10,2.0,8,2,0,8.5,England
Saad Nasim,8,1.0,4,4,0,17.0,Pakistan
RJ Nicol,60,4.0,20,40,0,12.8,New Zealand
EC Joyce,121,12.0,52,69,0,13.25,England
MK Tiwary,58,6.0,24,34,0,12.6666666667,India
Mushfiqur Rahim,515,41.0,168,347,0,11.6875,Bangladesh
Mohammad Ashraful,195,15.0,60,135,0,11.9565217391,Bangladesh
Sohag Gazi,9,1.0,4,5,0,15.0,Bangladesh
TG Southee,10,2.0,10,0,0,3.0,New Zealand
SE Marsh,212,17.0,70,142,0,13.2222222222,Australia
Shoaib Malik,339,28.0,124,215,0,11.3095238095,Pakistan
OA Shah,159,12.0,50,109,0,12.6818181818,England
BRM Taylor,383,34.0,148,235,0,10.9777777778,Zimbabwe
CA Ingram,77,6.0,24,53,0,13.0,South Africa
MG Johnson,35,4.0,20,15,0,12.0,Australia
A Flintoff,37,3.0,12,25,0,8.875,England
MP Vaughan,17,1.0,4,13,0,9.0,England
GC Wilson,61,7.0,28,33,0,11.6,Ireland
Farhad Reza,50,7.0,32,18,0,8.0,Bangladesh
MK Pandey,16,1.0,4,12,0,15.5,India
MV Boucher,74,5.0,20,54,0,11.0,South Africa
AD Hales,79,8.0,34,45,0,11.4285714286,England
TD Paine,30,2.0,8,22,0,15.0,Australia
MS Wade,59,2.0,10,49,0,9.45454545455,Australia
PR Stirling,70,11.0,48,22,0,15.25,Ireland
AD Mathews,302,27.0,118,184,0,11.0975609756,Sri Lanka
Dhiman Ghosh,27,3.0,12,15,0,7.16666666667,Bangladesh
T Duffin,10,1.0,4,6,0,15.0,Zimbabwe
KP Pietersen,367,30.0,134,233,0,11.5641025641,England
SM Davies,17,2.0,8,9,0,12.0,England
KD Mills,29,6.0,24,5,0,6.6,New Zealand
UT Yadav,17,3.0,14,3,0,12.0,India
DR Smith,65,8.0,36,29,0,8.55555555556,West Indies
SR Watson,483,52.0,254,229,1.0,13.0810810811,Australia
JWM Dalrymple,31,1.0,4,27,0,11.4,England
Mominul Haque,57,7.0,28,29,0,10.125,Bangladesh
KMDN Kulasekara,43,4.0,18,25,0,11.0,Sri Lanka
SK Raina,570,55.0,238,332,0,11.0307692308,India
RR Rossouw,107,11.0,52,55,0,13.125,South Africa
BJ Watling,65,8.0,32,33,0,16.6,New Zealand
BA Stokes,75,5.0,22,53,0,9.2,England
JC Buttler,181,21.0,94,87,0,10.3888888889,England
RR Sarwan,332,27.0,120,212,0,13.5882352941,West Indies
JL Ontong,15,1.0,4,11,0,16.0,South Africa
MN Samuels,416,44.0,188,228,0,12.1320754717,West Indies
KM Dabengwa,35,3.0,12,23,0,10.4285714286,Zimbabwe
V Kohli,880,59.0,252,628,0,13.3580246914,India
GC Smith,299,27.0,114,185,0,14.12,South Africa
BA Parchment,10,1.0,4,6,0,21.0,West Indies
RV Uthappa,37,3.0,16,21,0,8.5,India
