Batsman,Total Runs Scored,Home Run Hitting Ability,Home Runs,Non Home Runs,Number of Milestones Reached,Average Balls Faced,Team
Yasir Hameed,17,1.0,4,13,0,8.66666666667,Pakistan
Salman Butt,252,33.0,132,120,0,14.6666666667,Pakistan
JA Morkel,8,1.0,4,4,0,14.0,South Africa
JM Bairstow,31,3.0,12,19,0,14.6666666667,England
T Thushara,15,3.0,12,3,0,14.0,Sri Lanka
V Sehwag,469,70.0,302,167,0,11.5454545455,India
KA Edwards,30,1.0,6,24,0,9.42857142857,West Indies
SC Williams,154,13.0,52,102,0,9.28571428571,Zimbabwe
DE Bernard,13,1.0,4,9,0,10.6666666667,West Indies
Inzamam-ul-Haq,25,3.0,12,13,0,12.6,Pakistan
Mehrab Hossain jnr,14,1.0,4,10,0,16.6666666667,Bangladesh
RT Ponting,714,92.0,376,338,0,12.3205128205,Australia
MEK Hussey,165,16.0,68,97,0,11.5517241379,Australia
MM Ali,68,5.0,22,46,0,11.375,England
Imrul Kayes,199,21.0,90,109,0,11.8846153846,Bangladesh
RW Chakabva,29,1.0,4,25,0,7.66666666667,Zimbabwe
MJ Guptill,600,61.0,258,342,0,13.5689655172,New Zealand
MR Marsh,13,1.0,4,9,0,13.0,Australia
MJ Clarke,481,41.0,166,315,0,10.8873239437,Australia
Mahmudullah,167,21.0,86,81,0,11.7142857143,Bangladesh
Khurram Manzoor,27,3.0,12,15,0,14.3333333333,Pakistan
MJ Prior,153,18.0,74,79,0,11.5,England
S Chanderpaul,263,27.0,110,153,0,13.2777777778,West Indies
DJ Bravo,175,25.0,108,67,0,10.7272727273,West Indies
CK Kapugedera,47,5.0,20,27,0,8.8125,Sri Lanka
N Deonarine,67,8.0,32,35,0,12.1,West Indies
DA Warner,319,29.0,132,187,0,13.4827586207,Australia
Shamsur Rahman,72,9.0,46,26,0,16.0,Bangladesh
BJ Hodge,18,4.0,16,2,0,7.66666666667,Australia
ML Udawatte,32,6.0,24,8,0,14.5,Sri Lanka
TAM Siriwardana,19,3.0,12,7,0,9.5,Sri Lanka
Rajin Saleh,12,2.0,8,4,0,12.0,Bangladesh
HM Amla,766,60.0,242,524,0,13.125,South Africa
DA Miller,50,3.0,12,38,0,10.2222222222,South Africa
RJ Nicol,65,4.0,16,49,0,11.7777777778,New Zealand
KC Sangakkara,1149,112.0,456,693,0,12.5869565217,Sri Lanka
GJ Bailey,151,13.0,56,95,0,11.0,Australia
MJ Lumb,25,3.0,14,11,0,13.0,England
CK Coventry,84,11.0,50,34,0,13.4285714286,Zimbabwe
PJ Ingram,48,9.0,36,12,0,11.75,New Zealand
AT Rayudu,100,8.0,32,68,0,13.2857142857,India
SR Tendulkar,610,83.0,336,274,0,14.5576923077,India
JP Bray,30,3.0,14,16,0,12.0,Ireland
DM Richards,30,4.0,16,14,0,9.25,West Indies
R Dravid,162,18.0,72,90,0,12.4,India
SF Mire,18,1.0,4,14,0,11.0,Zimbabwe
CR Ervine,95,9.0,38,57,0,12.1333333333,Zimbabwe
XM Marshall,14,1.0,4,10,0,10.5,West Indies
ME Trescothick,67,10.0,42,25,0,13.0,England
A Symonds,66,8.0,32,34,0,11.3,Australia
RS Bopara,283,32.0,134,149,0,12.6774193548,England
L Vincent,68,11.0,44,24,0,14.3333333333,New Zealand
HDRL Thirimanne,302,25.0,102,200,0,12.4594594595,Sri Lanka
SHT Kandamby,32,3.0,12,20,0,10.125,Sri Lanka
SB Styris,179,22.0,88,91,0,11.8076923077,New Zealand
LD Chandimal,240,25.0,112,128,0,12.6785714286,Sri Lanka
Litton Das,33,4.0,16,17,0,12.3333333333,Bangladesh
Umar Gul,17,3.0,14,3,0,11.0,Pakistan
Younis Khan,495,56.0,230,265,0,10.7428571429,Pakistan
KD Karthik,138,18.0,76,62,0,9.95,India
GJ Maxwell,34,5.0,22,12,0,10.5,Australia
H Masakadza,445,46.0,192,253,0,11.3448275862,Zimbabwe
AJ Redmond,41,5.0,20,21,0,11.2,New Zealand
GS Ballance,46,2.0,8,38,0,10.4285714286,England
JM Kemp,12,1.0,4,8,0,8.66666666667,South Africa
TM Dowlin,25,3.0,12,13,0,14.6,West Indies
WTS Porterfield,144,14.0,60,84,0,13.8421052632,Ireland
WW Hinds,12,1.0,4,8,0,15.5,West Indies
Azhar Ali,155,12.0,48,107,0,12.1176470588,Pakistan
F du Plessis,379,33.0,136,243,0,12.487804878,South Africa
WU Tharanga,668,84.0,348,320,0,13.5151515152,Sri Lanka
Raqibul Hasan,169,17.0,70,99,0,10.4137931034,Bangladesh
DS Smith,149,15.0,64,85,0,12.6153846154,West Indies
SM Warnapura,14,2.0,8,6,0,14.0,Sri Lanka
Nasir Jamshed,220,23.0,104,116,0,12.5909090909,Pakistan
AN Petersen,56,6.0,24,32,0,12.8571428571,South Africa
AC Botha,14,1.0,4,10,0,14.6666666667,Ireland
JP Faulkner,16,3.0,12,4,0,15.0,Australia
DG Brownlie,45,4.0,16,29,0,13.3333333333,New Zealand
Fawad Alam,28,2.0,8,20,0,11.8333333333,Pakistan
PJ Forrest,60,7.0,32,28,0,14.2857142857,Australia
S Badrinath,20,1.0,4,16,0,17.6666666667,India
MS Dhoni,218,25.0,100,118,0,10.8181818182,India
MA Carberry,10,1.0,4,6,0,11.0,England
TM Dilshan,941,89.0,370,571,0,13.3010752688,Sri Lanka
F Behardien,24,3.0,12,12,0,9.33333333333,South Africa
AJ Strauss,398,41.0,170,228,0,11.625,England
JH Kallis,622,80.0,330,292,0,14.0350877193,South Africa
AM Rahane,323,33.0,140,183,0,13.4375,India
LRPL Taylor,553,66.0,270,283,0,11.9295774648,New Zealand
CH Gayle,485,74.0,348,137,0,12.5454545455,West Indies
J Charles,138,13.0,62,76,0,12.4666666667,West Indies
JA Burns,23,2.0,8,15,0,15.5,Australia
Nasir Hossain,19,3.0,12,7,0,8.0,Bangladesh
G Gambhir,670,71.0,292,378,0,12.203125,India
MDKJ Perera,136,14.0,58,78,0,12.5714285714,Sri Lanka
HH Gibbs,279,40.0,166,113,0,11.8461538462,South Africa
NJ Astle,52,8.0,32,20,0,15.75,New Zealand
LMP Simmons,234,25.0,108,126,0,11.4516129032,West Indies
Sarfraz Ahmed,66,6.0,24,42,0,9.77777777778,Pakistan
IJL Trott,332,27.0,108,224,0,12.0487804878,England
NJ O'Brien,159,14.0,58,101,0,11.4761904762,Ireland
Yuvraj Singh,401,59.0,246,155,0,11.1754385965,India
A Balbirnie,22,2.0,8,14,0,10.0,Ireland
BA Parchment,8,1.0,4,4,0,7.0,West Indies
S Chattergoon,55,10.0,40,15,0,18.75,West Indies
AB Barath,47,5.0,20,27,0,12.7142857143,West Indies
Mohammad Yousuf,233,31.0,126,107,0,10.4857142857,Pakistan
Misbah-ul-Haq,227,20.0,84,143,0,11.5348837209,Pakistan
DPMD Jayawardene,730,76.0,312,418,0,11.4583333333,Sri Lanka
Naeem Islam,8,1.0,4,4,0,8.33333333333,Bangladesh
PG Fulton,109,14.0,60,49,0,9.57894736842,New Zealand
SPD Smith,172,15.0,60,112,0,10.9545454545,Australia
PJ Hughes,101,10.0,40,61,0,12.6923076923,Australia
Anamul Haque,140,14.0,60,80,0,14.8461538462,Bangladesh
Shakib Al Hasan,244,29.0,120,124,0,9.95454545455,Bangladesh
Shahriar Nafees,194,32.0,128,66,0,13.5294117647,Bangladesh
HJH Marshall,11,1.0,4,7,0,6.75,New Zealand
Ahmed Shehzad,346,28.0,116,230,0,13.375,Pakistan
RS Morton,70,4.0,18,52,0,11.3636363636,West Indies
LM Jongwe,7,1.0,4,3,0,16.0,Zimbabwe
KOA Powell,101,11.0,46,55,0,11.2727272727,West Indies
Sharjeel Khan,27,3.0,16,11,0,9.66666666667,Pakistan
Javed Omar,22,2.0,8,14,0,10.8,Bangladesh
Alok Kapali,25,5.0,20,5,0,10.0,Bangladesh
KS Williamson,452,41.0,166,286,0,13.2,New Zealand
DJG Sammy,30,3.0,16,14,0,8.2,West Indies
ADS Fletcher,38,6.0,26,12,0,13.25,West Indies
JR Hopes,25,3.0,12,13,0,11.75,Australia
Soumya Sarkar,101,14.0,58,43,0,11.8888888889,Bangladesh
JL Denly,41,5.0,20,21,0,9.8,England
LPC Silva,49,6.0,24,25,0,9.0,Sri Lanka
E Chigumbura,131,23.0,102,29,0,9.78947368421,Zimbabwe
P Utseya,5,1.0,4,1,0,5.75,Zimbabwe
KP Pietersen,508,66.0,278,230,0,11.2063492063,England
MA Vermeulen,11,1.0,4,7,0,21.0,Zimbabwe
CL White,77,11.0,44,33,0,12.3076923077,Australia
CJ Ferguson,20,1.0,4,16,0,16.0,Australia
YK Pathan,39,7.0,28,11,0,13.0,India
S Randiv,9,2.0,8,1,0,15.0,Sri Lanka
L Ronchi,31,3.0,12,19,0,7.25,Australia
Imran Nazir,38,7.0,32,6,0,9.25,Pakistan
BJ Haddin,339,44.0,194,145,0,14.4166666667,Australia
MN Waller,8,1.0,4,4,0,7.75,Zimbabwe
Imran Farhat,145,15.0,60,85,0,13.3125,Pakistan
JM How,100,12.0,48,52,0,10.0,New Zealand
AN Cook,544,57.0,232,312,0,12.7169811321,England
TWM Latham,161,19.0,82,79,0,11.0625,New Zealand
AJ Finch,251,26.0,114,137,0,12.2307692308,Australia
BC Lara,88,11.0,48,40,0,12.8333333333,West Indies
RA Jadeja,26,1.0,4,22,0,10.5,India
ML Hayden,288,33.0,144,144,0,11.96875,Australia
MN van Wyk,65,9.0,38,27,0,12.8571428571,South Africa
PA Patel,100,11.0,48,52,0,12.4444444444,India
KA Pollard,89,12.0,58,31,0,8.57142857143,West Indies
Khalid Latif,29,3.0,12,17,0,15.3333333333,Pakistan
Shahid Afridi,48,5.0,28,20,0,6.28571428571,Pakistan
NT Broom,14,2.0,8,6,0,12.5,New Zealand
SP Fleming,88,12.0,50,38,0,12.0833333333,New Zealand
MB Loye,17,4.0,16,1,0,8.33333333333,England
CD McMillan,41,7.0,28,13,0,13.25,New Zealand
SMA Priyanjan,27,3.0,12,15,0,12.25,Sri Lanka
JP Duminy,163,16.0,64,99,0,10.1111111111,South Africa
NO Miller,4,1.0,4,0,0,2.0,West Indies
M Vijay,58,5.0,22,36,0,15.2,India
T Taibu,174,14.0,56,118,0,9.77777777778,Zimbabwe
JJ Roy,105,13.0,52,53,0,12.125,England
JL Carter,36,3.0,12,24,0,14.3333333333,West Indies
DJ Hussey,46,4.0,16,30,0,7.3,Australia
SC Ganguly,159,20.0,86,73,0,12.6875,India
CJ Anderson,134,20.0,104,30,1.0,14.1428571429,New Zealand
MD Gunathilaka,18,2.0,10,8,0,10.0,Sri Lanka
SM Pollock,23,4.0,16,7,0,25.0,South Africa
DR Smith,137,18.0,90,47,0,9.64285714286,West Indies
Kamran Akmal,307,37.0,156,151,0,12.6666666667,Pakistan
PD Collingwood,158,16.0,66,92,0,11.0,England
AB de Villiers,596,65.0,266,330,0,9.9156626506,South Africa
Asad Shafiq,158,12.0,48,110,0,10.72,Pakistan
JE Root,310,27.0,108,202,0,11.1351351351,England
KDK Vithanage,9,1.0,4,5,0,14.0,Sri Lanka
DI Joyce,25,4.0,16,9,0,17.0,Ireland
V Sibanda,261,31.0,130,131,0,12.9375,Zimbabwe
Aftab Ahmed,130,23.0,92,38,0,8.63157894737,Bangladesh
IR Bell,780,86.0,358,422,0,12.75,England
LR Johnson,8,1.0,6,2,0,14.0,West Indies
Babar Azam,36,4.0,16,20,0,9.4,Pakistan
C Kieswetter,113,11.0,50,63,0,10.0833333333,England
DR Martyn,64,11.0,44,20,0,13.3333333333,Australia
Sikandar Raza,59,8.0,32,27,0,9.0,Zimbabwe
Nazimuddin,38,6.0,26,12,0,11.5,Bangladesh
DT Johnston,16,2.0,8,8,0,9.5,Ireland
HM Nicholls,19,2.0,8,11,0,15.0,New Zealand
IK Pathan,14,2.0,8,6,0,6.83333333333,India
AC Gilchrist,234,36.0,166,68,0,12.3333333333,Australia
AC Voges,8,1.0,4,4,0,6.75,Australia
ST Jayasuriya,430,66.0,300,130,0,13.0344827586,Sri Lanka
KJ O'Brien,48,6.0,28,20,0,7.88888888889,Ireland
RG Sharma,518,51.0,224,294,0,11.7931034483,India
DM Bravo,359,33.0,140,219,0,13.3404255319,West Indies
CJ Chibhabha,222,25.0,100,122,0,13.1785714286,Zimbabwe
Tamim Iqbal,639,71.0,292,347,0,12.6567164179,Bangladesh
GD Elliott,107,10.0,40,67,0,9.78947368421,New Zealand
EJG Morgan,240,26.0,108,132,0,10.4054054054,Ireland
Mohammad Hafeez,861,102.0,434,427,0,13.5641025641,Pakistan
DR Flynn,23,3.0,12,11,0,11.75,New Zealand
Sami Aslam,11,1.0,4,7,0,17.0,Pakistan
AR Cusack,5,1.0,4,1,0,6.5,Ireland
JEC Franklin,18,2.0,8,10,0,6.66666666667,New Zealand
Jahurul Islam,65,8.0,34,31,0,13.1666666667,Bangladesh
RR Rossouw,115,8.0,32,83,0,14.0,South Africa
GH Bodi,9,1.0,4,5,0,15.0,South Africa
S Matsikenyeri,91,15.0,60,31,0,10.5,Zimbabwe
Umar Amin,10,2.0,8,2,0,7.66666666667,Pakistan
Sohaib Maqsood,52,7.0,28,24,0,13.1666666667,Pakistan
D Ramdin,97,7.0,30,67,0,8.61111111111,West Indies
SW Billings,24,3.0,12,12,0,15.0,England
MS Atapattu,19,3.0,12,7,0,7.25,Sri Lanka
LE Bosman,59,8.0,38,21,0,11.25,South Africa
RJ Peterson,19,1.0,4,15,0,11.0,South Africa
JWA Taylor,109,8.0,34,75,0,13.4615384615,England
Junaid Siddique,139,13.0,52,87,0,9.95238095238,Bangladesh
P Mustard,41,5.0,20,21,0,13.3333333333,England
S Dhawan,429,42.0,174,255,0,13.35,India
DP Hyatt,42,7.0,34,8,0,11.8,West Indies
Umar Akmal,110,12.0,52,58,0,10.9473684211,Pakistan
M Kaif,14,2.0,8,6,0,11.0,India
D Mongia,11,2.0,8,3,0,16.3333333333,India
HH Dippenaar,8,1.0,4,4,0,17.0,South Africa
Bilal Asif,16,3.0,14,2,0,6.0,Pakistan
EC Joyce,135,16.0,64,71,0,12.15,England
MK Tiwary,42,5.0,22,20,0,12.5,India
Mushfiqur Rahim,272,27.0,114,158,0,11.9230769231,Bangladesh
Mohammad Ashraful,347,49.0,200,147,0,11.4680851064,Bangladesh
Haris Sohail,69,7.0,28,41,0,12.0,Pakistan
SE Marsh,234,24.0,98,136,0,11.6923076923,Australia
Shoaib Malik,184,21.0,88,96,0,11.3571428571,Pakistan
OA Shah,129,15.0,70,59,0,13.1538461538,England
BRM Taylor,466,49.0,206,260,0,11.5593220339,Zimbabwe
CA Ingram,87,8.0,34,53,0,11.9090909091,South Africa
MG Johnson,13,1.0,4,9,0,12.0,Australia
DC Thomas,6,1.0,4,2,0,3.5,West Indies
AP Devcich,34,3.0,12,22,0,11.2,New Zealand
A Flintoff,47,6.0,26,21,0,7.6,England
MP Vaughan,47,7.0,32,15,0,10.4,England
GC Wilson,17,3.0,14,3,0,8.66666666667,Ireland
Farhad Reza,8,1.0,4,4,0,6.5,Bangladesh
MV Boucher,21,1.0,4,17,0,8.71428571429,South Africa
AD Hales,142,15.0,60,82,0,12.2666666667,England
TD Paine,130,15.0,60,70,0,13.6153846154,Australia
MS Wade,94,9.0,40,54,0,11.8333333333,Australia
PR Stirling,47,2.0,10,37,0,11.1666666667,Ireland
AD Mathews,135,16.0,66,69,0,9.2962962963,Sri Lanka
T Duffin,27,4.0,16,11,0,16.5,Zimbabwe
JD Ryder,209,30.0,134,75,0,11.2777777778,New Zealand
SM Davies,41,5.0,20,21,0,12.3333333333,England
MDK Perera,14,2.0,8,6,0,11.0,Sri Lanka
SE Findlay,12,2.0,8,4,0,11.0,West Indies
SR Watson,794,101.0,438,356,0,12.3823529412,Australia
BB McCullum,558,73.0,332,226,0,12.652173913,New Zealand
Mominul Haque,64,5.0,20,44,0,10.1111111111,Bangladesh
KMDN Kulasekara,4,1.0,4,0,0,3.5,Sri Lanka
SK Raina,258,28.0,116,142,0,9.46341463415,India
R Mutumbami,12,2.0,8,4,0,13.0,Zimbabwe
UT Khawaja,21,2.0,8,13,0,10.0,Australia
BJ Watling,41,2.0,8,33,0,10.3,New Zealand
BA Stokes,37,5.0,20,17,0,13.6666666667,England
Q de Kock,311,35.0,146,165,0,12.6071428571,South Africa
RR Sarwan,240,24.0,98,142,0,12.6363636364,West Indies
JL Ontong,7,1.0,4,3,0,11.0,South Africa
MN Samuels,329,38.0,162,167,0,12.8958333333,West Indies
V Kohli,950,90.0,366,584,0,13.2842105263,India
GC Smith,649,80.0,334,315,0,13.0,South Africa
RV Uthappa,49,4.0,18,31,0,10.0,India
